Name,Country,Occupation,Birth year,Age of death,Associated Country Life Expectancy,Death year
Michelle Rios,['Spain'],Astronomer,1923,86,20,2009
Jacob Leach,['Niue'],Athlete,1870,34,88,1904
Timothy Bates,"['Benin', 'Saint Kitts and Nevis']",Artist,1879,22,20,1901
Daniel Nelson,"['North Macedonia', 'Honduras']",Athlete,1877,82,48,1959
James Ramirez,"['Bouvet Island (Bouvetoya)', 'Niue']",Artist,1915,37,15,1952
Amy Collins,['Nigeria'],Military personnel,1877,44,73,1921
Carla Taylor,['Panama'],Artist,1921,83,28,2004
Joyce White,"['Cook Islands', 'Mexico']",Artist,1908,61,32,1969
Deborah Harris,['India'],Artist,1905,42,29,1947
Laura Silva,['Wallis and Futuna'],Inventor; balloonist,1874,37,48,1911
Timothy Harris,['Saint Kitts and Nevis'],Researcher,1884,42,35,1926
Sarah Guzman,['Christmas Island'],Artist,1912,4,55,1916
Sherry Wagner,['Montenegro'],Racing driver; racing automobile driver,1909,11,64,1920
Anthony Jacobson,"['Anguilla', 'Montserrat']",Esperantist,1888,7,63,1895
Katherine Morgan,['Martinique'],Artist,1904,51,18,1955
Elizabeth Key,"['Venezuela', 'Chad']",Artist,1910,73,21,1983
Stacey Hudson,"['Bangladesh', 'French Polynesia']",Artist,1886,22,57,1908
Charles Thomas,"['Northern Mariana Islands', 'Timor-Leste']",Researcher,1907,24,56,1931
Morgan Mendez,"['Finland', 'Bosnia and Herzegovina']",Artist,1921,63,18,1984
Jessica Adkins,"['Jordan', 'Kenya']",Lawyer,1871,41,23,1912
Michael Brooks,"['Japan', 'Tokelau']",Politician,1870,62,3,1932
Shane Williams,['Saint Barthelemy'],Artist,1887,24,26,1911
Natalie Guerrero,"['Christmas Island', 'Senegal']",Motorcycle racer; racing automobile driver,1889,54,13,1943
Daniel Russell,['Afghanistan'],Researcher,1906,77,62,1983
Heather Hunt,"['Antarctica (the territory South of 60 deg S)', 'Honduras']",Merchant; murderer,1890,61,5,1951
Gregory Webb,"['Northern Mariana Islands', 'Italy']",Artist,1917,7,47,1924
Cheryl Lozano,['Azerbaijan'],Researcher,1924,68,69,1992
Sarah Anderson,['Costa Rica'],Athlete,1922,85,83,2007
Raven Cook,"['Haiti', 'Central African Republic']",Entrepreneur,1910,82,35,1992
Brenda Barron,['Saint Vincent and the Grenadines'],Religious figure,1920,40,57,1960
Kristin Boone,['Yemen'],Researcher,1908,78,38,1986
Amy Guerrero,['Taiwan'],Artist,1903,74,5,1977
Kayla Brown,['Argentina'],Military personnel,1876,17,16,1893
Angelica Morrow,"['Burkina Faso', 'Malawi']",Politician,1883,83,36,1966
April Hurley,"['Australia', 'Bolivia']",Artist,1872,10,85,1882
Jennifer Franklin,"['British Virgin Islands', 'Singapore']",Artist,1890,65,42,1955
Maureen Mendoza,"['Wallis and Futuna', 'Paraguay']",Nun; christians jehovahâ€™s witnesses,1915,79,34,1994
James Davis,['Malawi'],Artist,1907,59,1,1966
Melissa Obrien,['Myanmar'],Artist,1896,86,38,1982
Christine Mitchell,['Pakistan'],Athlete,1920,14,88,1934
Emily Mcguire,"['Zimbabwe', 'Cape Verde']",Politician,1920,62,66,1982
Sandra Conner,"['Moldova', 'Sweden']",Conductor,1884,62,33,1946
Brianna Proctor,['Austria'],Researcher,1913,55,53,1968
Janice Browning,"['Syrian Arab Republic', 'Lesotho']",Artist,1920,36,21,1956
Lisa Garcia,['French Southern Territories'],Artist,1882,22,65,1904
Jamie Wu,['Barbados'],Artist,1910,54,26,1964
Erika Freeman,"['Tuvalu', 'Christmas Island']",Athlete,1894,23,7,1917
William George,['Heard Island and McDonald Islands'],Artist,1921,87,38,2008
Elijah Cooper,['Belarus'],Disc jockey,1893,27,10,1920
Lauren Jones DDS,['Macao'],Religious figure,1878,30,39,1908
Catherine Davis,['Norway'],Athlete,1899,86,48,1985
Lee Oliver,['Brunei Darussalam'],Artist,1907,30,73,1937
Elizabeth Hill,['Germany'],Politician,1877,82,11,1959
Madeline Smith,"['Cuba', 'Uganda']",Monk,1901,89,59,1990
Chelsea Lopez,['Bermuda'],Artist,1903,5,71,1908
Dr. Mary Cline,['Colombia'],Astronomer,1901,68,37,1969
Andrew Morrison,"['Mali', 'Saint Kitts and Nevis']",Artist,1892,28,23,1920
Jason Chapman,"['Faroe Islands', 'Sao Tome and Principe']",Politician,1899,4,19,1903
Stacy Gonzalez,['Spain'],Engineer,1898,71,0,1969
Sarah Lindsey,"['Guam', 'United States of America']",Businessperson,1876,8,44,1884
Reginald Rodriguez,"['Uruguay', 'Slovenia']",Criminal,1906,67,68,1973
Kylie Carroll,"[""Cote d'Ivoire""]",Artist,1916,9,87,1925
Shane Bates,['Nepal'],Artist,1873,17,85,1890
Nicholas Benson,['Sierra Leone'],Athlete,1876,54,41,1930
Brenda Wilson,['Bermuda'],Politician,1916,9,49,1925
Jacqueline Carter,"['United States of America', 'Singapore']",Artist,1912,52,2,1964
Brian Williams,['Niger'],Journalist,1874,26,27,1900
Dustin Lucero,['Guam'],Artist,1874,56,50,1930
Devin Mcdowell,['Iran'],Military personnel,1874,42,76,1916
Timothy Miller,"['Saint Pierre and Miquelon', 'Malta']",Artist,1894,37,63,1931
Ryan Jordan,['North Macedonia'],Artist,1870,46,16,1916
Brian Hernandez,"['Croatia', 'Korea']",Politician,1910,59,9,1969
Lauren Waters,['Reunion'],Hammer thrower,1891,60,45,1951
Michael Johnson,['Barbados'],Politician,1875,57,50,1932
Kenneth Cunningham,['Kiribati'],Artist,1882,23,16,1905
Katie Perry,"['Korea', 'Azerbaijan']",Researcher,1908,6,66,1914
Michael Hill,['Burkina Faso'],Artist,1878,43,41,1921
Rebecca Cunningham,"['Portugal', 'Vietnam']",Literary critic; novelist,1880,5,86,1885
Katrina Lloyd,"['Jersey', 'Guernsey']",Artist,1916,39,32,1955
Jamie Walker,"['Colombia', 'Falkland Islands (Malvinas)']",Politician,1907,35,7,1942
Jacob Brown,"['Western Sahara', 'Germany']",Artist,1890,65,77,1955
Brittney Thompson,['Congo'],Artist,1894,59,54,1953
Jason Carey,['Yemen'],Aristocrat,1888,3,11,1891
Janet Watson,"['Canada', 'Saint Martin']",Artist,1886,28,55,1914
David Pierce,['Portugal'],Serial killer,1879,81,26,1960
Allen Carter,['Congo'],Artist,1902,38,9,1940
Linda Flynn,['Macao'],Artist,1910,83,57,1993
Natasha Perez,['Uganda'],Researcher,1890,8,73,1898
Ronald Molina,"['Guernsey', 'Hong Kong']",Researcher,1886,20,69,1906
Curtis Montgomery,"['Fiji', 'Swaziland']",Artist,1873,40,11,1913
Samantha Trujillo,['Belgium'],Artist,1906,69,84,1975
Michael Quinn,"['Bermuda', 'Liechtenstein']",Ophthalmologist,1878,72,72,1950
David Wong,"['Austria', 'Sudan']",Politician,1878,67,30,1945
Lindsey Mcclure,['Timor-Leste'],Artist,1916,37,40,1953
Steve Alexander,"['Kiribati', 'Holy See (Vatican City State)']",Researcher,1878,78,74,1956
Jennifer Perez,['El Salvador'],Politician,1903,4,39,1907
Carrie Phillips,['Greenland'],Artist,1904,57,18,1961
Christopher Miranda,"['Mozambique', 'Tokelau']",Athlete,1908,7,26,1915
Pamela Flores,['Hong Kong'],Artist,1889,38,47,1927
Christopher Hooper,"['Cameroon', 'Benin']",Artist,1912,81,66,1993
Amanda Robinson,['Kuwait'],Philosopher,1890,32,19,1922
Allison Atkinson,"['Tonga', 'Kuwait']",Artist,1914,69,12,1983
Austin Espinoza,['Liberia'],Artist,1883,64,62,1947
Michael Christensen,['Jersey'],Religious figure,1899,65,82,1964
Stephen Hill,['Bahamas'],Artist,1892,47,86,1939
Richard Moore,['Peru'],Artist,1897,3,77,1900
Joanne Melendez,['Brunei Darussalam'],Artist,1899,26,7,1925
Michael Nelson,['Guernsey'],Military personnel,1904,62,34,1966
Tanner Edwards,"['Croatia', 'Korea']",Artist,1895,44,79,1939
Julie Bowen,['Malawi'],Artist,1886,86,5,1972
Matthew Brooks,['Philippines'],Artist,1879,7,54,1886
Anthony Silva,"['Falkland Islands (Malvinas)', 'Cameroon']",Artist,1884,44,78,1928
Amy Goodwin,"['Iraq', 'Finland']",Researcher,1921,79,5,2000
Daniel Walsh,"['Iran', 'Vietnam']",Artist,1870,18,18,1888
Richard Matthews,['Reunion'],Artist,1917,81,14,1998
Kathryn Jones,['Hungary'],Politician,1909,3,22,1912
Rachel Jackson,['Somalia'],Artist,1900,71,8,1971
Christopher Payne,['Andorra'],Researcher,1870,25,73,1895
Katherine Black,"['Guyana', 'Vanuatu']",Politician,1914,19,83,1933
Scott Hines,"['Central African Republic', 'Fiji']",Artist,1907,5,76,1912
Keith Palmer,['Germany'],Artist,1919,61,22,1980
Victor Welch,['Ghana'],Artist,1894,57,7,1951
Robert Wright,"['Honduras', 'Saint Vincent and the Grenadines']",Military personnel,1914,12,41,1926
Timothy Williams,['Mexico'],Researcher,1906,18,64,1924
Mr. Dustin Brown,"['United States Virgin Islands', 'Papua New Guinea']",Artist,1879,48,0,1927
Kimberly Kline,"['Malta', 'Samoa']",Politician,1909,52,86,1961
Christopher Burke,['Czech Republic'],Artist,1917,65,75,1982
Lindsey Walsh,"['Croatia', 'Bahamas']",Accordionist,1894,17,50,1911
Albert Sanchez,"['Vanuatu', ""Cote d'Ivoire""]",Politician,1896,80,43,1976
Robin Matthews,"['Bhutan', 'Ireland']",Journalist,1906,61,13,1967
Casey Ingram,"['Spain', 'Kyrgyz Republic']",Gangster,1872,57,36,1929
Jonathan Miller,"['Northern Mariana Islands', 'Vietnam']",Serial killer; drug trafficker,1880,21,67,1901
Jordan Lozano,['Mauritius'],Artist,1871,84,16,1955
Alicia Walsh,"['Uruguay', 'United Arab Emirates']",Athlete,1920,25,19,1945
Michelle Jensen,"['Togo', 'Finland']",Ballet dancer; ballet master; choreographer; theater director,1903,79,73,1982
Michelle Jensen,"['Lesotho', 'Bosnia and Herzegovina']",Politician,1909,45,44,1954
Paul Huynh,"['Isle of Man', 'Malta']",Artist,1891,30,11,1921
Melissa Roach,"['Saint Helena', 'Italy']",Artist,1901,61,9,1962
Ashley Owens,"['Burkina Faso', 'Cocos (Keeling) Islands']",Artist,1906,73,46,1979
Nicholas Brown,"['Israel', 'Hungary']",Artist,1907,19,19,1926
Karen Carter,"['Tanzania', 'French Polynesia']",Artist,1906,67,75,1973
James Day,['Latvia'],Artist,1913,6,0,1919
Jack Pratt,"['South Georgia and the South Sandwich Islands', 'Tokelau']",Judge,1877,84,15,1961
Larry Guzman,['Norway'],Politician,1909,2,69,1911
John Brooks,['Equatorial Guinea'],Researcher,1876,5,20,1881
Melinda Pacheco,"['Austria', 'Bosnia and Herzegovina']",Athlete,1881,41,61,1922
Kenneth Ayala,['Heard Island and McDonald Islands'],Artist,1894,77,39,1971
Christine Mclaughlin,"['Cambodia', 'Netherlands Antilles']",Artist,1914,15,84,1929
Brandon Sullivan,['Wallis and Futuna'],Gangster,1906,35,81,1941
Kyle Faulkner,"['Honduras', 'United States Virgin Islands']",Artist,1884,77,70,1961
Robert Parker,"['Norfolk Island', 'Luxembourg']",Military personnel,1870,51,64,1921
Edward King,"['Dominica', 'Guadeloupe']",Athlete,1892,29,34,1921
Tina Riley,"['Palau', 'Paraguay']",Military personnel,1916,16,78,1932
Randall Wolfe,"['Lebanon', 'British Virgin Islands']",Researcher,1890,82,7,1972
Tiffany Brown,"['Denmark', 'Guam']",Theater director,1905,35,48,1940
Louis Nguyen,"['Chile', 'Hungary']",Artist,1871,1,78,1872
Mary Walton,['Italy'],Artist,1913,82,88,1995
Scott Shaw,"['Cayman Islands', 'Eritrea']",Artist,1875,30,40,1905
Charlene Cortez,"['Slovenia', 'Fiji']",Artist,1915,30,18,1945
Jacob Nelson,['Nigeria'],Politician,1910,27,31,1937
Douglas Austin,"['Sweden', 'Niger']",Artist,1875,6,58,1881
Randy Fletcher,['Cook Islands'],Politician,1913,31,49,1944
Charles Reyes Jr.,"['Chad', 'United Arab Emirates']",Military personnel,1910,63,13,1973
Pamela Huerta,"['Pitcairn Islands', 'Guatemala']",Entrepreneur,1870,83,20,1953
William Young,['Gibraltar'],Artist,1909,39,86,1948
Steven Smith,['Montserrat'],Artist,1880,3,23,1883
Ashley Hernandez,"['Comoros', 'Maldives']",Artist,1889,50,72,1939
Lori Brown,"['Pitcairn Islands', 'Monaco']",Athlete,1902,49,21,1951
Darryl Griffin,['Eritrea'],Military personnel,1894,29,58,1923
Linda Webb,"['Niue', 'Norway']",Engineer,1919,65,22,1984
Elaine Thompson,"['Saint Helena', 'Venezuela']",Artist,1911,72,39,1983
Stephanie Thomas,"['Burundi', 'Netherlands Antilles']",Journalist,1913,42,38,1955
Laurie Wood,['Mali'],Artist,1890,40,20,1930
Steve Day,['Guadeloupe'],Artist,1917,29,28,1946
Jordan Miller,['Moldova'],Artist,1907,41,40,1948
Curtis Miller,"['Central African Republic', 'Saint Vincent and the Grenadines']",Impostor,1910,52,40,1962
Albert Walker,"['Liechtenstein', 'Tuvalu']",Politician,1914,0,82,1914
Jessica Kennedy,"['Denmark', 'Bangladesh']",Artist,1879,7,0,1886
Kristina Noble,"['Ghana', ""Cote d'Ivoire""]",Artist,1891,15,73,1906
Alicia Watson,"['Slovenia', 'Macao']",Artist,1870,58,29,1928
Christine Carter,"[""Lao People's Democratic Republic""]",Artist,1923,18,79,1941
Angela Dudley,['British Indian Ocean Territory (Chagos Archipelago)'],Artist,1884,0,46,1884
Alexandria Sampson,['Myanmar'],Artist,1875,17,35,1892
Jocelyn Lamb,"['Guinea-Bissau', 'Lithuania']",Politician,1920,73,71,1993
Allison Suarez,['United Arab Emirates'],Cinematographer,1895,40,6,1935
Courtney Henderson,"['New Caledonia', 'Turkmenistan']",Artist,1878,11,0,1889
John Bryant,['Guadeloupe'],Politician,1901,60,19,1961
Jacob Johnson,"['British Virgin Islands', 'Guatemala']",Artist,1908,48,45,1956
Lisa Brown,"['Honduras', 'Brazil']",Researcher,1916,6,36,1922
Michael Sutton,"['Micronesia', 'Uganda']",Ballet dancer; ballet master; choreographer; theater director,1904,49,82,1953
Tonya Russell,['Svalbard & Jan Mayen Islands'],Military personnel,1901,66,29,1967
Kent Webb,['Liberia'],Artist,1902,38,23,1940
Theresa Arnold,['Nicaragua'],Researcher,1921,37,28,1958
Ann Sanders,['Monaco'],Artist,1873,39,31,1912
Jonathan Barrett,"['Hungary', 'Thailand']",Researcher,1874,14,56,1888
Kyle Davidson,['Bermuda'],Artist,1922,47,22,1969
Lauren Malone,"['Tuvalu', 'Cape Verde']",Military personnel,1911,76,13,1987
Fernando Cardenas,"['Zimbabwe', 'Vietnam']",Artist,1917,80,12,1997
Eric Mitchell Jr.,['Christmas Island'],Artist,1915,37,2,1952
Patricia Jackson,['Martinique'],Artist,1907,72,69,1979
Kimberly Cook,"['Faroe Islands', 'Liechtenstein']",Artist,1871,13,87,1884
Patrick Strong,"[""Cote d'Ivoire""]",Artist,1871,30,39,1901
Anthony Short,"['Korea', 'Western Sahara']",Artist,1912,34,84,1946
Melanie Howard,['Saint Kitts and Nevis'],Military personnel,1909,87,23,1996
Michael Hughes,['Congo'],Artist,1908,74,23,1982
Jaime Brady,"['Bhutan', 'Dominican Republic']",Musher,1894,84,70,1978
Holly Blanchard MD,"['Chad', 'Germany']",Artist,1915,31,64,1946
Michelle Cline,"['Guinea', 'British Virgin Islands']",Researcher,1871,37,50,1908
Kristen Beltran,"['Vanuatu', 'Belize']",Researcher,1872,20,87,1892
Tracy Ferguson,['Guyana'],Artist,1909,16,81,1925
James Anderson,['Kyrgyz Republic'],Artist,1904,52,84,1956
Mark Underwood,['Congo'],Religious figure,1919,75,39,1994
Kirsten Ortiz,"['Haiti', 'Palestinian Territory']",Artist,1892,33,43,1925
Kaitlyn Williams,['Sweden'],Politician,1898,67,27,1965
James Smith,['Peru'],Artist,1915,86,83,2001
Raymond Bishop,['Senegal'],Artist,1909,89,4,1998
Jessica Howell,['Australia'],Military personnel,1922,6,22,1928
Lisa Williams,['Sao Tome and Principe'],Artist,1886,74,37,1960
Jenny Livingston,['Uzbekistan'],Professional wrestler,1914,38,79,1952
Kimberly Grant,['Suriname'],Artist,1894,74,89,1968
Laura Combs,['Congo'],Military personnel,1908,1,65,1909
Catherine Jensen,['Guyana'],Motorcycle racer,1879,66,68,1945
Marc Griffin,['Slovenia'],Military personnel,1903,26,77,1929
Neil Leach,"['Chile', 'United States Virgin Islands']",Artist,1900,24,77,1924
David Johns,['British Virgin Islands'],Artist,1917,8,29,1925
Laura Ramirez,"['Guyana', 'Nauru']",Athlete,1905,59,47,1964
Jessica Anderson,['Slovakia (Slovak Republic)'],Artist,1911,79,86,1990
Thomas Sanchez,['Micronesia'],Military personnel,1882,85,54,1967
Melissa Ayers,['Dominica'],Researcher,1885,31,13,1916
Kayla Davis,['Seychelles'],Artist,1891,64,17,1955
Jessica Webb,['Cocos (Keeling) Islands'],Politician,1877,74,8,1951
Eric Rodriguez,"['Qatar', ""Cote d'Ivoire""]",Activist; founder,1917,82,74,1999
Glenda Cruz,"['Norfolk Island', 'Monaco']",Entrepreneur,1907,27,64,1934
Sean Fox,"['Slovenia', 'Cuba']",Athlete,1878,14,60,1892
Matthew Nguyen,['San Marino'],Artist,1878,3,35,1881
Kevin Hodges,"['Gabon', 'Western Sahara']",Athlete,1918,26,75,1944
Cory Williams,"['Namibia', 'Angola']",Politician,1898,27,9,1925
Alisha Maddox MD,"['Yemen', 'Niger']",Artist,1887,47,1,1934
Valerie Martin,"['Saint Lucia', 'Denmark']",Artist,1921,45,41,1966
Robert Jones,"['Benin', 'Belize']",Artist,1887,58,1,1945
Tony Miller,['Uruguay'],Artist,1895,54,62,1949
Mackenzie Smith,['Germany'],Artist,1923,6,17,1929
Paul Jones,['Croatia'],Artist,1885,82,36,1967
Kelly Turner,['Portugal'],Politician,1911,60,30,1971
Thomas Martinez,['Comoros'],Politician,1882,68,75,1950
Christopher Everett,['Netherlands Antilles'],Alpine skier,1903,29,23,1932
Connie Pace,['Guernsey'],Artist,1915,48,77,1963
Alison Young,['Korea'],Politician,1874,44,17,1918
John Wilson,"['Cambodia', 'South Africa']",Politician,1896,48,12,1944
Douglas Moore,['Northern Mariana Islands'],Artist,1877,46,73,1923
Barry Hunter,['Poland'],Athlete,1901,60,7,1961
Christopher Dyer,"['Papua New Guinea', 'Monaco']",Athlete,1923,28,75,1951
Joseph Hardy,"['Pakistan', 'Bouvet Island (Bouvetoya)']",Artist,1923,20,60,1943
Christina Buckley,"['Samoa', 'Senegal']",Military personnel,1893,76,9,1969
Kenneth Williams,['Moldova'],Artist,1879,50,52,1929
Eric Martin,['Norfolk Island'],Artist,1908,35,83,1943
Jason Carter,['Slovenia'],Racing driver; formula one driver,1900,13,31,1913
Mrs. Brooke Jones,['Isle of Man'],Military personnel,1873,19,88,1892
Stephanie Morris,['Nigeria'],Artist,1880,10,73,1890
Mrs. Marissa Carr MD,['Marshall Islands'],Editor,1904,21,66,1925
Briana Young,"['Costa Rica', 'Israel']",Military personnel,1878,12,25,1890
Aaron Bell,['Grenada'],Criminal,1893,42,60,1935
Sara Jacobs,['Turkmenistan'],Politician,1885,84,48,1969
Samantha Leon,"['China', 'Monaco']",Artist,1871,24,71,1895
Eric Trevino,"['Congo', 'Bouvet Island (Bouvetoya)']",Artist,1906,62,84,1968
Kimberly Barnes,"['Switzerland', 'French Southern Territories']",Artist,1901,11,48,1912
Jennifer Adams,"['Luxembourg', 'Cape Verde']",Politician,1910,18,85,1928
Pamela Hart,"['Greenland', 'Uganda']",Artist,1879,60,18,1939
Johnathan Chandler,"['United States of America', 'China']",Artist,1908,70,32,1978
Nicholas Owens,['Palestinian Territory'],Politician,1873,3,29,1876
Nancy Powell,['Luxembourg'],Artist,1921,64,53,1985
John Bush,['Nepal'],Politician,1916,34,7,1950
Daniel Calhoun,['Andorra'],Politician,1920,30,40,1950
Nancy Smith,"['Portugal', 'Bahamas']",Nun; christians jehovahâ€™s witnesses,1885,71,49,1956
Marissa Gray,"['Suriname', 'Ireland']",Artist,1891,36,1,1927
Anthony Olson,['Cambodia'],Artist,1894,88,56,1982
Patrick Wright,['Anguilla'],Politician,1894,5,11,1899
Andre Thompson,"['Switzerland', 'Netherlands']",Military personnel,1890,84,11,1974
Rebecca Ward,['Bahrain'],Artist,1914,79,10,1993
Matthew Diaz,['Saint Barthelemy'],Researcher,1895,2,26,1897
Danny Russell,['San Marino'],Artist,1905,20,75,1925
Emily Cruz,['Cape Verde'],Artist,1910,2,4,1912
Andrew Roth,"['Zimbabwe', 'Kyrgyz Republic']",Politician,1911,27,37,1938
Nicole Glenn,['Egypt'],Politician,1897,69,56,1966
Henry Ortiz,['Netherlands Antilles'],Politician,1919,84,43,2003
Ryan Miller,['Croatia'],Female guards in nazi concentration camps; concentration camp guard,1921,73,35,1994
Michele Kim,"['Sri Lanka', 'Cyprus']",Artist,1875,83,71,1958
Timothy Hall,"['Algeria', 'Tajikistan']",Aikidoka; judoka; karateka,1919,7,13,1926
Tiffany Gonzalez,['Svalbard & Jan Mayen Islands'],Artist,1874,64,15,1938
Larry Snyder MD,"['Guadeloupe', 'New Caledonia']",Military personnel,1895,5,42,1900
Renee Duarte,"['Botswana', 'Norfolk Island']",Artist,1909,31,7,1940
Alex Lewis,['Turkey'],Military personnel,1899,34,4,1933
Paul Butler,['Aruba'],Artist,1873,17,70,1890
Kathleen Huerta,['Guam'],Explorer,1892,68,69,1960
Michelle Stone,['Cocos (Keeling) Islands'],Duke,1888,81,33,1969
John Allen,['India'],Serial killer,1914,56,80,1970
Amanda Bradley,"['Brazil', 'Cambodia']",Artist,1893,23,41,1916
Crystal Lam,['Norfolk Island'],Athlete,1897,73,12,1970
Scott Davis,['Pakistan'],Politician,1909,81,48,1990
Ashley Russo,"['Ireland', 'Libyan Arab Jamahiriya']",Military personnel,1896,58,71,1954
Bryce Lewis,"['Central African Republic', 'Costa Rica']",Artist,1898,8,9,1906
Amy Jackson,"['Liberia', 'Djibouti']",Researcher,1880,48,57,1928
Colleen Douglas,['Poland'],Researcher,1885,12,35,1897
Christopher Morris,"['Malta', 'Lesotho']",Businessperson,1891,81,84,1972
Elizabeth Fischer,"['Denmark', 'Sweden']",Artist,1877,73,67,1950
Crystal Davis PhD,['Korea'],Politician,1903,82,15,1985
Whitney Wallace,"['Sierra Leone', 'Slovenia']",Military personnel,1882,44,25,1926
Jacob Moon,['Oman'],Artist,1906,83,4,1989
Kelly Guerrero,['Eritrea'],Artist,1914,53,86,1967
Anthony Davis,['Niger'],Athlete,1889,41,0,1930
Miranda Schwartz,['Central African Republic'],Artist,1910,23,54,1933
Mary Martinez,['Saint Vincent and the Grenadines'],Politician,1901,61,34,1962
Daniel Smith,"['Falkland Islands (Malvinas)', 'Northern Mariana Islands']",Military personnel,1920,1,23,1921
Ryan Frazier,['Myanmar'],Prostitute,1898,20,61,1918
Abigail Jackson,['Mauritius'],Artist,1879,3,67,1882
Jorge Johnson,"['Portugal', 'Colombia']",Artist,1891,16,85,1907
Frederick Rush,['Iceland'],Cook; restaurateur,1905,6,68,1911
Steven Grant,"['Colombia', 'Kyrgyz Republic']",Artist,1901,42,22,1943
Mr. Thomas Russo,"['Vanuatu', 'Mongolia']",Researcher,1884,8,3,1892
Adam Cummings,['Malaysia'],Researcher,1879,47,17,1926
Taylor Miller,"['Korea', 'Libyan Arab Jamahiriya']",Artist,1881,26,14,1907
John Smith,"['Mauritius', 'Western Sahara']",Artist,1919,43,61,1962
Scott Summers,"['Nauru', 'Bangladesh']",Artist,1877,50,63,1927
Crystal Wall,['Papua New Guinea'],Teacher,1893,17,32,1910
Karen Owens,"['Niue', 'New Caledonia']",Researcher,1911,69,65,1980
Tina Adams,['Turkmenistan'],Politician,1905,5,5,1910
Rhonda Jones,['Sierra Leone'],Tribal chief,1917,45,3,1962
Shelly Harris,['Saint Helena'],Politician,1900,72,77,1972
Larry Rush,['Jersey'],Politician,1877,45,61,1922
Matthew James,['Zambia'],Artist,1910,31,46,1941
Brian Stevens,['Isle of Man'],Military personnel,1885,60,69,1945
Sara Parker DVM,"['Georgia', 'Guadeloupe']",Regent,1871,82,62,1953
Justin Wallace,"['New Caledonia', 'Djibouti']",Military personnel,1896,0,83,1896
Scott Davidson,['Norfolk Island'],Artist,1913,26,29,1939
James Baldwin,['South Georgia and the South Sandwich Islands'],Artist,1902,72,11,1974
Shane Adams,"['Vanuatu', 'Cuba']",Artist,1876,49,2,1925
Trevor Guerra PhD,"['Turks and Caicos Islands', 'Micronesia']",Researcher,1915,48,18,1963
Renee Gould,"['Saint Kitts and Nevis', 'Finland']",Artist,1901,33,60,1934
Raymond Kaiser,['Oman'],Artist,1887,56,36,1943
Nicole Mclaughlin,"['British Virgin Islands', 'Guinea']",Researcher,1896,28,76,1924
John Mcpherson,['Maldives'],Researcher,1888,44,36,1932
Cynthia Johnson,['Korea'],Literary critic; novelist,1882,9,77,1891
George Ramirez,"['Slovenia', 'Cayman Islands']",Physician,1908,12,88,1920
Cindy Bryant,['Nauru'],Entrepreneur,1921,33,68,1954
Brian Rodriguez,"['Korea', 'Maldives']",Political activist; newspaper editor,1900,27,39,1927
Lynn Wood,"['Korea', 'Uruguay']",Artist,1910,33,57,1943
Greg Mccall,['Pakistan'],Artist,1899,22,53,1921
Justin Cruz,['Angola'],Circus performer; amateur wrestler,1890,5,52,1895
Matthew Saunders,"['Luxembourg', 'Cyprus']",Astrologer,1911,21,85,1932
Melissa Murphy,['New Caledonia'],Artist,1882,73,73,1955
Sarah Serrano DDS,['Puerto Rico'],Navigator; officer of the french navy,1887,75,33,1962
Devon Jackson,['Hungary'],Artist,1911,77,55,1988
Annette Flores,"['Slovenia', 'Spain']",Politician,1870,10,10,1880
Beth Vega,"['Sierra Leone', 'Iran']",Politician,1890,84,35,1974
Robert Williams,"['Martinique', 'Jamaica']",Military personnel,1906,10,64,1916
Megan Taylor,['Bahamas'],Businessperson,1878,8,8,1886
Thomas Lewis,['Bouvet Island (Bouvetoya)'],Artist,1906,88,76,1994
Jason Greene,['Iceland'],Politician,1916,77,49,1993
Edward Riley,"['Isle of Man', 'New Zealand']",Politician,1876,4,32,1880
Cristina Wilkins,"['Niger', 'Western Sahara']",Artist,1878,33,54,1911
Anthony Thomas,['Falkland Islands (Malvinas)'],Artist,1917,44,4,1961
Gerald Blanchard,"['Venezuela', 'Suriname']",Artist,1886,23,0,1909
Emily Perry,"['Senegal', 'Niue']",Artist,1875,12,57,1887
Justin Coleman,"['Thailand', 'Guernsey']",Monarch,1911,83,15,1994
Donald Carpenter,['Isle of Man'],Artist,1881,53,55,1934
Martha Smith,"['French Southern Territories', 'French Southern Territories']",Artist,1880,6,8,1886
Shawna Harrison,['Central African Republic'],Artist,1920,3,54,1923
Steven Garner,['Lesotho'],Researcher,1902,24,7,1926
Timothy Lee,"[""Lao People's Democratic Republic"", 'Iran']",Politician,1905,2,38,1907
Taylor Lin,"['Palestinian Territory', 'Tuvalu']",Artist,1873,42,64,1915
Andrew Cantu,"['Anguilla', ""Cote d'Ivoire""]",Criminal,1882,43,19,1925
Amanda Ross,"['Yemen', 'Jamaica']",Artist,1889,35,29,1924
James Cunningham,['Italy'],Artist,1921,16,3,1937
Lauren Williams,['Nauru'],Artist,1877,42,25,1919
Jonathan Harris,['Niue'],Artist,1879,0,41,1879
Tammy Middleton,['Nigeria'],Athlete,1907,30,15,1937
Michelle Blair,['Japan'],Athlete,1874,43,13,1917
Caroline Sullivan,['Poland'],Politician,1917,0,50,1917
Samantha Waller,['Burkina Faso'],Athlete,1892,0,61,1892
Angel Pratt,"['Tonga', 'Swaziland']",Artist,1905,13,12,1918
Marie Robinson,['Equatorial Guinea'],Athlete,1894,13,74,1907
Roger Neal,"['Saint Pierre and Miquelon', 'Mexico']",Researcher,1881,88,66,1969
Terry Carney,"['Western Sahara', 'Bulgaria']",Athlete,1878,70,62,1948
Anthony Wilson,['Antigua and Barbuda'],Artist,1912,45,7,1957
Thomas Vasquez,"['British Indian Ocean Territory (Chagos Archipelago)', 'Papua New Guinea']",Journalist,1917,14,3,1931
Adrian Mcgee,"['Azerbaijan', 'Bahamas']",Politician,1900,3,69,1903
Mary Lopez DDS,['Congo'],Artist,1908,6,55,1914
Laura Bruce,"['Armenia', 'Cuba']",Artist,1891,41,25,1932
James Allen,"['Djibouti', 'Bouvet Island (Bouvetoya)']",Artist,1878,59,22,1937
Marcus Hernandez,"['Micronesia', 'Mayotte']",Artist,1894,61,30,1955
Kimberly Murphy,"['Cameroon', 'Holy See (Vatican City State)']",Politician,1882,29,66,1911
Tyler Delgado,['Bahamas'],Artist,1912,42,58,1954
Caitlin Melendez,"['Montenegro', 'Luxembourg']",Artist,1884,75,23,1959
Scott Lynch,"['Nicaragua', 'Guinea']",Artist,1912,59,71,1971
Christina King,['Tokelau'],Social worker; social activist; philanthropist; autobiographer; humanitarian,1881,6,26,1887
Zachary Shields,"['Sierra Leone', 'Ghana']",Politician,1921,46,15,1967
Jessica Perry,"['Sao Tome and Principe', 'Guam']",Artist,1885,7,8,1892
Andrew Ryan,"['Sudan', 'Venezuela']",Politician,1874,85,70,1959
Clinton Durham,['Myanmar'],Politician,1904,46,75,1950
Wayne Burns,"['Guinea', 'San Marino']",Artist,1918,85,36,2003
Robert Leonard,"['Cyprus', 'Reunion']",Artist,1877,42,67,1919
Alexa Hurley,"['Solomon Islands', 'Wallis and Futuna']",Researcher,1902,36,76,1938
George Sanders,"['Myanmar', 'Lesotho']",Athlete,1919,34,43,1953
Daniel Brock,['Congo'],Artist,1917,86,79,2003
Michael Gutierrez,"['Guernsey', 'Tajikistan']",Naval officer,1875,69,55,1944
Caitlin Stephenson,['Iran'],Artist,1897,20,63,1917
Richard Jacobson,['Togo'],Artist,1907,23,56,1930
Richard Smith,"['Libyan Arab Jamahiriya', 'Ghana']",Anthropologist,1877,3,88,1880
Kristin Edwards,['Maldives'],Politician,1885,51,18,1936
Teresa Hines,['Heard Island and McDonald Islands'],Military personnel,1870,60,71,1930
Jennifer Black,['Papua New Guinea'],Researcher,1909,53,2,1962
Cheryl Garcia,['Gabon'],Psychiatrist,1878,47,12,1925
Jessica Martin,"['Ukraine', 'Russian Federation']",Artist,1924,78,78,2002
Kristy Johnson,"['Bouvet Island (Bouvetoya)', 'Liechtenstein']",Researcher,1924,64,67,1988
Martin Smith,"['Tokelau', 'Central African Republic']",Researcher,1882,66,87,1948
Angela Evans,"['Norfolk Island', 'Zambia']",Artist,1920,71,88,1991
Jennifer Burns,"['Jamaica', 'Qatar']",Researcher,1904,35,64,1939
Cynthia Armstrong,"['Madagascar', 'Angola']",Artist,1919,3,45,1922
Nicole Adams,"['American Samoa', 'Belize']",Politician,1901,78,25,1979
Tracy Sanders,"['Serbia', 'Sudan']",Artist,1916,63,74,1979
Christopher Garcia,"['Bosnia and Herzegovina', 'Botswana']",Artist,1910,57,0,1967
Bruce White,"['Denmark', 'Isle of Man']",Military personnel,1906,26,56,1932
Sharon Huff,"['French Polynesia', 'South Georgia and the South Sandwich Islands']",Military personnel,1908,89,36,1997
Michelle Jenkins,"['Mauritania', 'Pakistan']",Politician,1887,81,86,1968
Michael Smith,"['Belgium', 'Ukraine']",Artist,1899,42,23,1941
Roy Sherman,"['Kyrgyz Republic', 'Pakistan']",Artist,1898,82,89,1980
Deanna Chambers,"['Mongolia', 'Turks and Caicos Islands']",Artist,1872,9,72,1881
David Ross,['Philippines'],Politician,1874,82,0,1956
Katherine Bautista,"['China', 'Cocos (Keeling) Islands']",Artist,1913,47,4,1960
Crystal Logan,"['Afghanistan', 'Congo']",Researcher,1895,63,59,1958
Anthony Morrison,"['Hong Kong', 'Bouvet Island (Bouvetoya)']",Politician,1922,46,45,1968
Trevor Ballard,"['Bermuda', 'Turkey']",Politician,1871,32,14,1903
Elizabeth Bishop,['Montenegro'],Military personnel,1916,7,18,1923
Joseph Floyd,"['Croatia', 'Sierra Leone']",Researcher,1911,2,19,1913
Michelle Williamson,"['French Guiana', 'Argentina']",Businessperson,1892,3,7,1895
Joan Perry,['Mozambique'],Architect,1917,51,41,1968
Taylor Colon,['Burundi'],Artist,1885,16,89,1901
Catherine Davis,['Croatia'],Politician,1889,0,48,1889
Christopher Johnson,"['Dominican Republic', 'Sierra Leone']",Military personnel,1899,33,0,1932
Sara Russell,['Indonesia'],Athlete,1890,67,33,1957
Andrew Cole,['Latvia'],Artist,1882,65,69,1947
Jeffrey Norton,['Liberia'],Artist,1918,43,74,1961
Matthew Scott,"['Kuwait', 'Nigeria']",Politician,1895,73,5,1968
Christopher Hardin,"['Italy', 'France']",Artist,1915,57,48,1972
Jillian Johnson,"['United States of America', 'Tunisia']",Artist,1873,51,84,1924
Kenneth Scott,"['Guadeloupe', 'Bahamas']",Artist,1892,46,48,1938
Jared Hernandez,['Tanzania'],Artist,1911,61,60,1972
Crystal Allen,"['Saint Barthelemy', 'Oman']",Researcher,1887,78,58,1965
Craig Rodriguez,['Congo'],Artist,1870,52,78,1922
Stephanie Kane,"['Peru', 'United States of America']",Artist,1878,63,10,1941
Jasmine Sullivan,"['Marshall Islands', 'Sudan']",Artist,1898,71,55,1969
Victor Neal,"['Gibraltar', 'Guatemala']",Psychoanalyst,1882,31,48,1913
Mark Scott,"['Brazil', 'Saint Barthelemy']",Artist,1918,4,32,1922
Megan Young,['Central African Republic'],Artist,1880,85,13,1965
Brittany Crawford,"['Saint Vincent and the Grenadines', 'British Virgin Islands']",Artist,1906,43,41,1949
Jennifer Phillips,['Slovakia (Slovak Republic)'],Artist,1895,48,68,1943
Paul Dixon,"['British Virgin Islands', 'British Indian Ocean Territory (Chagos Archipelago)']",Athlete,1924,22,64,1946
Bruce Williams,['Namibia'],Politician,1887,63,68,1950
Jason Evans,['Paraguay'],Artist,1886,14,44,1900
Brian Huerta,"['Senegal', 'Nepal']",Artist,1874,88,40,1962
Patricia Zimmerman,['Japan'],Artist,1919,16,57,1935
Cory Harris,['Central African Republic'],Artist,1909,29,10,1938
Nicole Davis,"['Liechtenstein', 'Peru']",Artist,1887,77,40,1964
Matthew Thomas,['Uganda'],Artist,1897,50,75,1947
Karina Jones,"['Cayman Islands', 'New Caledonia']",Politician,1922,5,57,1927
Gabriel Stout,['Rwanda'],Artist,1880,14,8,1894
Sean Reese,"['Indonesia', 'Montenegro']",Artist,1875,84,6,1959
Larry Boone,"['Tokelau', 'Anguilla']",Artist,1920,68,70,1988
Patrick Knight,['Andorra'],Artist,1879,9,88,1888
Virginia Hernandez,"['United States Virgin Islands', 'Hong Kong']",Artist,1878,88,37,1966
Lynn Church,"['Panama', 'Bulgaria']",Artist,1870,74,55,1944
Maria Williams,['Kuwait'],Athlete,1910,3,4,1913
Audrey Dawson,"['Cape Verde', 'Uganda']",Politician,1871,12,78,1883
Mrs. Marissa Scott,"['Palestinian Territory', 'Uruguay']",Artist,1873,33,51,1906
Trevor Foster,['Montenegro'],Artist,1902,62,35,1964
Jose Maddox,['Saint Vincent and the Grenadines'],Artist,1905,10,19,1915
Brittany Cox,['Syrian Arab Republic'],Businessperson,1913,24,86,1937
Michael Estrada,"['Haiti', 'Oman']",Explorer,1893,39,76,1932
Eric Lopez,"['Belize', 'Iraq']",Athlete,1878,21,55,1899
Johnny Cobb,"['Turks and Caicos Islands', 'Finland']",Athlete,1880,75,34,1955
Kristin Johnston,"['Heard Island and McDonald Islands', ""Cote d'Ivoire""]",Artist,1903,23,58,1926
Katrina Henry,"['Morocco', 'New Caledonia']",Entrepreneur,1870,27,59,1897
Cindy Bass,"['Western Sahara', 'Saint Pierre and Miquelon']",Researcher,1880,16,54,1896
Christopher Castillo,['Latvia'],Artist,1897,67,20,1964
John Graves,"['Estonia', 'Senegal']",Politician,1873,58,67,1931
Beth Johnson,"['Japan', 'Azerbaijan']",Researcher,1906,6,28,1912
Amanda Martinez,"['Sao Tome and Principe', 'Niger']",Cinematographer,1885,23,28,1908
James Hendrix,['Kazakhstan'],Artist,1921,88,4,2009
Connor Callahan,"['Papua New Guinea', 'Turks and Caicos Islands']",Serial killer; criminal,1917,58,68,1975
Danny Richards,['Macao'],Politician,1879,89,31,1968
Amber Knight,"['Thailand', 'Turkmenistan']",Artist,1904,63,54,1967
Wayne Oliver,"['Central African Republic', 'Antarctica (the territory South of 60 deg S)']",Politician,1897,71,32,1968
Rebecca Black,"['French Polynesia', 'Montenegro']",Politician,1919,63,66,1982
Daniel Chandler,"['Tunisia', 'Japan']",Politician,1917,88,63,2005
Christina Mann,"['Greece', 'Mali']",Artist,1906,17,76,1923
Gerald Fox,['Afghanistan'],Artist,1891,77,63,1968
Valerie Morris,"['British Indian Ocean Territory (Chagos Archipelago)', 'Kiribati']",Researcher,1916,74,48,1990
Diane Smith,"['Monaco', 'Burundi']",Artist,1907,39,50,1946
Brandon Duarte,"['Bolivia', 'Gabon']",Military personnel,1881,79,16,1960
Dan Miller,['New Zealand'],Politician,1892,82,64,1974
Daniel Torres,"['New Caledonia', 'Bhutan']",Politician,1880,57,10,1937
Joseph Thomas,['Cyprus'],Researcher,1872,2,27,1874
James Wright,['Greece'],Artist,1876,65,0,1941
Brian Estrada,['Tuvalu'],Artist,1888,50,51,1938
Justin Perry,['Poland'],Samurai,1887,24,13,1911
Stephanie Howard,['Saudi Arabia'],Artist,1907,14,48,1921
Laura Thompson,['Malta'],Athlete,1887,33,62,1920
Ruben Brooks,"['Honduras', 'North Macedonia']",Entrepreneur,1914,3,11,1917
Sarah Barr,"['Bermuda', 'Serbia']",Artist,1875,6,67,1881
Misty Hayes,"['Mexico', 'Nicaragua']",Artist,1872,84,38,1956
Shane Jones,"['Isle of Man', 'Djibouti']",Politician,1874,63,56,1937
Alexander Ferguson,"['Turkey', 'Sri Lanka']",Motorcycle racer; racing automobile driver; formula one driver,1920,27,49,1947
Ronald Rodriguez,['Tokelau'],Businessperson,1895,37,2,1932
Tiffany Stone,['Niue'],Politician,1890,24,5,1914
Lisa Kirby,"['Guinea-Bissau', 'Sao Tome and Principe']",Politician,1912,60,86,1972
Amanda Nelson,['Timor-Leste'],Athlete,1909,67,55,1976
David Hill,"['Saint Kitts and Nevis', 'Isle of Man']",Politician,1903,48,73,1951
Richard Bryant,['Somalia'],Racing automobile driver; formula one driver,1886,0,33,1886
Daniel Best,['Iran'],Researcher,1917,47,42,1964
Robert Jenkins,['Falkland Islands (Malvinas)'],Artist,1889,60,55,1949
Lawrence Johnson,"['Nigeria', 'Montserrat']",Artist,1898,12,85,1910
Erica Miller,['Rwanda'],Artist,1906,49,20,1955
Matthew Russell,['Kazakhstan'],Cartographer,1877,5,38,1882
David Reed,['Palestinian Territory'],Artist,1907,57,82,1964
Sheri Patterson,"['Tuvalu', 'British Virgin Islands']",Artist,1877,43,74,1920
Mark Bullock,['North Macedonia'],Athlete,1882,3,50,1885
Eric Taylor,['Saint Martin'],Politician,1923,35,15,1958
Melissa Hamilton,"['Guadeloupe', 'Equatorial Guinea']",Artist,1906,43,85,1949
Christina Valdez,"['Mozambique', 'United States Minor Outlying Islands']",Teacher,1920,51,61,1971
James Flores,"['Cape Verde', 'Mali']",Artist,1914,37,29,1951
Debra Mercer,"['Seychelles', 'Papua New Guinea']",Artist,1921,25,2,1946
Chase Glass,['Afghanistan'],Religious figure,1910,52,73,1962
Julie Brown,['United Arab Emirates'],Religious figure,1875,10,36,1885
Oscar Clark,['Philippines'],Costume designer; fashion designer,1872,45,19,1917
Joseph Adams,['Guinea'],Artist,1876,33,85,1909
Jason King,"[""Lao People's Democratic Republic"", 'Western Sahara']",Researcher,1880,84,69,1964
Cynthia Thompson,['Seychelles'],Artist,1911,37,74,1948
Heather Hicks,"['Guinea-Bissau', 'Cayman Islands']",Military personnel,1908,41,88,1949
Dr. Tracey Glover,['Guatemala'],Politician,1871,74,40,1945
Alexander Henry,"['Belgium', 'Tokelau']",Politician,1900,51,72,1951
David Daniel,"['Saint Pierre and Miquelon', 'Thailand']",Teacher,1910,1,50,1911
Gary Jenkins,"['Tanzania', 'Cyprus']",Politician,1873,67,68,1940
Elizabeth Leon,"['Somalia', 'Ethiopia']",Teacher,1888,61,87,1949
Leslie Walker,['Tuvalu'],Conductor,1879,12,58,1891
Richard Owens,['Ghana'],Politician,1906,11,49,1917
Richard Hogan,"['Holy See (Vatican City State)', 'South Georgia and the South Sandwich Islands']",Businessperson,1905,6,3,1911
Sarah Hunter,"['Kazakhstan', 'Italy']",Serial killer,1871,2,58,1873
Michelle Willis,['Bangladesh'],Artist,1904,81,72,1985
Alexander Smith,['Micronesia'],Politician,1888,29,45,1917
Vincent Townsend,['Oman'],Researcher,1910,30,72,1940
Javier Woodward,"['Marshall Islands', 'Cayman Islands']",Resistance fighter,1886,65,73,1951
Meredith Carson,['Panama'],Artist,1905,37,35,1942
Mr. Kevin Underwood,['Mozambique'],Artist,1877,69,82,1946
Beverly Bell,['Cambodia'],Artist,1891,26,72,1917
Stephanie Wilson,"['Cuba', 'Norfolk Island']",Teacher,1914,44,44,1958
Stephanie Flores,"['Niue', ""Lao People's Democratic Republic""]",Artist,1922,14,84,1936
Tamara Russell,"['United States of America', 'Central African Republic']",Researcher,1887,27,64,1914
Zachary Green,['Cameroon'],Politician,1921,89,54,2010
Todd Hoffman,"['Canada', 'Anguilla']",Socialite,1884,29,56,1913
Katherine Hodge,"['Singapore', 'Spain']",Artist,1897,17,85,1914
Elizabeth Perez,['Portugal'],Alpine skier,1916,26,18,1942
Elizabeth Terrell,"['Portugal', 'Korea']",Military personnel,1906,11,64,1917
Christopher Jones,['Nicaragua'],Artist,1916,4,20,1920
Kevin Miller,['United Kingdom'],Artist,1877,34,62,1911
Tracy Adams,"['Fiji', 'Yemen']",Researcher,1872,44,72,1916
Mr. Charles Cline,"['Hungary', 'Dominica']",Politician,1887,73,13,1960
Nicholas Tran,['Luxembourg'],Athlete,1909,52,26,1961
Jill Nichols,"['Latvia', 'Turks and Caicos Islands']",Military personnel,1890,31,48,1921
Roger Allen,"['Heard Island and McDonald Islands', 'Germany']",Artist,1885,51,18,1936
Jean Mathews,['Reunion'],Politician,1918,39,76,1957
Anthony Fernandez,"['Congo', 'Niger']",Politician,1888,60,56,1948
Michael Arnold,['Austria'],Pretender; adventurer,1921,72,78,1993
Jonathan Walker,['Syrian Arab Republic'],Artist,1902,77,19,1979
Robert Rodriguez,"['Lesotho', 'United Kingdom']",Politician,1918,88,49,2006
Kathleen Anderson,['Micronesia'],Artist,1911,43,74,1954
Laura Marshall,"['Hungary', 'Sweden']",Artist,1897,48,32,1945
Tyler Ibarra,['Georgia'],Artist,1900,84,12,1984
Jason Le,"['Kazakhstan', 'Slovakia (Slovak Republic)']",Artist,1870,80,1,1950
Natasha Medina,"['Barbados', 'Paraguay']",Artist,1871,9,8,1880
David Davenport,"['Central African Republic', 'Reunion']",Artist,1914,64,51,1978
Sonya Johnson,['Madagascar'],Politician,1873,6,40,1879
Daniel Wade,['Papua New Guinea'],Politician,1918,31,63,1949
Jimmy Cameron,"['Russian Federation', 'Suriname']",Artist,1908,32,69,1940
Ashley Dickerson,"['Egypt', 'Sao Tome and Principe']",Physician,1906,52,31,1958
Kathryn Ortiz,['Madagascar'],Politician,1885,48,58,1933
Christopher Romero,['Belize'],Athlete,1880,85,18,1965
Jennifer Bean PhD,['Saint Vincent and the Grenadines'],Artist,1901,27,12,1928
Stacie Villegas,['Philippines'],Athlete,1924,74,10,1998
Richard Cowan,['Brazil'],Artist,1898,69,9,1967
Rachel Jones,['Denmark'],Artist,1897,76,28,1973
Casey Rowland,"['Botswana', 'Armenia']",Artist,1879,34,14,1913
Maria Beck,"['Zimbabwe', 'Saint Vincent and the Grenadines']",Artist,1910,50,49,1960
Andrew Griffith,"['New Zealand', 'Burkina Faso']",Artist,1889,21,61,1910
John Gross,['Slovenia'],Artist,1874,3,39,1877
David Taylor,"['Bahamas', 'Guatemala']",Artist,1907,80,28,1987
Kristy Mason DVM,"['Georgia', 'Saudi Arabia']",Military personnel,1898,16,78,1914
Gina Morrow,['Dominica'],Socialite,1884,50,58,1934
Brenda Lara,['Lebanon'],Artist,1888,27,14,1915
William White,['Belize'],Military personnel,1876,62,71,1938
Thomas Watkins,"['Tunisia', 'Solomon Islands']",Artist,1917,3,8,1920
Patricia Garcia,"['Isle of Man', 'Kuwait']",Politician,1870,27,34,1897
Monica King,"['Jamaica', 'Guadeloupe']",Artist,1898,59,7,1957
Daniel Wells,"['Mauritania', 'French Polynesia']",Researcher,1876,37,29,1913
Catherine Flores,['Georgia'],Artist,1907,55,15,1962
Paul Casey,['Greece'],Artist,1916,39,6,1955
Charles Morrow,"['Grenada', 'Iceland']",Athlete,1902,10,9,1912
Brent Coleman,"['Finland', 'Barbados']",Military personnel,1878,53,59,1931
Melissa Peters,"['Czech Republic', 'Saint Lucia']",Artist,1885,64,54,1949
Kara Summers,"['Belize', 'Thailand']",Researcher,1919,49,76,1968
Raymond Huffman,['Rwanda'],Athlete,1874,13,84,1887
George Smith,['Guam'],Politician,1881,63,69,1944
Edwin Wilson,"['Moldova', 'Djibouti']",Artist,1875,6,44,1881
Jessica Serrano,['Marshall Islands'],Politician,1882,58,31,1940
Matthew Booker,"['Paraguay', 'United States of America']",Gynaecologist,1904,77,53,1981
Shelley Norris,"['Canada', 'Afghanistan']",Military personnel,1908,73,60,1981
Alexandra Malone,['Montenegro'],Athlete,1891,57,22,1948
Jeremy Weaver,['French Southern Territories'],Military personnel,1901,45,83,1946
Brianna Hansen,['Canada'],Mangaka; lyricist,1915,49,57,1964
Roberta Logan,['Reunion'],Artist,1900,64,54,1964
Crystal Lewis,['Heard Island and McDonald Islands'],Religious figure,1904,89,8,1993
Anthony Sexton,['Lesotho'],Politician,1874,43,42,1917
Kathryn Miranda,"['Uganda', 'Algeria']",Politician,1889,5,18,1894
Kevin Taylor,"['Japan', 'Israel']",Artist,1873,23,8,1896
Nathaniel Francis,"['Greenland', 'Spain']",Military personnel,1879,67,42,1946
Daniel Henderson,"['Fiji', 'Northern Mariana Islands']",Model,1887,69,68,1956
Robert Jones,"['Palestinian Territory', 'Ethiopia']",Resistance fighter; oberstleutnant,1902,1,34,1903
Jason Gutierrez,['Aruba'],Artist,1871,19,36,1890
David Gonzales,['Guam'],Athlete,1883,44,13,1927
Noah Walker,['Croatia'],Researcher,1899,57,73,1956
Krystal White,"['Hong Kong', 'Germany']",Artist,1887,52,16,1939
Raven Watts,"['India', 'Falkland Islands (Malvinas)']",Artist,1892,67,38,1959
Brandon Bush,"['Finland', 'Senegal']",Entrepreneur,1916,30,84,1946
Wanda Smith,['Malta'],Artist,1911,60,52,1971
Shannon Clarke,"['France', 'South Georgia and the South Sandwich Islands']",Researcher,1883,57,28,1940
Steven Barnes,['Pakistan'],Artist,1918,76,7,1994
Michelle Vaughan,"['French Guiana', 'Togo']",Artist,1918,81,28,1999
Daniel Frazier,['Korea'],Artist,1884,30,10,1914
Steven Wilson,['Gibraltar'],Artist,1899,52,4,1951
John Smith,['Saint Lucia'],Concentration camp guard,1879,17,24,1896
Jerry Parker MD,['Macao'],Artist,1878,45,46,1923
Jennifer Townsend,"['Ethiopia', 'Somalia']",Researcher,1917,76,30,1993
Veronica Williams,['Fiji'],Businessperson,1878,32,63,1910
Elizabeth Miller,['Bosnia and Herzegovina'],Artist,1894,0,28,1894
Emily Solomon,['Holy See (Vatican City State)'],Politician,1893,26,29,1919
Denise Thomas,['Romania'],Artist,1891,38,41,1929
Jonathan Sanchez,"['Singapore', 'Azerbaijan']",Teacher,1899,28,6,1927
Sarah Castro,['Turkmenistan'],Researcher,1886,54,10,1940
Michele Williams,['Greece'],Politician,1915,80,45,1995
Andrew Hawkins,"['Congo', 'Spain']",Politician,1880,16,76,1896
Heather Banks,['Gambia'],Statesperson,1914,67,88,1981
Laura Mann,"['Portugal', 'Guatemala']",Researcher,1910,69,1,1979
Billy Powell,"['Finland', 'Liberia']",Torturer,1888,20,66,1908
Laura Ochoa,['Venezuela'],Artist,1920,27,21,1947
Brandon Vargas,['Saint Martin'],Artist,1918,0,22,1918
Deanna Nash,['Brunei Darussalam'],Politician,1905,83,61,1988
Stacy Weaver,['Cameroon'],Politician,1894,2,75,1896
Alisha Durham,"['Turkmenistan', 'Germany']",Athlete,1922,34,76,1956
Shannon Evans,['Comoros'],Artist,1911,56,2,1967
Jessica Kline,['Mayotte'],Politician,1883,4,53,1887
Ronald Neal,"['Ghana', 'Liberia']",Researcher,1878,47,82,1925
Ruth Skinner,"['Lithuania', 'Austria']",Artist,1880,19,5,1899
Lori Velazquez,"['San Marino', 'Turkey']",Politician,1896,77,11,1973
Wendy Lewis,['Serbia'],Politician,1911,18,5,1929
Mark Berry,"['Grenada', 'Ecuador']",Athlete,1896,32,29,1928
Richard Cisneros,"['Bangladesh', 'Papua New Guinea']",Politician,1895,47,85,1942
Anthony Anderson,"['Kenya', 'Albania']",Artist,1893,34,68,1927
Brandon Powers,"['Ireland', 'South Georgia and the South Sandwich Islands']",Athlete,1886,23,38,1909
Amy Strong,"['India', 'North Macedonia']",Artist,1873,5,35,1878
Richard Glenn,"['Guadeloupe', 'Seychelles']",Aristocrat,1871,22,37,1893
Breanna Pollard,"['Bahamas', 'Saudi Arabia']",Torturer; concentration camp guard,1876,42,24,1918
David Davis,"['Falkland Islands (Malvinas)', 'Monaco']",Artist,1907,15,62,1922
Christina Williams,['Saint Kitts and Nevis'],Athlete,1905,53,29,1958
Holly Henry,"['Morocco', 'French Guiana']",Dentist,1920,20,11,1940
Kevin Cummings,"['Kazakhstan', 'Bouvet Island (Bouvetoya)']",Religious figure,1913,85,6,1998
Angel Allison,"['Reunion', 'South Africa']",Resistance fighter; submariner; intelligence officer; naval officer,1881,42,47,1923
Jennifer Wells,"['Mauritania', 'Liberia']",Politician,1893,45,53,1938
Mary Brewer,"['Cuba', 'India']",Politician,1916,64,32,1980
Crystal Thomas,"['Czech Republic', 'Heard Island and McDonald Islands']",Artist,1906,13,75,1919
Amy Williams,['Slovakia (Slovak Republic)'],Artist,1900,82,64,1982
Marvin Pierce,['Congo'],Athlete,1908,89,68,1997
Hannah Krause,['Taiwan'],Artist,1919,55,84,1974
Noah Le,['Wallis and Futuna'],Artist,1920,69,67,1989
Kathryn Smith,"['Brunei Darussalam', 'United States Virgin Islands']",Athlete,1895,3,18,1898
James Ruiz,"['Myanmar', 'Benin']",Artist,1890,45,26,1935
Brianna Ochoa,"['Denmark', 'Libyan Arab Jamahiriya']",Athlete,1917,87,14,2004
Michael Stout,['Zimbabwe'],Cross-country skier,1872,35,51,1907
Andrea Brock,['Liechtenstein'],Artist,1904,14,67,1918
Marilyn Fowler,['Switzerland'],Politician,1875,52,20,1927
Peter Dillon,['Central African Republic'],Artist,1888,40,40,1928
Carol House,"['Pakistan', 'North Macedonia']",Artist,1921,70,25,1991
Veronica Richardson,['United States of America'],Artist,1883,55,42,1938
Kelli Ramirez,"['Portugal', 'Martinique']",Religious figure,1915,13,20,1928
Lee Parrish,['Syrian Arab Republic'],Artist,1905,78,9,1983
Vincent Mason,"['Hong Kong', 'Saint Pierre and Miquelon']",Politician,1904,89,29,1993
Kristina Gray,['Cuba'],Artist,1891,74,77,1965
Deborah Horn MD,"['Syrian Arab Republic', 'Montserrat']",Artist,1886,35,33,1921
Tricia Evans,"['Guinea-Bissau', 'Djibouti']",Artist,1880,26,69,1906
Michael Vasquez,"['Russian Federation', 'Ethiopia']",Politician,1891,43,5,1934
David Blackwell,"['Vanuatu', 'Suriname']",Military personnel,1875,11,0,1886
Corey Lee,['Chile'],Researcher,1911,2,47,1913
Christy Anderson,['Ireland'],Torturer,1896,82,80,1978
William Bauer,['Eritrea'],Artist,1878,21,20,1899
Dana Chambers,"['Romania', 'Barbados']",Religious figure,1877,46,34,1923
Jay Galvan,"['Uganda', ""Lao People's Democratic Republic""]",Politician,1921,75,32,1996
Maria Garrison,"['Turkey', 'Burkina Faso']",Researcher,1893,32,25,1925
Henry Lyons,['Vietnam'],Researcher,1908,9,8,1917
Maria Mccullough,"['Qatar', 'Guatemala']",Politician,1910,65,13,1975
Ryan Fowler,"['Morocco', 'Northern Mariana Islands']",Politician,1917,78,72,1995
Stephanie Perez,['Cocos (Keeling) Islands'],Artist,1875,32,56,1907
Patricia Wiley,"['Panama', 'United Arab Emirates']",Artist,1904,25,70,1929
Paul Singleton,['Gibraltar'],Politician,1892,66,75,1958
Travis Olson,"['Sierra Leone', 'Somalia']",Artist,1908,24,77,1932
Lori Perez,['Swaziland'],Politician,1879,69,37,1948
Scott Walker,"['Gibraltar', 'Cambodia']",Artist,1877,31,66,1908
Keith Peterson,['Norway'],Artist,1902,67,75,1969
Kristi Wall,"['Croatia', 'Burundi']",Artist,1907,47,36,1954
Abigail Garcia,"['Antigua and Barbuda', 'Moldova']",Artist,1904,14,80,1918
Daniel Rogers,['Bhutan'],Sailor,1874,30,19,1904
Rebecca Blackburn,"['Cook Islands', 'Switzerland']",Politician,1922,50,24,1972
Veronica Massey,"['Afghanistan', 'Thailand']",Artist,1884,81,7,1965
John Smith,['Bolivia'],Artist,1893,41,69,1934
Angela Shaw,"['French Southern Territories', 'Tunisia']",Researcher,1898,81,24,1979
Christopher Lynch,['Nepal'],Politician,1913,43,56,1956
Stacey Davila,"['Congo', 'Congo']",Artist,1905,29,27,1934
Brian Smith,['Greece'],Researcher,1870,6,88,1876
Katrina Johnson,['Saint Pierre and Miquelon'],Artist,1917,19,0,1936
Christina Martin,"[""Lao People's Democratic Republic""]",Marathon runner,1900,30,40,1930
Katelyn Davis,"['Monaco', 'Costa Rica']",Artist,1923,81,33,2004
Nicholas Jones,"['Saint Helena', 'Belarus']",Artist,1898,32,57,1930
William Powers,"['Japan', 'Vietnam']",Artist,1913,80,59,1993
Michelle Mcmahon,"['Romania', 'Norway']",Businessperson,1889,16,7,1905
Javier Martinez,"[""Cote d'Ivoire""]",Politician,1886,74,85,1960
Michael Scott,['Kyrgyz Republic'],Teacher,1879,38,0,1917
Andrew Dalton,['Nauru'],Artist,1898,88,48,1986
Barbara Harrison,['Tokelau'],Politician,1919,55,44,1974
Carla Delgado,"['Heard Island and McDonald Islands', 'Christmas Island']",Researcher,1921,57,3,1978
Deborah Francis,"['Swaziland', 'Mauritius']",Artist,1922,48,12,1970
Andrea Chapman,['Cape Verde'],Athlete,1882,65,41,1947
Andrea Merritt,"['Palau', 'Azerbaijan']",Nun; christians jehovahâ€™s witnesses,1876,6,65,1882
John Brown,['American Samoa'],Entrepreneur,1886,69,40,1955
Jason Elliott,['Faroe Islands'],Teacher,1875,89,50,1964
Aaron Gomez,"['United States of America', 'Colombia']",Artist,1878,30,7,1908
Krista Morgan,"['Jersey', 'Benin']",Researcher,1905,50,66,1955
Jason Williams,"['Saint Barthelemy', 'Pakistan']",Sultan,1920,24,29,1944
Daniel Jones,"['Svalbard & Jan Mayen Islands', 'Christmas Island']",Artist,1923,12,44,1935
Hunter Blake,['Congo'],Artist,1882,59,49,1941
Paul Ali,['Namibia'],Politician,1889,72,32,1961
Megan Patel,['Saudi Arabia'],Athlete,1873,48,1,1921
Heidi Walker,['United Kingdom'],Artist,1922,12,3,1934
Christopher Ramirez,['Bahrain'],Researcher,1881,14,56,1895
Cesar Robinson,"['Sierra Leone', 'Thailand']",Artist,1892,56,6,1948
Jennifer Merritt,['Korea'],Artist,1898,63,71,1961
Robin Meyer,['Congo'],Artist,1900,24,13,1924
Lauren Bennett,"['Cameroon', 'Czech Republic']",Criminal,1897,16,80,1913
Joshua Robinson,['Guinea-Bissau'],Athlete,1876,34,22,1910
Tina Morales,['Poland'],Researcher,1872,10,51,1882
Matthew Michael DDS,"['Cyprus', 'Ireland']",Artist,1886,13,25,1899
Hayden Ramirez,"['French Southern Territories', 'Poland']",Researcher,1871,35,40,1906
Anne Hawkins,['Belgium'],Artist,1920,67,89,1987
Elizabeth Thomas,"['Morocco', 'Saint Lucia']",Artist,1911,75,61,1986
Holly Snyder,"['Bahamas', 'Anguilla']",Military personnel,1886,25,7,1911
Chris Estrada,"[""Lao People's Democratic Republic""]",Artist,1870,0,15,1870
Kristi Costa,['Saint Kitts and Nevis'],Researcher,1887,0,89,1887
Melissa Hernandez,['Kyrgyz Republic'],Entrepreneur,1891,73,86,1964
Justin Ferguson,['Vietnam'],Politician,1904,19,60,1923
David Bass,"['Gabon', 'Pitcairn Islands']",Judge,1870,34,2,1904
Bradley Patterson,['Uganda'],Researcher,1870,34,86,1904
Christopher Berry DVM,"['Pitcairn Islands', 'Falkland Islands (Malvinas)']",Partisan,1907,52,52,1959
Steven Thompson,"['Haiti', 'Philippines']",Artist,1906,62,39,1968
Heidi Carpenter,['Andorra'],Politician,1899,15,45,1914
Teresa Castro,['Portugal'],Researcher,1878,11,8,1889
Kevin Lawrence,['Kiribati'],Athlete,1897,14,62,1911
Anthony Davis,"['Qatar', 'Gambia']",Artist,1923,65,46,1988
Megan Gonzales,"['Saint Lucia', 'Norway']",Artist,1879,14,6,1893
Kelsey Nelson,"['Niger', 'United Arab Emirates']",Politician,1882,60,9,1942
Noah Roberts,"['Mexico', 'Burundi']",Artist,1875,65,22,1940
Victoria Clark,['Russian Federation'],Artist,1900,11,27,1911
Anthony Wells,['Nicaragua'],Activist,1906,5,24,1911
Michelle Rogers,['Lebanon'],Athlete,1876,35,83,1911
Holly Stevens,['Netherlands Antilles'],Taxi driver,1878,80,59,1958
Mark Payne,['Mayotte'],Athlete,1901,7,27,1908
Dr. William Chapman,"['Gabon', 'Northern Mariana Islands']",Artist,1898,10,63,1908
Colin Price,['Saint Barthelemy'],Artist,1875,71,18,1946
Nicholas Caldwell,"['Egypt', 'Kyrgyz Republic']",Artist,1888,32,24,1920
Lauren Rice,"['Mongolia', 'Armenia']",Politician,1903,11,27,1914
Mark Nixon,['Faroe Islands'],Artist,1874,26,46,1900
Gary Rodriguez,"['Botswana', 'Faroe Islands']",Artist,1895,35,67,1930
Jared Allen,['Guernsey'],Artist,1873,82,81,1955
Shawn Davis,"['Guyana', 'Maldives']",Artist,1891,5,10,1896
Jennifer Greer,"['United Arab Emirates', 'Guadeloupe']",Artist,1899,88,60,1987
Kyle Barnes,"['Canada', 'Saint Helena']",Politician,1898,28,69,1926
Victoria Parks,['Timor-Leste'],Artist,1875,57,47,1932
Sharon Singleton,['Mali'],Artist,1893,78,60,1971
Brian Anderson,['Czech Republic'],Military personnel,1891,49,72,1940
Janet Stewart,['Taiwan'],Artist,1874,58,75,1932
Nicholas Christian,['Russian Federation'],Athlete,1897,72,6,1969
Allison Joyce,"['United Kingdom', 'Lithuania']",Politician,1910,48,30,1958
Eric Campbell,"['Saint Lucia', 'Saint Pierre and Miquelon']",Artist,1870,40,4,1910
Wendy Kelley,['Marshall Islands'],Artist,1873,26,21,1899
Scott Evans,"['Sudan', 'French Guiana']",Politician,1915,13,68,1928
Jose Jones,"['French Polynesia', 'Tunisia']",Artist,1875,11,67,1886
Dr. Andrew Morton,['Eritrea'],Artist,1923,22,71,1945
Tony West,['Iraq'],Politician,1902,85,44,1987
Troy Hardin,"['Saint Lucia', 'Argentina']",Politician,1891,5,29,1896
Paula House,['Zimbabwe'],Artist,1874,25,36,1899
Adrienne Alexander,"['Jamaica', 'Benin']",Artist,1873,50,22,1923
Misty Sullivan,['South Africa'],Military personnel,1903,78,32,1981
Brooke Hawkins,['Ecuador'],Artist,1874,14,86,1888
Robert Russell,"['Turkmenistan', 'United States Minor Outlying Islands']",Athlete,1911,3,63,1914
Donald Short,"['Korea', 'Turkmenistan']",Athlete,1916,22,29,1938
Brian Jackson,"['Lebanon', 'Malaysia']",Artist,1903,63,5,1966
Patricia Mclaughlin,"['Bouvet Island (Bouvetoya)', 'Vanuatu']",Criminal,1889,75,74,1964
Kevin Noble,"['Central African Republic', 'Guinea']",Artist,1883,81,18,1964
Matthew Jackson,"['Russian Federation', 'Guernsey']",Researcher,1922,16,33,1938
Judith Flores,"['Taiwan', 'Dominican Republic']",Artist,1918,85,76,2003
Brandon Rivera,['Morocco'],Artist,1874,23,24,1897
Thomas Santana,['United Arab Emirates'],Artist,1906,29,20,1935
Cynthia Murphy,"['French Guiana', 'Guatemala']",Artist,1911,89,74,2000
John Mathews,"['United Arab Emirates', 'China']",Researcher,1886,51,27,1937
Jose Strickland,['Fiji'],Artist,1873,55,85,1928
Chloe Love,"['Benin', 'Senegal']",Artist,1923,12,72,1935
Anthony Finley,"['Guernsey', 'Norfolk Island']",Athlete,1891,48,5,1939
Ronald Lewis,"['Guyana', 'Bahamas']",Military personnel,1878,29,38,1907
Jordan Ford,['Belgium'],Artist,1921,25,68,1946
Peter Olsen,['Honduras'],Secretary,1907,46,81,1953
Anthony Robertson,['Russian Federation'],Artist,1895,30,23,1925
Mary Goodman,['Vanuatu'],Researcher,1898,65,65,1963
Wanda Alexander,"['Luxembourg', 'Bangladesh']",Politician,1907,89,58,1996
Rhonda Kelly,"['Macao', 'Barbados']",Journalist,1918,15,27,1933
Gary Roberts,['Costa Rica'],Artist,1891,25,57,1916
Kathy Liu,['Cambodia'],Athlete,1891,56,54,1947
Jessica Clarke,"['Christmas Island', 'Micronesia']",Artist,1899,42,75,1941
Marcus Martinez,['Liechtenstein'],Politician,1877,16,5,1893
Amanda Mejia,['Christmas Island'],Artist,1872,17,82,1889
James Morse,['Djibouti'],Politician,1879,80,53,1959
Nathan Walsh,"['Angola', 'Senegal']",Artist,1920,43,23,1963
Benjamin Floyd,['Dominica'],Artist,1870,7,40,1877
Eric Davenport,"['Botswana', 'Ghana']",Artist,1876,32,80,1908
Justin Jenkins,"['Eritrea', 'British Indian Ocean Territory (Chagos Archipelago)']",Artist,1899,9,44,1908
Alex Keith,"['Tunisia', 'Tanzania']",Artist,1909,4,72,1913
Sandra Mendez,['Paraguay'],Artist,1885,59,0,1944
Peter Blake,"['Botswana', 'Sudan']",Researcher,1911,89,33,2000
Victor Avery,['Norway'],Politician,1886,8,14,1894
Troy Wood,"['Samoa', 'Dominican Republic']",Physician,1878,41,55,1919
Larry Ward,"['United States Minor Outlying Islands', 'India']",Politician,1916,30,8,1946
Timothy Mccormick,"['Sudan', 'Zambia']",Artist,1920,38,15,1958
Natalie Flynn,"['Faroe Islands', 'Switzerland']",Politician,1915,87,66,2002
Robin King,"['Slovenia', 'Armenia']",Athlete,1895,41,29,1936
Glenn Perry,['Haiti'],Artist,1917,51,52,1968
Paul Robinson,"['Saint Helena', 'Turkey']",Artist,1901,0,12,1901
Steven Blevins,"['Chad', 'Timor-Leste']",Artist,1879,38,81,1917
Ann Johnson,"['Marshall Islands', 'Saint Martin']",Researcher,1873,76,69,1949
Erik Wilkerson,['Malta'],Classical philologist,1882,32,10,1914
Kenneth Ferguson,"['Benin', 'Bahrain']",Politician,1894,55,45,1949
Lindsay Williams,"[""Cote d'Ivoire"", 'Somalia']",Artist,1879,75,54,1954
Beverly Tanner,['Montserrat'],Athlete,1915,58,70,1973
Ronald Wright,"['Burundi', 'Saint Pierre and Miquelon']",Politician,1882,16,86,1898
Samuel Kim,['Suriname'],Politician,1880,80,27,1960
Michael Duran,['Belize'],Researcher,1907,58,29,1965
Sandra Davis,"['Slovakia (Slovak Republic)', 'Germany']",Artist,1896,7,24,1903
Joshua Williams,['Slovakia (Slovak Republic)'],Artist,1894,25,20,1919
Richard Spencer,['Georgia'],Politician,1901,35,1,1936
Edgar Buchanan,['Australia'],Researcher,1919,72,17,1991
Allison Castillo,['Guernsey'],Artist,1895,16,10,1911
Brandy Long,"['Afghanistan', 'Haiti']",Artist,1904,57,19,1961
David Cunningham,['Aruba'],Artist,1875,78,65,1953
Karen Williams,['Rwanda'],Athlete,1887,56,61,1943
Julie Lindsey,"['Kuwait', 'Germany']",Artist,1872,35,35,1907
Julia Jackson,"['Anguilla', 'Kazakhstan']",Politician,1878,33,55,1911
Barbara Joseph,['Sierra Leone'],Politician,1921,41,44,1962
Erin Harvey,['Senegal'],Politician,1912,73,22,1985
Brandy Graham,"['Falkland Islands (Malvinas)', 'Christmas Island']",Artist,1873,39,66,1912
Zoe Garrett,"['Liberia', 'Vanuatu']",Politician,1920,10,11,1930
Ashley Flores DDS,"['Burundi', 'Dominica']",Entrepreneur,1873,3,69,1876
Jordan Wilson,['South Africa'],Artist,1876,70,62,1946
Victoria Randall,['Korea'],Artist,1882,20,76,1902
Anthony Brown,['Saint Martin'],Artist,1916,54,52,1970
Clinton Porter,"['Japan', 'Algeria']",Artist,1914,62,46,1976
Gina Montgomery,['Micronesia'],Artist,1873,37,86,1910
Brian Hughes,"['Kuwait', 'Netherlands']",Model,1907,37,0,1944
Howard Conway,"['Mozambique', 'Antarctica (the territory South of 60 deg S)']",Artist,1897,5,72,1902
Patrick Mcdowell,['Algeria'],Athlete,1911,68,25,1979
Aaron Whitaker,['Guinea-Bissau'],Politician,1898,66,49,1964
Courtney Harris,['Tonga'],Athlete,1923,8,52,1931
Amanda Keller,"['Swaziland', 'Moldova']",Alpine skier,1893,44,40,1937
Leah Hughes,"['Singapore', 'Benin']",Artist,1919,8,34,1927
Dylan Smith,['Isle of Man'],Athlete,1895,71,52,1966
Brian French,['Hong Kong'],Serial killer,1884,17,55,1901
Ryan Davenport,['Solomon Islands'],Artist,1915,61,5,1976
Sandra Hernandez,"['Reunion', 'Comoros']",Athlete,1886,6,9,1892
Lawrence Wolfe,['Guinea-Bissau'],Artist,1876,57,33,1933
Kelli Adams,['Niue'],Artist,1919,84,10,2003
Ian Johnson,['Netherlands'],Artist,1914,60,73,1974
Hannah Bradley,"['Niue', 'Panama']",Artist,1878,39,46,1917
Lawrence Soto,['Uganda'],Athlete,1909,29,48,1938
Nicole Taylor,"['Haiti', 'Sao Tome and Principe']",Artist,1902,83,12,1985
Joseph Simpson,['American Samoa'],Researcher,1896,72,81,1968
James Hammond,['Iceland'],Politician,1902,43,33,1945
Susan Lee,['Reunion'],Athlete,1902,0,70,1902
John Bond,"['Martinique', 'Bolivia']",Artist,1886,54,10,1940
Tyler Singleton,"['Czech Republic', 'Togo']",Shogun,1894,20,3,1914
Gregory Meadows,"['Saint Pierre and Miquelon', 'Iraq']",Politician,1880,80,81,1960
Jeremy Willis,['French Southern Territories'],Researcher,1883,81,20,1964
Jacob Aguilar Jr.,['Dominica'],Artist,1882,4,88,1886
Michael Farmer,['Grenada'],Researcher,1914,36,65,1950
Susan Stevens,"['Montserrat', 'Antigua and Barbuda']",Military personnel,1886,43,74,1929
Jennifer Roberts,"['Namibia', 'France']",Artist,1881,48,43,1929
Karen Rosales,['Yemen'],Artist,1891,53,61,1944
Lori Grant,['Mexico'],Politician,1885,38,59,1923
Christy King,"['United States of America', 'Somalia']",Military personnel,1900,58,48,1958
Christopher Jackson,['Congo'],Artist,1904,39,27,1943
Brenda Brown,['Ukraine'],Entrepreneur,1896,1,47,1897
Catherine Bennett,"['Niue', 'Palestinian Territory']",Artist,1898,2,32,1900
Deborah Patrick,['Panama'],Researcher,1887,63,54,1950
Caleb Johnson,['Andorra'],Manager; professional wrestler,1884,86,42,1970
Keith Green,['Jamaica'],Artist,1905,11,68,1916
Denise Robinson,['Sierra Leone'],Political activist,1908,42,57,1950
Christopher Moody,"['Ireland', 'Chile']",Athlete,1902,35,60,1937
Heidi Erickson,"['Azerbaijan', 'Slovenia']",Artist,1883,35,68,1918
Jose Brown,"['Georgia', 'Saint Martin']",Researcher,1902,2,37,1904
Paul Jimenez,"['Nepal', 'Brazil']",Politician,1891,12,21,1903
James Welch,"['Fiji', 'Serbia']",Artist,1880,82,20,1962
Bryan Shea,"['American Samoa', 'Ukraine']",Artist,1914,23,55,1937
Daniel Hill,"['Lebanon', 'Swaziland']",Politician,1918,4,76,1922
Brandon Jackson,['Martinique'],Athlete,1900,71,14,1971
Michael Wall,"['Bolivia', 'El Salvador']",Artist,1872,88,63,1960
Amy Bennett,"['Cyprus', 'Sao Tome and Principe']",Artist,1890,80,32,1970
John Medina,"['Gibraltar', 'Cook Islands']",Researcher,1881,82,35,1963
Brittany Mason,"['Suriname', 'Saint Pierre and Miquelon']",Researcher,1880,85,31,1965
Bryan Lane,['Uganda'],Politician,1885,57,12,1942
Timothy Lawrence,"['United Arab Emirates', 'Equatorial Guinea']",Artist,1910,26,89,1936
Ian Hill,"['Botswana', 'Grenada']",Researcher,1876,64,66,1940
Michael Flores,['Nepal'],Artist,1888,56,34,1944
Tasha Bryan,"['Burundi', 'Vanuatu']",Artist,1923,20,45,1943
Carol Ruiz,['Japan'],Politician,1913,14,54,1927
Brian Abbott,['San Marino'],Artist,1888,21,12,1909
Kelly Palmer,['British Indian Ocean Territory (Chagos Archipelago)'],Athlete,1894,25,31,1919
Kaitlyn Velasquez,['Zimbabwe'],Athlete,1909,30,31,1939
Cynthia Williams,"['Myanmar', 'Tokelau']",Politician,1923,21,82,1944
Laura Wilson,['Sudan'],Researcher,1875,60,50,1935
Ryan Ramirez,['Aruba'],Politician,1883,49,43,1932
Craig Booker,"['Jamaica', 'Oman']",Artist,1893,79,57,1972
Brittany Rogers,['Djibouti'],Engineer,1871,20,59,1891
Joseph Blackburn DDS,['Vietnam'],Artist,1888,19,47,1907
Bobby Powell,['Mauritius'],Artist,1908,48,41,1956
Sarah Vaughn,['Pakistan'],Researcher,1899,84,10,1983
Amanda Miranda,['Jamaica'],Partisan; miner; trade unionist,1883,23,76,1906
Rachel Coffey,"['Bahrain', 'Tunisia']",Kayaker,1910,38,7,1948
Darren Rodriguez,"['Argentina', 'Chad']",Athlete,1908,22,71,1930
Teresa French,['Montenegro'],Athlete,1906,29,74,1935
Brendan Chang,['French Southern Territories'],Artist,1905,62,85,1967
Ronald Brown,"['Switzerland', 'Nepal']",Artist,1909,35,77,1944
Nathan Wright,['Holy See (Vatican City State)'],Politician,1918,1,22,1919
Derrick Williams,['Saint Barthelemy'],Researcher,1896,73,76,1969
Jennifer Wheeler,['Philippines'],Artist,1902,16,53,1918
Rebecca Smith,"['Qatar', 'Micronesia']",Artist,1913,60,84,1973
Stephanie Kemp,['Estonia'],Artist,1917,18,56,1935
Jane Bowen,"['Equatorial Guinea', 'Faroe Islands']",Politician,1878,25,0,1903
Allison Mason,"['New Caledonia', 'Eritrea']",Artist,1920,67,18,1987
Amanda Maldonado,['Panama'],Athlete,1916,24,55,1940
Sherri Fox,['Canada'],Researcher,1891,65,37,1956
William Gutierrez,"['Japan', 'Brazil']",Artist,1891,65,17,1956
Benjamin Owen,"['Norfolk Island', 'Sierra Leone']",Entrepreneur,1889,20,77,1909
Stacy Johnston,"['French Polynesia', 'Tuvalu']",Athlete,1914,21,40,1935
Deborah Jenkins,"['Andorra', 'Burundi']",Artist,1915,79,70,1994
Dr. Krystal Hammond,['Canada'],Film producer,1879,66,37,1945
Christopher Neal,['British Indian Ocean Territory (Chagos Archipelago)'],Artist,1881,50,4,1931
Laura Coffey,['Cocos (Keeling) Islands'],Conductor,1883,20,5,1903
Mr. Jeremiah Williams,"['Antigua and Barbuda', 'Guyana']",Politician,1901,71,44,1972
Jean Johnson,"['Wallis and Futuna', 'French Southern Territories']",Artist,1884,67,44,1951
Kelly Lopez,['Thailand'],Athlete,1898,75,4,1973
Jason Moss,['Philippines'],Artist,1909,2,72,1911
Crystal Juarez,"['Botswana', 'Vanuatu']",Politician,1922,70,4,1992
Aaron Morgan,"['Guyana', 'Vietnam']",Human rights activist,1877,14,1,1891
Sean Wong,['Peru'],Artist,1920,20,28,1940
Jacqueline Scott,['Panama'],Athlete,1921,42,82,1963
Trevor Medina,['Malta'],Artist,1919,17,19,1936
Amy Franklin,"['Azerbaijan', 'Botswana']",Researcher,1875,8,52,1883
Sarah Ponce,"['Saint Martin', 'Haiti']",Politician,1920,86,19,2006
Brian Hammond,"['Finland', 'Turks and Caicos Islands']",Ballet dancer; pedagogue; choreographer; ballerina; dancer,1907,21,47,1928
Richard Oneal,['Benin'],Politician,1898,61,79,1959
Joseph Rodriguez,"['Bangladesh', 'Cocos (Keeling) Islands']",Researcher,1885,17,36,1902
Brandon Burke,"['Latvia', 'Equatorial Guinea']",Gangster,1909,25,40,1934
Alicia Thompson,"['Grenada', 'Benin']",Artist,1904,68,57,1972
Kristy Bartlett,['Equatorial Guinea'],Politician,1881,10,64,1891
Julie Goodman,"['French Polynesia', 'Argentina']",Artist,1893,50,84,1943
Shirley Barnes,"['Belarus', 'Cambodia']",Athlete,1907,80,48,1987
Garrett Martinez,['Peru'],Artist,1920,66,77,1986
Ryan Duncan,"['Palestinian Territory', 'Austria']",Criminal,1875,54,48,1929
Laurie Sanchez,['United Kingdom'],Researcher,1883,74,50,1957
Jacob Jones,"['Moldova', 'Ukraine']",Artist,1875,61,15,1936
Bryan Beck,"['Mali', 'Heard Island and McDonald Islands']",Artist,1870,22,83,1892
Shane Ward,['Falkland Islands (Malvinas)'],Researcher,1914,42,76,1956
James Henry,"['Mexico', 'Solomon Islands']",Artist,1916,80,1,1996
Stephanie Howard,"['Estonia', 'Tuvalu']",Politician,1902,79,45,1981
Jessica Wells,"['Bahrain', 'Ecuador']",Politician,1901,7,79,1908
Tanya Charles,['Aruba'],Artist,1920,26,87,1946
Jeremy Bridges,"['Gibraltar', 'Jersey']",Artist,1924,26,6,1950
James Baker,"['Malta', 'Mauritania']",Athlete,1914,32,33,1946
Kathy Owens,['Sierra Leone'],Artist,1911,63,39,1974
Jeremy Turner,['Dominican Republic'],Artist,1874,71,65,1945
Cody Stone,"['Georgia', 'Barbados']",Artist,1881,82,26,1963
Amber Allen,['Ecuador'],Judge,1921,67,44,1988
Lisa Ruiz,"['Gambia', 'Thailand']",Artist,1873,8,47,1881
Eric Young,['Timor-Leste'],Politician,1871,73,89,1944
Nichole Gilbert,"['Svalbard & Jan Mayen Islands', 'Afghanistan']",Artist,1874,26,9,1900
Crystal Rodriguez MD,"['Falkland Islands (Malvinas)', 'Guinea']",Politician,1909,8,9,1917
Daniel Herrera,"[""Cote d'Ivoire"", 'Greenland']",Artist,1887,39,30,1926
Bradley Lin,"[""Cote d'Ivoire"", 'Senegal']",Sailor,1883,67,14,1950
Wendy Dennis,['Monaco'],Sovereign,1907,34,67,1941
Tina Solis,['North Macedonia'],Artist,1897,27,83,1924
Rachel Romero,"['Slovakia (Slovak Republic)', 'Gabon']",Politician,1905,55,15,1960
Stephanie Mccormick MD,['Tonga'],Artist,1882,66,36,1948
Michael King,"['Kenya', 'Central African Republic']",Artist,1903,30,13,1933
Madison Ryan,"['Bolivia', 'Anguilla']",Athlete,1907,77,85,1984
Shelly James,['Christmas Island'],Artist,1887,47,83,1934
Scott Richardson,"['Senegal', 'Cyprus']",Artist,1914,2,13,1916
Gabrielle Serrano,['Pitcairn Islands'],Athlete,1893,74,13,1967
Peter Fleming,"['Aruba', 'Saudi Arabia']",Artist,1919,33,65,1952
Matthew Anderson,"['Sweden', 'British Virgin Islands']",Artist,1890,1,67,1891
Penny Oliver,['Albania'],Artist,1889,69,49,1958
Jason Moon,"['Seychelles', 'Syrian Arab Republic']",Artist,1900,25,67,1925
Amanda Parks,"['Tonga', 'Venezuela']",Artist,1871,26,38,1897
Vincent Lawrence,"['Mayotte', 'Zimbabwe']",Housekeeper,1907,47,80,1954
Susan Johnston,"['French Polynesia', 'Seychelles']",Athlete,1881,43,2,1924
Tonya Brown,"['Chad', 'Montserrat']",Artist,1871,83,55,1954
Leslie Smith,['Gambia'],Military personnel,1889,54,65,1943
Lucas Michael,"['Nicaragua', 'Reunion']",Ballet dancer; ballet master; choreographer; theater director,1913,15,59,1928
Hunter Brown,['Cameroon'],Military personnel,1919,63,20,1982
Kyle Scott DDS,"['Morocco', 'Christmas Island']",Researcher,1897,24,86,1921
Richard Erickson,['Bhutan'],Military personnel,1901,10,44,1911
Paul Goodwin,['Greece'],Politician,1881,81,56,1962
Nicole Ortiz,['Guinea'],Artist,1907,28,3,1935
Anthony Rodriguez,"['Lithuania', 'Venezuela']",Military personnel,1906,4,0,1910
Annette Baird,"['Azerbaijan', 'Israel']",Artist,1877,17,0,1894
Christopher Murphy,"['Saint Martin', 'Togo']",Politician,1879,13,52,1892
Peter Watkins,"['Egypt', 'British Virgin Islands']",Rally driver,1892,8,10,1900
Eric Owen,['Fiji'],Conductor,1917,46,83,1963
Dennis Brown,['United States Virgin Islands'],Politician,1887,72,86,1959
James Johnson,"['Niue', 'Egypt']",Artist,1906,22,57,1928
Erik Lee,['France'],Athlete,1921,23,81,1944
John Morrison,['Canada'],Artist,1871,13,75,1884
Lindsay Ramirez,['South Africa'],Artist,1912,56,69,1968
Jose Vargas,"['Antarctica (the territory South of 60 deg S)', 'Nauru']",Entrepreneur,1916,34,40,1950
Stephanie Howard,['Papua New Guinea'],Politician,1885,37,46,1922
Timothy Hanna,['Greenland'],Artist,1890,66,4,1956
Tracey Gonzalez,"['Vanuatu', 'Aruba']",Researcher,1887,83,62,1970
Tammy Lawson,"['Palestinian Territory', 'Malta']",Artist,1918,69,34,1987
Jeffery Watkins,['Slovakia (Slovak Republic)'],Artist,1911,3,32,1914
Amy Cline,['Mongolia'],Artist,1917,1,79,1918
Lawrence Gill,['Saint Pierre and Miquelon'],Politician,1924,16,10,1940
David Molina,['Egypt'],Politician,1890,45,11,1935
Erin Bell,['Cyprus'],Artist,1898,7,44,1905
Melissa Davidson,['Greece'],Entrepreneur,1872,84,48,1956
Ashley Johnson,['Tuvalu'],Artist,1912,36,16,1948
Jeffrey Mendoza,"['Panama', 'Peru']",Athlete,1903,57,15,1960
Meredith Sanders,"['Kenya', 'Nigeria']",Artist,1911,41,58,1952
Tracy Harris,"['Ukraine', 'Belgium']",Artist,1885,20,89,1905
Patrick Frank,"['Ireland', 'Thailand']",Artist,1871,33,22,1904
Joshua Mahoney,"['Morocco', 'New Zealand']",Artist,1923,54,22,1977
Melissa Henry,['Tuvalu'],Military personnel,1893,40,59,1933
Christopher Dorsey,['Heard Island and McDonald Islands'],Financier,1879,1,81,1880
Margaret Snyder,['Anguilla'],Researcher,1887,30,56,1917
Nathan Rogers,"['New Caledonia', 'Zimbabwe']",Politician,1914,35,66,1949
Robert Pineda,"['Italy', 'Liberia']",Athlete,1920,25,70,1945
Rebecca Smith,"['Italy', 'Lesotho']",Engineer,1910,54,80,1964
Dalton Beltran,"['Hungary', 'Algeria']",Artist,1921,84,71,2005
James Reed,['Australia'],Athlete,1880,6,83,1886
Julie Davis,"['Ghana', 'Gambia']",Researcher,1919,39,64,1958
Steven Brown,['Sudan'],Artist,1902,42,21,1944
Matthew Wong,['Croatia'],Racing automobile driver,1905,14,70,1919
Johnathan Thompson,['Wallis and Futuna'],Graphic designer; designer,1891,47,66,1938
James Bartlett,['Korea'],Artist,1883,0,22,1883
Andrea Davis,['Zimbabwe'],Military personnel,1912,67,17,1979
Julia Gaines,"['Samoa', 'Saint Martin']",Artist,1878,46,62,1924
Virginia Sanders,"['Botswana', 'British Virgin Islands']",Politician,1874,33,0,1907
Colton Anderson,"['Nigeria', 'Libyan Arab Jamahiriya']",Researcher,1896,41,79,1937
Ashley Bailey,['Iran'],Medievalist,1889,86,33,1975
Daniel Cowan,['French Polynesia'],Artist,1879,46,65,1925
Laura Gomez,"['France', 'Jersey']",Artist,1873,86,35,1959
Jared Cobb,['Turks and Caicos Islands'],Military personnel,1890,79,20,1969
Anita Gonzales,['United States Virgin Islands'],Athlete,1885,41,88,1926
Tammy Fox,['Tonga'],Ballet dancer; ballet master; choreographer,1886,86,19,1972
Cory Simmons,['Canada'],Politician,1875,20,82,1895
Philip Gonzalez,['Poland'],Politician,1881,18,65,1899
Rebecca Briggs,['Dominica'],Artist,1884,75,57,1959
Valerie Anderson,['Saint Martin'],Artist,1890,27,11,1917
Maurice Francis,['Hungary'],Politician,1880,42,18,1922
Nichole Hansen,"['Eritrea', 'Anguilla']",Military personnel,1895,50,8,1945
Lisa Young,['Bangladesh'],Artist,1901,45,47,1946
Terry Mcgee,"['United States Minor Outlying Islands', 'Mexico']",Farmer,1870,88,76,1958
Jeffery Cardenas,"['Sao Tome and Principe', 'Moldova']",Researcher,1914,41,61,1955
Tiffany King,"['Switzerland', 'Guam']",Artist,1922,65,89,1987
Vincent Lamb,"['Maldives', 'Burundi']",Researcher,1905,23,48,1928
Steven Brown,['Senegal'],Politician,1918,23,70,1941
Eric Gutierrez,"['Mali', 'Montserrat']",Military personnel,1918,78,78,1996
Patrick Garza,"['New Zealand', 'Central African Republic']",Bullfighter,1909,27,34,1936
Courtney Moss,"['Uganda', 'Equatorial Guinea']",Artist,1917,55,9,1972
Ashley Payne,['Cocos (Keeling) Islands'],Artist,1891,76,66,1967
Amy Richardson,"['Cape Verde', 'Poland']",Artist,1911,20,26,1931
Jerry Rivera,['Nicaragua'],Artist,1885,70,85,1955
Joseph Greene,['Aruba'],Artist,1915,83,84,1998
James Meyers,"['Saint Vincent and the Grenadines', 'Fiji']",Criminal,1923,9,6,1932
Allison Richardson,"['Uruguay', 'Albania']",Researcher,1912,4,44,1916
Jenny Wells,['Kiribati'],Ruler,1897,49,69,1946
Thomas Williams,"['Albania', 'Norfolk Island']",Manual worker; anarchist,1919,44,82,1963
John Harrell,"['Somalia', 'Lesotho']",Artist,1916,36,73,1952
Bradley Fisher,"['Jamaica', 'Micronesia']",Nurse; torturer; concentration camp guard,1885,26,88,1911
James Hughes,['Myanmar'],Artist,1909,68,30,1977
Christopher Williams,['Marshall Islands'],Politician,1893,34,0,1927
Nathan Rogers,['Dominica'],Artist,1890,54,60,1944
Heather Barnett,"['Saint Kitts and Nevis', 'Chile']",Politician,1888,2,12,1890
Kenneth Edwards,"[""Lao People's Democratic Republic""]",Athlete,1883,81,25,1964
Kyle Martinez,['Slovenia'],Artist,1878,71,58,1949
Dana Taylor,"['Korea', 'Kenya']",Politician,1921,51,14,1972
Kimberly Mitchell,['Jordan'],Politician,1911,37,73,1948
Leah Payne,['Kyrgyz Republic'],Artist,1903,48,25,1951
Kevin Blankenship,['Mexico'],Artist,1890,1,47,1891
Timothy Dudley,['Congo'],Engineer,1890,34,8,1924
Chloe Flores,['Mauritania'],Artist,1921,52,84,1973
Jimmy Cisneros II,['Italy'],Artist,1883,73,62,1956
John Bradley,"['Jordan', 'Iraq']",Athlete,1895,24,53,1919
Leslie Obrien,['Malta'],Artist,1884,41,25,1925
Erin Hull,"['Bolivia', ""Cote d'Ivoire""]",Politician,1891,12,68,1903
Marissa Rodriguez,"['Saint Vincent and the Grenadines', 'Malaysia']",Religious figure,1878,17,12,1895
Ronald Hill,"['Qatar', 'American Samoa']",Researcher,1923,53,73,1976
Sarah Lee MD,['Greenland'],Teacher,1870,58,33,1928
Robert Reed,['Bahamas'],Artist,1899,2,38,1901
Carla Gonzalez,"['Zambia', 'Saint Pierre and Miquelon']",Artist,1897,82,18,1979
Robert Moore,['Mongolia'],Athlete,1886,72,74,1958
Russell Holmes,"['Morocco', 'India']",Artist,1896,0,6,1896
Gregory Garner,['Kuwait'],Artist,1923,5,62,1928
John Sanders,"['Poland', 'Netherlands Antilles']",Artist,1898,78,80,1976
Amanda Ware,['Austria'],Researcher,1896,86,60,1982
Martha Logan,['Spain'],Inventor,1908,87,82,1995
Ruth Atkinson,"['Iraq', 'Qatar']",Teacher,1887,26,28,1913
Cesar Richardson,['France'],Military personnel,1912,23,33,1935
Shane Ortiz,"['Turkey', 'Wallis and Futuna']",Politician,1892,85,41,1977
Jordan Santos,['French Polynesia'],Artist,1892,68,65,1960
Philip Moody,['Swaziland'],Artist,1924,1,77,1925
Kenneth Martinez,"['Lesotho', 'Tanzania']",Researcher,1888,5,44,1893
Joseph Bond,['French Guiana'],Artist,1886,45,38,1931
Dustin Chang,['Bulgaria'],Physician,1902,44,83,1946
Adrienne Brooks,['Denmark'],Ballet dancer; pedagogue; choreographer; ballerina; dancer,1905,59,21,1964
Lori Lynch,"['Martinique', 'Anguilla']",Artist,1916,72,19,1988
Daniel Cole,['Mauritius'],Researcher,1897,56,32,1953
Nancy Johnson,['Ukraine'],Politician,1884,14,50,1898
Amber Frederick,['Belarus'],Businessperson,1887,68,36,1955
Renee Bautista DDS,"['Estonia', 'Kyrgyz Republic']",Artist,1902,42,59,1944
Kyle Miller,['Niger'],Artist,1894,57,6,1951
Richard Dudley MD,"['Seychelles', 'Colombia']",Religious figure,1899,11,8,1910
Victoria Orr,"['Denmark', 'Russian Federation']",Artist,1911,27,84,1938
Katherine Wilson,"['Samoa', 'Panama']",Journalist,1872,41,20,1913
Catherine Church,['Norfolk Island'],Athlete,1918,6,27,1924
Jacqueline Fox,['Albania'],Politician,1895,71,30,1966
Brooke Chavez,"['Canada', 'Costa Rica']",Military personnel,1918,16,56,1934
Nina Wyatt,"['Korea', 'Cambodia']",Aristocrat,1875,65,83,1940
Darlene Rice,"['Holy See (Vatican City State)', 'New Caledonia']",Artist,1916,22,26,1938
Sarah Avila,['Japan'],Researcher,1883,89,83,1972
Kathryn Hebert,"['British Indian Ocean Territory (Chagos Archipelago)', 'Peru']",Artist,1896,62,18,1958
Bobby Kane,['France'],Artist,1883,58,79,1941
Bruce Payne,['Libyan Arab Jamahiriya'],Cinematographer,1895,27,39,1922
Jamie Rodriguez,['Hong Kong'],Artist,1880,70,33,1950
Gregory Torres,"['United States Virgin Islands', 'Pitcairn Islands']",Artist,1890,32,31,1922
Robert Lewis,['Northern Mariana Islands'],Athlete,1911,56,37,1967
Ruth Diaz,['Bermuda'],Artist,1910,56,38,1966
Ryan Williams,"['Western Sahara', 'Northern Mariana Islands']",Politician,1891,67,88,1958
Amanda Shannon,"['Costa Rica', 'United States Minor Outlying Islands']",Street vendor,1883,42,88,1925
Dominic Lee,"['Saint Kitts and Nevis', 'Faroe Islands']",Artist,1871,75,20,1946
Kaitlin Maynard,['Saint Martin'],Artist,1920,73,62,1993
Joseph Jenkins,['Fiji'],Military personnel,1908,27,18,1935
Michael Williams,"['Liberia', 'Tajikistan']",Athlete,1904,55,31,1959
Clayton Conner,"['Northern Mariana Islands', 'Norway']",Artist,1910,73,30,1983
Tina Pierce,['Korea'],Politician,1887,73,78,1960
Lee Lopez,"['Slovenia', 'Ghana']",Artist,1901,30,25,1931
Todd Barrett,['South Africa'],Artist,1893,37,23,1930
Anna Thomas,['Saint Kitts and Nevis'],Artist,1912,68,64,1980
Tanya Wells,"['Cook Islands', 'Antigua and Barbuda']",Artist,1923,23,60,1946
Christopher Snyder,['Palau'],Athlete,1894,37,82,1931
Robert Brown,['Sierra Leone'],Artist,1899,22,47,1921
Molly Hampton,"['Kiribati', 'Sweden']",Athlete,1892,73,20,1965
David Davis,['Tonga'],Psychiatrist; psychoanalyst,1873,78,86,1951
William Li,['Reunion'],Artist,1905,23,63,1928
Francis Lozano,"['Guinea', 'Barbados']",Conductor,1874,76,19,1950
Brenda Floyd,['Bahrain'],Artist,1888,60,59,1948
Tony Mata,['Bolivia'],Artist,1924,68,59,1992
Caroline Watson,"['Turkmenistan', 'South Georgia and the South Sandwich Islands']",Politician,1890,88,16,1978
Stephanie Castillo,"['Faroe Islands', 'Latvia']",Artist,1923,14,19,1937
Nancy Snyder,['Lithuania'],Artist,1875,67,44,1942
Christina Clark,"['Guadeloupe', 'El Salvador']",Artist,1906,71,42,1977
Jeffrey Acevedo,"['Mayotte', 'Central African Republic']",Artist,1887,87,65,1974
Barbara Padilla,['Luxembourg'],Teacher,1873,6,78,1879
Cody Lewis,"['Lesotho', 'New Zealand']",Athlete,1918,85,87,2003
Matthew Lee,['Belgium'],Military personnel,1907,78,38,1985
Sandra Garcia,['India'],Artist,1893,61,76,1954
Martin Underwood,['Congo'],Lawyer,1904,30,87,1934
Jorge Peters,"['Saint Lucia', 'Qatar']",Researcher,1877,75,35,1952
Alicia Sherman,"['Moldova', 'Sri Lanka']",Artist,1881,19,47,1900
Joseph Haynes,"['India', 'United States Virgin Islands']",Military personnel,1876,45,66,1921
Cory Ferguson,['Turkey'],Artist,1918,70,40,1988
Bradley Sullivan,"['Togo', 'United States Virgin Islands']",Politician,1878,28,75,1906
Jesse Bruce,['Hungary'],Artist,1889,11,22,1900
Miss Stephanie Davidson,"['Jordan', 'Togo']",Politician,1897,48,11,1945
Andrea Hicks,['Lesotho'],Artist,1888,52,68,1940
Heather Fowler,"['Argentina', 'Mali']",Artist,1924,60,29,1984
Johnathan Ochoa,"['Holy See (Vatican City State)', 'Grenada']",Artist,1920,23,35,1943
Melissa Swanson,['Kyrgyz Republic'],Artist,1878,3,55,1881
Paula Gomez,"['Suriname', 'Cameroon']",Politician,1905,68,62,1973
Christopher Lamb,"['Guatemala', 'Bahamas']",Artist,1905,17,81,1922
Richard Watson,"['Greenland', 'Costa Rica']",Researcher,1898,2,43,1900
Amanda Davila,['Western Sahara'],Politician,1874,73,9,1947
Megan Roberts,['Sri Lanka'],Artist,1915,24,62,1939
Randall Payne,['Pakistan'],Artist,1878,60,56,1938
Spencer Long,['Heard Island and McDonald Islands'],Religious figure,1913,63,46,1976
Joshua Davis,"['Guyana', 'Venezuela']",Artist,1877,80,76,1957
Yvette Ramirez,['Gibraltar'],Monk,1893,12,50,1905
Matthew Meyer,"['Turkmenistan', 'Netherlands']",Military personnel,1903,62,82,1965
Michael Adams,"['Portugal', 'Namibia']",Artist,1874,3,80,1877
Joseph Wright,"['Christmas Island', 'Brunei Darussalam']",Researcher,1870,44,9,1914
Scott Martin,['French Polynesia'],Artist,1899,69,51,1968
Shannon Elliott,"['Luxembourg', 'Anguilla']",Politician,1906,86,51,1992
Tanya Ross,['South Georgia and the South Sandwich Islands'],Serial killer,1879,22,68,1901
Benjamin Stewart,['Iceland'],Businessperson,1883,79,32,1962
Stephanie Weber,['Uzbekistan'],Banker; art collector,1903,59,16,1962
Cindy Rojas,"['Brunei Darussalam', 'Thailand']",Artist,1921,35,53,1956
Kelly Khan,['Armenia'],Artist,1910,79,67,1989
Paula Hunter,"['Slovenia', 'Nauru']",Athlete,1876,5,21,1881
Pedro Garcia,"['Mongolia', 'Japan']",Artist,1904,39,13,1943
Michelle Dalton,"['Guam', 'Reunion']",Artist,1912,81,80,1993
Benjamin Lee,['Niue'],Artist,1878,39,65,1917
Dylan Green,"['New Zealand', 'Belarus']",Artist,1882,60,5,1942
Kenneth Powers,['Oman'],Athlete,1921,44,58,1965
Jose Randall,['Syrian Arab Republic'],Politician,1877,11,87,1888
Jeffrey Miller,"['Cayman Islands', 'Falkland Islands (Malvinas)']",Artist,1919,9,29,1928
Jeffrey Medina,['Montserrat'],Artist,1883,31,83,1914
Lisa Lee,['Namibia'],Artist,1891,11,70,1902
David Miles,"['Mauritania', 'United States Virgin Islands']",Researcher,1911,22,61,1933
Kyle Good,['Saint Barthelemy'],Artist,1897,65,71,1962
Tracy Lopez,"['Antarctica (the territory South of 60 deg S)', 'Qatar']",Researcher,1904,25,84,1929
Russell Reed,['Tonga'],Entrepreneur,1879,88,28,1967
Kelly Mitchell,"['Timor-Leste', 'Chad']",Artist,1888,21,5,1909
Trevor Smith,['Sri Lanka'],Artist,1870,39,67,1909
Tyler Mathews,"['Uruguay', 'Bermuda']",Artist,1899,19,30,1918
Amanda Johns,['Moldova'],Artist,1908,77,53,1985
Stephanie Gilmore,['Nepal'],Artist,1917,84,29,2001
Alicia Salas,['United States of America'],Athlete,1873,57,52,1930
Jeremy Martinez,['Zimbabwe'],Artist,1879,55,66,1934
Jonathan Smith,"['Rwanda', 'Suriname']",Artist,1917,17,28,1934
Diana Martinez,"['Algeria', 'Niue']",Artist,1873,6,85,1879
Renee Reese,"['Nepal', 'Ukraine']",Researcher,1902,64,74,1966
Martha Flores,"['Tunisia', 'Nigeria']",Artist,1918,1,47,1919
David Hood,"['Colombia', 'Canada']",Artist,1881,23,82,1904
Christopher Cruz,"['Senegal', 'Romania']",Politician,1885,19,62,1904
Steven Simon,['Uganda'],Artist,1906,29,17,1935
Melissa Frederick,"['Uruguay', 'Israel']",Politician,1907,80,77,1987
Denise Kennedy,"['Belarus', 'Cayman Islands']",Artist,1906,84,29,1990
Melissa Anderson,['Norway'],Researcher,1910,88,65,1998
Sarah Gonzalez,['British Virgin Islands'],Teacher,1870,42,16,1912
Susan Nelson,"['Honduras', 'Swaziland']",Politician,1876,89,40,1965
Michael Hudson,"['Mozambique', 'Ethiopia']",Journalist,1908,26,10,1934
Nathan Jones,['Poland'],Co-driver; racing automobile driver; rally driver,1920,2,31,1922
Miguel Banks,"['Guadeloupe', 'Nepal']",Artist,1877,74,17,1951
David Gray,"['Croatia', 'Togo']",Politician,1902,54,27,1956
Robin Jones,"['Peru', 'Bulgaria']",Politician,1900,79,47,1979
Christina Hines,"['Liberia', 'Saint Barthelemy']",Athlete,1870,61,0,1931
Patrick Acosta,"['Gibraltar', 'Bangladesh']",Artist,1885,69,25,1954
Christine Matthews,"['Saint Lucia', 'Australia']",Politician,1924,7,39,1931
Jeffrey Ellis,['Grenada'],Artist,1912,25,53,1937
Robert Levine,['Sao Tome and Principe'],Politician,1918,76,53,1994
Joshua Richardson,"['Denmark', 'Wallis and Futuna']",Politician,1910,33,61,1943
Alexandra Ramirez,"[""Lao People's Democratic Republic"", 'Egypt']",Politician,1874,6,85,1880
Hannah Lara,"['British Indian Ocean Territory (Chagos Archipelago)', 'Reunion']",Artist,1880,16,54,1896
Miguel Williams,"['Vietnam', 'Niger']",Artist,1908,66,44,1974
Regina Roberts,['Qatar'],Artist,1878,82,48,1960
Daniel Vargas,"['Wallis and Futuna', 'North Macedonia']",Politician,1907,70,37,1977
Eric Martin,['Isle of Man'],Athlete,1870,82,29,1952
Michelle Hurley,['Swaziland'],Politician,1887,28,22,1915
Robin Friedman,"['Gibraltar', 'Bolivia']",Administrator of the government,1920,89,56,2009
Timothy Frye,['Timor-Leste'],Artist,1881,48,27,1929
Cindy Graham,"['Bosnia and Herzegovina', 'Sierra Leone']",Artist,1920,3,4,1923
Katelyn Lewis,"['Christmas Island', 'Bolivia']",Artist,1908,13,73,1921
Courtney Cordova,"['American Samoa', ""Cote d'Ivoire""]",Politician,1891,5,21,1896
Mrs. Carmen Golden DDS,['Madagascar'],Artist,1893,55,64,1948
Kelli Ellis,"['Australia', 'Syrian Arab Republic']",Artist,1878,86,71,1964
Nicole Quinn,['San Marino'],Artist,1883,13,66,1896
Natalie Smith,['Japan'],Researcher,1901,67,52,1968
James Young,"['Palau', 'India']",Artist,1890,55,83,1945
James Murphy,"[""Cote d'Ivoire"", 'Venezuela']",Researcher,1899,28,1,1927
Brian King,['Cayman Islands'],Artist,1873,29,12,1902
David Rich,"['Sudan', 'Italy']",Athlete,1888,39,54,1927
Tanya Cabrera,"['Paraguay', 'Saint Martin']",Aristocrat,1905,53,33,1958
Dennis Wilson,"['Switzerland', 'Isle of Man']",Artist,1909,10,59,1919
Robert Porter,['Uganda'],Politician,1919,72,1,1991
Sarah Jones,['Svalbard & Jan Mayen Islands'],Researcher,1881,39,19,1920
Timothy Alvarado,['Chad'],Artist,1883,68,15,1951
Michele Franklin,"['Iceland', 'Tajikistan']",Athlete,1884,48,3,1932
Christopher Murray,"['Romania', 'Croatia']",Artist,1886,72,51,1958
Jordan Waller,['Mexico'],Artist,1914,82,53,1996
Robert Pierce,['Estonia'],Artist,1905,37,86,1942
Diana Rivera,"['Hungary', 'Samoa']",Military personnel,1910,68,33,1978
Jacob Davis,['Rwanda'],Artist,1895,18,21,1913
Mr. Mark Grant Jr.,['Maldives'],Politician,1918,30,31,1948
Evan Jackson,"['American Samoa', 'Turks and Caicos Islands']",Artist,1882,15,32,1897
Gregory Walker,['Saint Barthelemy'],First lady,1880,34,82,1914
Ryan Walker,"['Ukraine', 'Zambia']",Artist,1873,22,70,1895
Leslie Davis,['Palau'],Artist,1898,25,49,1923
Catherine Rose,['Norfolk Island'],Artist,1914,41,83,1955
William Butler,['Czech Republic'],Politician,1897,42,38,1939
Christopher Hansen,['Afghanistan'],Artist,1912,4,77,1916
Nicholas Henderson,['Liberia'],Athlete,1883,50,68,1933
Derrick Smith,"['Rwanda', 'Guinea']",Sovereign,1898,59,86,1957
Rebecca Kelly,"['Namibia', 'Saint Lucia']",Artist,1899,5,53,1904
Anna Young,"['Slovakia (Slovak Republic)', 'Reunion']",Artist,1875,4,87,1879
Jose Gray,['Central African Republic'],Artist,1913,29,44,1942
David Hernandez,['Netherlands Antilles'],Artist,1917,73,45,1990
Charlene Austin,"['Cocos (Keeling) Islands', 'Finland']",Politician,1875,81,3,1956
Marie Morgan,['Congo'],Researcher,1881,67,16,1948
Angela Stewart,['Syrian Arab Republic'],Politician,1883,50,14,1933
Thomas Brown,"['Romania', 'Zambia']",Researcher,1906,82,83,1988
Keith Morris,['Fiji'],Athlete,1918,1,56,1919
Grant Pitts,['Micronesia'],Athlete,1894,65,10,1959
Jenny Dawson,['Indonesia'],Racing automobile driver; formula one driver,1909,47,79,1956
Joshua Garza,"['Bangladesh', 'Hungary']",Artist,1922,25,80,1947
Jennifer Grant,['Spain'],Costume designer; fashion designer,1879,5,65,1884
Shawn Arnold,"['Bulgaria', 'Sri Lanka']",Artist,1909,51,65,1960
Denise Freeman,['Armenia'],Researcher,1900,20,1,1920
Jerry Scott,['Kyrgyz Republic'],Researcher,1899,83,74,1982
Megan Kennedy,"['United Arab Emirates', 'Seychelles']",Researcher,1898,17,61,1915
Alicia Anderson,['Jamaica'],Politician,1875,24,73,1899
Matthew Bishop,"['Madagascar', 'Bouvet Island (Bouvetoya)']",Politician,1917,12,55,1929
Jimmy Collins,"['French Polynesia', 'Saint Barthelemy']",Artist,1874,37,44,1911
Robert Flowers,"['Central African Republic', 'Colombia']",Artist,1910,4,22,1914
Theresa Wright,['Tunisia'],Politician,1882,7,19,1889
Valerie Maldonado,['Fiji'],Businessperson,1912,13,57,1925
Clayton White,['Armenia'],Artist,1881,76,9,1957
Diana Roth,"['Ghana', 'Montenegro']",Artist,1892,85,16,1977
Jonathan Lopez,['Angola'],Artist,1880,19,23,1899
Mario Dickson,"['Seychelles', 'Korea']",Researcher,1894,65,87,1959
Cassandra Hobbs,"['Greece', 'Sudan']",Conquistador; explorer,1918,46,57,1964
Melissa Hickman,"['Sierra Leone', 'Cayman Islands']",Artist,1895,43,61,1938
Emily Ford,"['Tanzania', 'Guernsey']",Shogun,1914,37,82,1951
Charles Wade,['Ethiopia'],Athlete,1894,43,67,1937
Natalie Wagner,"['South Africa', 'Cook Islands']",Police officer; serial killer,1918,50,22,1968
Curtis Duncan,['Serbia'],Researcher,1871,33,40,1904
Logan Campbell,['Grenada'],Military personnel,1891,30,0,1921
Larry Smith,['Zimbabwe'],Researcher,1871,30,82,1901
Jason Richardson,"[""Lao People's Democratic Republic"", 'Somalia']",Athlete,1920,33,16,1953
Tristan Jones,"['Montenegro', 'Canada']",Politician,1871,25,71,1896
Allison Pierce,['Mayotte'],Researcher,1884,48,12,1932
Gabriel Martinez,"['Palau', 'Zimbabwe']",Artist,1890,84,86,1974
Allen Castillo,['Sudan'],Funeral director; manager; professional wrestler,1894,89,46,1983
Cynthia Little,"['Northern Mariana Islands', 'Congo']",Playwright; author; dramaturge,1915,74,75,1989
Adam Nunez,"['Kiribati', 'Japan']",Artist,1918,11,7,1929
Danielle Poole,['Egypt'],Politician,1916,37,0,1953
Craig Moreno,"['Niger', 'Chile']",Artist,1916,49,48,1965
Cynthia Carter,"['Iraq', 'Somalia']",Researcher,1872,26,89,1898
Stuart Lynch,"['Faroe Islands', 'Palestinian Territory']",Artist,1916,4,34,1920
Mr. Stephen Perez,['United States of America'],Artist,1898,48,11,1946
Julia Wilson,['Kiribati'],Artist,1909,2,46,1911
Walter Jones,"['Paraguay', 'Montenegro']",Politician,1904,57,57,1961
Jack Davis,['Cape Verde'],Teacher,1918,53,60,1971
Patricia Moore,['Zimbabwe'],Artist,1895,57,7,1952
Tanya Stewart,"['Nigeria', 'Singapore']",Researcher,1923,36,14,1959
Thomas Davis,['Vietnam'],Artist,1871,45,62,1916
Gregory Bell,"['Guam', 'Portugal']",Athlete,1900,87,75,1987
Willie Lawson,"['Taiwan', 'Greenland']",Artist,1888,8,22,1896
Anna Watson,"['Denmark', 'Nepal']",Artist,1873,10,89,1883
Mark Marks,"['Ghana', 'Kuwait']",Monarch,1915,71,73,1986
Toni Dunn,['Indonesia'],Researcher,1921,56,20,1977
Stephanie Keith,['Seychelles'],Explorer,1893,60,75,1953
Paul Williams,"['Saint Pierre and Miquelon', 'Slovenia']",Politician,1923,20,85,1943
Danielle Jackson,"['Saint Helena', 'China']",Magician,1905,80,73,1985
Tara King,"['Nicaragua', 'Italy']",Artist,1893,54,43,1947
Mark Sullivan,['Sierra Leone'],Artist,1885,69,29,1954
Gregory Duran,['Cocos (Keeling) Islands'],Police officer; spree killer; mass murderer,1914,10,58,1924
Nicholas Lyons,['Anguilla'],Artist,1903,5,19,1908
Deborah Sanders,['Cayman Islands'],Artist,1891,46,88,1937
Jennifer Martin,['North Macedonia'],Artist,1922,33,10,1955
Mitchell Li,"['Norfolk Island', 'Sierra Leone']",Aristocrat,1871,31,61,1902
Corey Miller,"['Brazil', 'Guinea']",Researcher,1914,49,18,1963
Todd Brown,"['Kiribati', 'San Marino']",Teacher,1919,35,8,1954
Jesus Lawson,"['Palau', 'Kuwait']",Monarch,1879,3,53,1882
Sierra Robertson,"['Guatemala', 'Monaco']",Artist,1896,55,57,1951
Jason Bennett,['Denmark'],Teacher,1901,78,30,1979
Christina Stewart,"['New Caledonia', 'Mozambique']",Artist,1918,16,59,1934
Timothy Hunter,['Serbia'],Religious figure,1878,51,18,1929
Eric Romero,['North Macedonia'],Politician,1901,21,21,1922
Allison Velez,['Jordan'],Athlete,1913,77,49,1990
Brenda Reynolds,['Swaziland'],Lady-in-waiting,1892,14,14,1906
Harold Stephenson,"['Nauru', 'Kuwait']",Social reformer,1924,23,1,1947
Shawn Smith,"['Liberia', 'Iceland']",Artist,1884,54,31,1938
Kristina Wright,['Kyrgyz Republic'],Artist,1901,78,43,1979
Mary Miller,['French Southern Territories'],Researcher,1886,33,66,1919
Joseph Davis,['Samoa'],Artist,1885,37,71,1922
Amanda Lee,"['Slovakia (Slovak Republic)', 'Suriname']",Researcher,1911,53,19,1964
Daniel Brown,"['India', 'Sweden']",Artist,1914,25,44,1939
Samantha Hood,['San Marino'],Politician,1906,20,59,1926
Stephen Avila,['Switzerland'],Film producer,1878,40,42,1918
Daniel Mcdonald,"['Romania', 'Morocco']",Artist,1875,78,74,1953
Ryan Jones,['Equatorial Guinea'],Artist,1909,87,7,1996
Sarah Collins,['Syrian Arab Republic'],Flying ace,1893,61,32,1954
Lisa Stanley,['New Zealand'],Amateur wrestler,1870,14,27,1884
Krista Walsh,"['Singapore', 'Maldives']",Artist,1884,55,16,1939
Bradley Marshall,"['Brunei Darussalam', 'Romania']",Artist,1923,77,10,2000
Peggy Higgins,['Saint Pierre and Miquelon'],Artist,1872,73,33,1945
Stephanie Curtis PhD,"['Norway', 'Djibouti']",Politician,1882,6,12,1888
Jessica Benjamin,['Moldova'],Artist,1890,22,3,1912
Fernando Flores,"['Iceland', 'Qatar']",Artist,1903,33,43,1936
James Brown,"['Tanzania', 'Philippines']",Politician,1875,42,89,1917
Victoria Hoover,['Tajikistan'],Politician,1887,81,46,1968
Timothy Curry,"['Algeria', 'Ethiopia']",Politician,1883,31,23,1914
Derrick Davis,"['Brunei Darussalam', 'Saint Lucia']",Artist,1902,51,20,1953
Richard Crawford,"['Trinidad and Tobago', 'Egypt']",Artist,1912,56,43,1968
Andrea Lawrence,['Trinidad and Tobago'],Artist,1874,23,26,1897
Cynthia Lester,['Guyana'],Artist,1909,33,34,1942
Brian Jones,['Algeria'],Artist,1922,53,65,1975
Valerie Brown,['Micronesia'],Artist,1871,49,77,1920
David Boyd,['Northern Mariana Islands'],Sprinter,1898,20,31,1918
Laura Hall,"[""Cote d'Ivoire"", 'Bahamas']",Politician,1905,20,53,1925
Jennifer Bruce,"['Holy See (Vatican City State)', 'Macao']",Artist,1890,39,3,1929
Laurie Marshall,"['Guyana', 'Turkey']",Judge,1874,44,50,1918
Robin Dawson,"['Falkland Islands (Malvinas)', 'Holy See (Vatican City State)']",Politician,1921,15,76,1936
Mary Conner,"['Dominican Republic', 'El Salvador']",Artist,1879,4,69,1883
Casey Carpenter,"['French Polynesia', 'Sri Lanka']",Artist,1917,4,88,1921
Audrey Anderson,['Russian Federation'],Artist,1921,50,55,1971
Shannon Campbell,"['Macao', 'Suriname']",Resistance fighter; interpreter,1905,81,85,1986
Linda Wilkins,['Sudan'],Artist,1882,35,0,1917
Alexandra Miller,"['Korea', 'Finland']",Artist,1878,56,5,1934
Erica Barnett,"['Dominican Republic', 'Bahamas']",Politician,1918,27,8,1945
Jake Green,['Guernsey'],Aristocrat,1894,12,58,1906
Amber Dawson,"['Bulgaria', 'United States Minor Outlying Islands']",Artist,1923,28,60,1951
Corey Wilson,"['Tunisia', 'Lebanon']",Artist,1902,44,80,1946
Kristina Mccall,['Poland'],Artist,1908,21,88,1929
James Norris,['Nepal'],Researcher,1878,71,57,1949
Todd Martin,['Singapore'],Entrepreneur,1908,33,28,1941
Anne Murray,['Switzerland'],Athlete,1871,83,75,1954
Tiffany Freeman,['Egypt'],Artist,1905,51,0,1956
Alexander Brown,"['Mauritania', 'South Georgia and the South Sandwich Islands']",Politician,1877,13,19,1890
Timothy Velazquez,['Barbados'],Artist,1887,36,44,1923
Jessica Lambert,['Saint Martin'],Artist,1895,74,1,1969
Angela Graves,['Maldives'],Artist,1921,0,42,1921
William Oneal,['Mayotte'],Artist,1905,51,51,1956
Courtney Mccarthy,"['Croatia', 'Iraq']",Businessperson,1919,55,83,1974
Derek Ochoa,"['Cook Islands', 'Thailand']",Artist,1889,17,47,1906
Nicholas Howell,['Tokelau'],Athlete,1881,42,33,1923
Maria Faulkner,"['Pitcairn Islands', 'Lesotho']",Artist,1909,19,12,1928
Melanie Cook,"['Saint Pierre and Miquelon', 'Romania']",Artist,1891,78,88,1969
Angela Hartman,"['Myanmar', 'Guatemala']",Serial killer; criminal,1888,28,82,1916
Mr. Trevor Shepard Jr.,['Georgia'],Athlete,1912,25,5,1937
Sarah Wheeler,['Uruguay'],Artist,1904,55,83,1959
Jasmine Ford,"['Greenland', 'Senegal']",Researcher,1885,32,39,1917
Ronald Gutierrez,['Somalia'],Religious figure,1887,6,21,1893
Brian Price,"[""Cote d'Ivoire""]",Stand-up comedian,1870,76,64,1946
Erika Alexander,"['Barbados', 'Tokelau']",Researcher,1901,54,27,1955
Timothy Griffin,"['American Samoa', 'Aruba']",Religious figure,1909,69,56,1978
William Vega,"['Azerbaijan', 'Iraq']",Artist,1879,85,37,1964
George Miller,"['Greenland', 'Portugal']",Artist,1893,62,44,1955
Jill Stephenson,"['Cuba', 'Samoa']",Lady-in-waiting,1893,67,27,1960
Kathryn Martin,"['Sierra Leone', 'Oman']",Artist,1877,79,54,1956
Zachary Cox,['Uganda'],Artist,1924,8,23,1932
Jessica Montgomery,['Guyana'],Artist,1884,81,7,1965
Mary Smith,['Netherlands Antilles'],Sovereign,1871,9,30,1880
Margaret Mclaughlin,['Libyan Arab Jamahiriya'],Aristocrat; art collector,1911,13,67,1924
Kimberly Roth,['India'],Artist,1912,22,27,1934
Linda Rice,['Spain'],Researcher,1914,45,4,1959
Eric Schultz,['Wallis and Futuna'],Artist,1909,46,65,1955
Julie Hensley,['Austria'],Artist,1892,28,72,1920
Jessica Miller,['Bhutan'],Artist,1893,6,18,1899
Douglas Smith,"['Saint Kitts and Nevis', 'Uzbekistan']",Businessperson,1903,10,25,1913
David Morales,"['Korea', 'Sao Tome and Principe']",Artist,1881,66,53,1947
Adam Bailey,['Israel'],Artist,1894,24,2,1918
Nicole Todd,"['Montserrat', 'Singapore']",Artist,1920,45,18,1965
Daniel Kerr,"['Niue', 'Eritrea']",Artist,1875,89,58,1964
Arthur Reed,['Antarctica (the territory South of 60 deg S)'],Artist,1923,76,74,1999
Kathryn Pham,"['Azerbaijan', 'Marshall Islands']",Artist,1894,57,85,1951
Anne Becker,['Bermuda'],Religious figure,1889,53,22,1942
Jason Thompson,"['Greece', 'Saint Lucia']",Artist,1887,34,59,1921
Carrie Brandt,['China'],Politician,1905,48,66,1953
Melissa Walker,['Burkina Faso'],Researcher,1921,30,66,1951
Sonia Coleman,['Moldova'],Engineer,1871,16,50,1887
Gregory Roberts,"['New Zealand', 'Mozambique']",Artist,1878,84,88,1962
Victoria Rose,"['Zambia', 'Central African Republic']",Researcher,1882,24,75,1906
Valerie Norman,"['Cameroon', 'Saint Lucia']",Researcher,1889,44,10,1933
Phillip Burton,"['Romania', 'Guyana']",Researcher,1896,87,48,1983
Julie Payne,['Zimbabwe'],Artist,1895,4,32,1899
Andrew Jordan,"['Egypt', 'Iran']",Artist,1906,43,71,1949
Christopher Smith,"['Denmark', 'Panama']",Athlete,1879,36,14,1915
Morgan Ross MD,['Saint Barthelemy'],Artist,1899,28,66,1927
Aaron Hughes,"['Sweden', 'Afghanistan']",Entrepreneur,1897,1,2,1898
Latasha Burton,['Cambodia'],Artist,1889,7,29,1896
Mr. Troy Cain,['Ethiopia'],Artist,1921,12,21,1933
Colleen Powell,"['Taiwan', 'El Salvador']",Politician,1873,57,20,1930
Lisa Rodriguez,['Panama'],Religious figure,1915,68,85,1983
Mariah Carpenter,['Argentina'],Artist,1888,40,30,1928
Christopher Carter,['Honduras'],Politician,1879,82,69,1961
Dillon Gonzalez,['Cayman Islands'],Politician,1908,62,35,1970
Lisa Allen MD,['Seychelles'],Artist,1922,36,16,1958
Dennis Francis,"['Saint Barthelemy', 'United Kingdom']",Artist,1921,71,4,1992
Michael Cook DVM,"['Tuvalu', 'Svalbard & Jan Mayen Islands']",Artist,1873,76,24,1949
Joseph Hunt,['Wallis and Futuna'],Athlete,1912,46,49,1958
Ivan Flowers,"['Brunei Darussalam', 'Australia']",Artist,1873,67,49,1940
Andrea Rodriguez,['Mozambique'],Politician,1875,70,8,1945
Ms. Deborah Robinson,"['Barbados', 'Cuba']",Artist,1915,83,47,1998
Erika Harrington,"['Paraguay', 'Saudi Arabia']",Politician,1872,86,61,1958
Edward Williams,['Bulgaria'],Artist,1880,89,16,1969
Marie Ramirez,['Korea'],Artist,1917,59,78,1976
Riley Hurley Jr.,"['Kuwait', 'Wallis and Futuna']",Athlete,1888,29,12,1917
Dawn Roberts,"['Wallis and Futuna', 'Madagascar']",Athlete,1913,28,0,1941
Alfred Li,['Guadeloupe'],Artist,1913,45,11,1958
Tonya Ford,['Mayotte'],Karateka,1873,14,46,1887
Shelby Garcia,"['Moldova', 'Guinea-Bissau']",Spy,1915,9,28,1924
Darrell Boyle,"['Latvia', 'Djibouti']",Artist,1886,57,57,1943
Alicia Cross,['Cook Islands'],Teacher,1874,46,7,1920
Juan Cook,"['Namibia', 'Congo']",Military personnel,1913,57,12,1970
Cheryl Henderson,"['Andorra', 'Christmas Island']",Athlete,1900,14,85,1914
Peter Larson,"['Barbados', 'Tokelau']",Artist,1923,89,84,2012
Jerry Velasquez,"['Tonga', 'Belarus']",Athlete,1918,4,43,1922
Courtney Turner,['Christmas Island'],Spy,1896,44,78,1940
Stephanie Morales,['Lebanon'],Artist,1883,85,8,1968
Jeffrey Jacobs DVM,"['Netherlands Antilles', 'Holy See (Vatican City State)']",Artist,1874,0,60,1874
Lisa Howard,['Cape Verde'],Artist,1917,75,44,1992
Steven Jackson,['Kuwait'],Teacher,1889,85,74,1974
Justin Owen,['Christmas Island'],Artist,1922,67,88,1989
William Hayes,['Djibouti'],Researcher,1911,52,82,1963
David Scott,"['Afghanistan', 'Spain']",Artist,1897,48,2,1945
Alexander Sanders,"['Vietnam', 'Cameroon']",Politician,1914,17,9,1931
Bryan Larsen,"['Iceland', 'Bosnia and Herzegovina']",Artist,1904,37,63,1941
Bobby Vasquez,['United Arab Emirates'],Politician,1910,63,85,1973
Ryan Brown,"['Saudi Arabia', 'Netherlands Antilles']",Athlete,1895,28,23,1923
Vincent Murphy,['Costa Rica'],Politician,1870,35,46,1905
Deborah Martin,['Niue'],Artist,1920,33,25,1953
David Oliver,"[""Cote d'Ivoire"", 'Central African Republic']",Politician,1924,38,20,1962
Ryan Roberts,"['Bahamas', 'Cyprus']",Artist,1914,2,69,1916
Kevin Bender,['Denmark'],Artist,1908,72,81,1980
Joseph Haynes,['Greece'],Politician,1890,31,47,1921
Tyler Cook,['Yemen'],Military personnel,1874,37,50,1911
Christopher Wright,['Jersey'],Researcher,1914,48,3,1962
Robin Johnson,['Bosnia and Herzegovina'],Artist,1915,14,14,1929
Chelsea Shannon,['Cuba'],Artist,1906,32,6,1938
Karen Stephens,['Macao'],Politician,1895,16,9,1911
Alejandro Franklin DDS,['El Salvador'],Artist,1900,55,77,1955
Darrell Sosa,"['Japan', 'Saint Lucia']",Entrepreneur,1879,48,81,1927
Amber Morris,"['Sudan', 'Dominica']",Businessperson,1901,10,53,1911
Crystal Hart,['Anguilla'],Physician,1874,2,26,1876
John Perkins,"['Trinidad and Tobago', 'Pakistan']",Artist,1873,60,81,1933
Jeffrey Hodges,"['Mali', 'Finland']",Pianist,1910,89,84,1999
William Bell,"['Saint Pierre and Miquelon', 'Malta']",Sovereign,1884,86,79,1970
Pamela Garcia,"['Nigeria', 'Guernsey']",Politician,1895,88,39,1983
Willie Kane,['Togo'],Artist,1907,11,41,1918
Jordan Smith,['Kenya'],Researcher,1881,21,0,1902
Mr. Michael Reese,['Gabon'],Artist,1896,17,54,1913
Albert Campbell,"['French Guiana', 'Montserrat']",Religious figure,1909,60,83,1969
Matthew Hanna,"['Poland', 'Russian Federation']",Politician,1896,74,72,1970
Kyle Bowman,['Iceland'],Playwright; art critic; film critic; literary critic; novelist,1879,11,68,1890
Gerald Brown,"['Turkey', 'Tokelau']",Artist,1899,75,45,1974
Kristina Ferguson,['Marshall Islands'],Artist,1902,5,54,1907
Teresa Gonzalez,['French Southern Territories'],Athlete,1901,5,13,1906
Tracy Holmes,"['Serbia', 'United States of America']",Artist,1917,34,14,1951
William Malone,"['Croatia', 'Christmas Island']",Astronomer,1898,44,77,1942
Paul Park,"['Heard Island and McDonald Islands', 'Holy See (Vatican City State)']",Ballet dancer,1879,18,21,1897
Brandi Flores,['Guinea'],Artist,1881,32,11,1913
Derrick Hubbard,"['Thailand', 'Swaziland']",Researcher,1910,31,27,1941
Christy Bradley,"['Rwanda', 'Turkey']",Athlete,1907,76,7,1983
William Todd,"['Indonesia', 'Nauru']",Military personnel,1918,7,87,1925
Scott Adams,['Hong Kong'],Artist,1873,70,84,1943
Lindsay Perez,"['Syrian Arab Republic', 'Algeria']",Artist,1916,3,89,1919
James Murphy,['Seychelles'],Athlete,1879,80,25,1959
Jessica Marshall,"['Japan', 'Saint Kitts and Nevis']",Researcher,1910,11,61,1921
Christopher Taylor,"[""Cote d'Ivoire"", 'Niger']",Researcher,1910,71,70,1981
Beth Davis,"['Netherlands', 'Australia']",Athlete,1900,26,70,1926
Kelly Mendoza,['France'],Navigator; skipper,1873,48,7,1921
Teresa Padilla,['Slovakia (Slovak Republic)'],Politician,1890,1,87,1891
Kimberly Miller,['Namibia'],Artist,1883,81,43,1964
Joanne Kelley,['British Indian Ocean Territory (Chagos Archipelago)'],Criminal,1893,75,66,1968
Valerie Morgan,"['Saint Lucia', 'Wallis and Futuna']",Politician,1917,56,74,1973
Angela Carter,"['Bolivia', 'Ecuador']",Artist,1913,85,55,1998
Allison Peterson,"['Brunei Darussalam', 'Chad']",Military personnel,1906,62,23,1968
James Bell,['Solomon Islands'],Artist,1889,17,46,1906
Charles Lee,"['Gabon', 'Lithuania']",Politician,1922,43,1,1965
Kristina Burgess,"['Nigeria', 'Mauritania']",Artist,1897,63,81,1960
Sherry Zavala,['New Zealand'],Artist,1911,71,14,1982
Miss Tammy Castaneda,['Falkland Islands (Malvinas)'],Teacher,1918,37,23,1955
Bobby Daniel,"['Cook Islands', 'Gibraltar']",Artist,1911,39,58,1950
Jason Phillips,"['Morocco', 'Zambia']",Artist,1874,85,39,1959
Zachary Romero,"['French Guiana', 'Niger']",Politician,1922,0,86,1922
Amber Bowman,"['Norfolk Island', 'Palestinian Territory']",Artist,1886,48,83,1934
Colleen Murray,['Spain'],Researcher,1887,70,27,1957
Steven Johnson,"['Bahrain', 'Togo']",Politician,1878,25,58,1903
Daniel Reyes,"['Gibraltar', 'Guernsey']",Artist,1916,57,79,1973
Teresa Gonzalez,"['New Zealand', 'Afghanistan']",Politician,1918,64,66,1982
Tyler Hudson,"['American Samoa', 'Ireland']",Athlete,1874,86,22,1960
Nicole Foster,"['Moldova', 'China']",Artist,1923,63,70,1986
Donna White,['France'],Researcher,1878,69,49,1947
Christopher Mack,['Thailand'],Artist,1886,50,29,1936
Kenneth Jordan,['Norway'],Professional wrestler,1910,43,17,1953
Patrick Macias,"['Algeria', 'Japan']",Researcher,1916,34,74,1950
Candice Rodriguez,"['Central African Republic', 'Ecuador']",Politician,1883,3,59,1886
Tonya Wells,"['Guyana', 'Azerbaijan']",Artist,1878,61,13,1939
James Skinner,"['Dominica', 'Cook Islands']",Student; resistance fighter,1871,85,53,1956
Michael Morris DDS,['Andorra'],Artist,1894,37,23,1931
Jorge Jones,"['United States Minor Outlying Islands', 'Taiwan']",Politician,1906,1,28,1907
Samantha Cain,"['Aruba', 'Peru']",Artist,1921,64,39,1985
Kevin Herman,['Romania'],Artist,1893,75,76,1968
Joy Chen,['Reunion'],Artist,1918,72,71,1990
Kristin Mitchell,"['Cocos (Keeling) Islands', 'Svalbard & Jan Mayen Islands']",Artist,1905,38,35,1943
Henry Hamilton,"['Mongolia', 'Gibraltar']",Artist,1910,12,73,1922
Keith Thompson,['Turkey'],Artist,1897,24,3,1921
Maria Moran,"['Niue', 'Martinique']",Politician,1921,13,24,1934
Ashley Martinez,['Uruguay'],Researcher,1874,16,79,1890
Glenn Davis,['Bulgaria'],Artist,1915,70,63,1985
Julie Baker,['Saint Vincent and the Grenadines'],Athlete,1916,58,47,1974
Matthew Pratt,['Congo'],Watercolourist,1904,59,85,1963
Kevin Garrett,"['Sri Lanka', 'French Southern Territories']",Artist,1909,30,74,1939
Ronald Simmons,"['Wallis and Futuna', 'Norfolk Island']",Artist,1905,68,24,1973
Robert Walker,"['Central African Republic', 'Uruguay']",Witness,1914,10,22,1924
William Jones,"['Benin', 'Gibraltar']",Politician,1900,15,52,1915
Joan Dodson,['Equatorial Guinea'],Politician,1879,79,36,1958
Kenneth Cummings,['Italy'],Artist,1915,53,61,1968
Carlos Jackson,['Zambia'],Designer,1920,31,36,1951
Daniel Curtis,['Myanmar'],Artist,1921,7,12,1928
Cindy Morales,['Kyrgyz Republic'],Artist,1901,4,11,1905
Heather Baker,['Samoa'],Artist,1901,84,24,1985
Kayla Myers,"['Belarus', 'Pitcairn Islands']",Artist,1871,69,55,1940
Brenda Rodriguez,"['Oman', 'Cook Islands']",Drummer,1906,52,75,1958
Julie Solomon,['Comoros'],Artist,1895,37,45,1932
Elizabeth Hawkins,['Korea'],Athlete,1885,17,54,1902
Tom Day,"['Denmark', 'Netherlands Antilles']",Researcher,1918,74,18,1992
Angela Pineda,"['Albania', 'Netherlands Antilles']",Anthropologist,1882,29,9,1911
William Cortez,"['Mozambique', 'Papua New Guinea']",Teacher,1872,71,24,1943
Justin Francis,"['Saint Kitts and Nevis', 'Saint Martin']",Politician,1922,79,29,2001
Troy Smith,"['Western Sahara', 'Trinidad and Tobago']",Artist,1922,21,67,1943
Sherry Bradley,"['Rwanda', 'Cape Verde']",Artist,1906,21,24,1927
Kim Bowers,"['Burkina Faso', 'Christmas Island']",Artist,1916,6,14,1922
Sara Eaton,['Bangladesh'],Politician,1916,34,9,1950
Rachel Green,['French Guiana'],Artist,1900,50,1,1950
Tommy Yates,['Liberia'],Artist,1881,58,52,1939
Kylie Ho,['Ukraine'],Politician,1886,81,73,1967
Brian Oliver,['Marshall Islands'],Artist,1922,13,79,1935
Sandra Reed,"['Italy', 'Saudi Arabia']",Artist,1906,44,81,1950
Amber Jenkins,"['Tanzania', 'Venezuela']",Athlete,1876,58,56,1934
Donna Villarreal,"['Malta', 'Cuba']",Judge,1907,57,88,1964
Kimberly Brock,['Pitcairn Islands'],Athlete,1908,52,31,1960
Kelly Mitchell,['Burundi'],Politician,1899,49,74,1948
Keith Thomas,['Nauru'],Judoka,1893,61,30,1954
Angela Garcia,['Czech Republic'],Researcher,1920,47,30,1967
Edgar Ryan,"['Lebanon', ""Lao People's Democratic Republic""]",Artist,1902,16,61,1918
Robert Jefferson Jr.,['Palestinian Territory'],Artist,1913,74,3,1987
David Mack,['Mexico'],Politician,1915,48,37,1963
Leah Castillo,"['South Georgia and the South Sandwich Islands', 'Holy See (Vatican City State)']",Aristocrat,1882,60,52,1942
Catherine Kline,['Syrian Arab Republic'],Artist,1882,51,38,1933
Kyle Moore,"['Venezuela', 'Myanmar']",Artist,1898,22,62,1920
Julia Mosley,"['Haiti', 'Liechtenstein']",Artist,1903,29,49,1932
Ryan Williams,['Ghana'],Artist,1904,66,8,1970
Rebecca Duncan,"['Senegal', 'Estonia']",Artist,1904,51,75,1955
Brenda Medina,['Guam'],Artist,1876,73,26,1949
Dwayne Bruce,"['Cyprus', 'Haiti']",Tribal chief,1903,50,23,1953
Richard Taylor,['Haiti'],Artist,1885,62,52,1947
Kathy English,['Holy See (Vatican City State)'],Artist,1893,56,87,1949
Christine Garcia,['Guinea'],Accordionist,1906,8,21,1914
Dr. John Brown,['Ethiopia'],Politician,1908,2,23,1910
Felicia Johnson,['Nigeria'],Researcher,1922,4,63,1926
Travis Valdez,"[""Cote d'Ivoire"", 'Slovakia (Slovak Republic)']",Military personnel,1904,4,88,1908
Thomas Ramirez,['Brazil'],Politician,1879,46,33,1925
Christopher Hart,"[""Cote d'Ivoire""]",Researcher,1899,51,40,1950
Nathan Patton,"['Andorra', 'Norfolk Island']",Ballet dancer; pedagogue; choreographer; ballerina; dancer,1905,47,84,1952
Michael Hernandez,"[""Lao People's Democratic Republic"", 'Tuvalu']",Artist,1883,25,31,1908
Valerie Jones,['Palau'],Ballet dancer; ballet master; choreographer; theater director,1895,64,0,1959
Crystal Hicks,"['Botswana', 'Cuba']",Miller,1902,32,25,1934
Jordan Meyer,['Sierra Leone'],Politician,1870,29,61,1899
Cindy Galvan,"['Tokelau', 'Solomon Islands']",Artist,1898,5,60,1903
Cassandra Johnson,['Belarus'],Researcher,1891,22,87,1913
Mr. Marco Burns,['Anguilla'],Artist,1900,84,2,1984
Jacob Cline,['Argentina'],Politician,1914,54,71,1968
Rebecca Harvey,"['Bolivia', 'Serbia']",Artist,1907,74,1,1981
Tammy Robinson,"['Estonia', 'Japan']",Artist,1893,5,55,1898
Sherry Valentine,['Faroe Islands'],Artist,1903,55,84,1958
Adam Hernandez,"['Palau', 'Saint Lucia']",Artist,1903,10,34,1913
Angel Lewis,"['Chad', 'Libyan Arab Jamahiriya']",Model,1905,39,16,1944
Linda Bennett,"['Peru', 'Namibia']",Rock climber; skydiver; mountaineer,1879,24,84,1903
Dr. Tammy Sims,['Germany'],Artist,1879,9,36,1888
Beth Martin,"['Tokelau', 'Chad']",Artist,1914,68,31,1982
Deborah James,['Kazakhstan'],Criminal,1919,17,49,1936
Jeremy Miller Jr.,"['Bahrain', 'Ireland']",Politician,1872,30,86,1902
Mark Young,['Uzbekistan'],Researcher,1916,5,10,1921
Ann Manning,"['Cape Verde', 'Montserrat']",Engineer,1914,57,20,1971
Joshua Sullivan,"['Bouvet Island (Bouvetoya)', 'Tonga']",Religious figure,1892,22,45,1914
Dr. Alexander Bryant,['Albania'],Artist,1904,89,50,1993
Anthony King,['Congo'],Researcher,1915,36,11,1951
Michael Garcia,"['British Virgin Islands', 'Jordan']",Artist,1891,52,56,1943
Elizabeth Sexton,"['Argentina', 'Grenada']",Psychiatrist; psychoanalyst,1912,14,25,1926
Cynthia Garza,['Mexico'],Politician,1919,28,9,1947
Monica Jimenez,['Peru'],Politician,1885,88,53,1973
Daniel Garza,"['Iceland', 'Nepal']",Researcher,1891,31,88,1922
Cynthia Pierce,"['Cyprus', 'Equatorial Guinea']",Artist,1894,47,38,1941
Mary Howard,['Oman'],Explorer,1875,8,40,1883
Tiffany Miller,['Guam'],Politician,1878,12,42,1890
Christina Watkins,['North Macedonia'],Journalist,1893,26,68,1919
Rebecca Warren,"['Cambodia', 'Armenia']",Religious figure,1923,82,60,2005
Patricia Morse,"['Belgium', 'Canada']",Athlete,1870,73,30,1943
Rebecca Baker,['Australia'],Artist,1902,70,72,1972
William Butler,['Ecuador'],Athlete,1895,66,59,1961
Adam James,['Venezuela'],Artist,1901,83,64,1984
William Young,['Tunisia'],Motorcycle racer; racing automobile driver; formula one driver; rally driver,1913,56,22,1969
Anthony Flores,"['Equatorial Guinea', 'Ethiopia']",Criminal; serial killer,1899,69,10,1968
Anne Brooks,['Ireland'],Artist,1884,76,13,1960
Cynthia Gardner,['Portugal'],Politician,1917,44,39,1961
Natalie Walker,['Chad'],Athlete,1879,4,37,1883
Andrew Bonilla,"['Falkland Islands (Malvinas)', 'Thailand']",Racing automobile driver,1898,88,77,1986
Jeff Alvarez,"['Syrian Arab Republic', 'American Samoa']",Artist,1923,86,70,2009
Robert Espinoza,"['Niger', 'El Salvador']",Teacher,1923,58,28,1981
Elizabeth Parker,['Guinea-Bissau'],Artist,1881,55,85,1936
Alicia Hoffman,"['Dominican Republic', 'Czech Republic']",Researcher,1871,31,39,1902
Reginald Proctor,['Pitcairn Islands'],Researcher,1906,25,32,1931
Mary Shaw,"['North Macedonia', 'Ghana']",Artist,1921,82,19,2003
Cody Morris,['Algeria'],Religious figure,1876,86,41,1962
Nicole King,['British Indian Ocean Territory (Chagos Archipelago)'],Researcher,1870,0,86,1870
Melissa Houston,"['Liberia', 'Trinidad and Tobago']",Researcher,1885,32,54,1917
Sara Bruce,"['Senegal', 'Norway']",Artist,1904,84,72,1988
Jasmine Howard,"['British Indian Ocean Territory (Chagos Archipelago)', 'Belgium']",Politician,1920,23,87,1943
Anna Young,['Madagascar'],Athlete,1919,76,30,1995
Charles Strickland,"['Russian Federation', 'Palestinian Territory']",Researcher,1883,0,3,1883
Andre Mendoza DDS,['Guatemala'],Politician,1906,30,29,1936
Crystal Tyler,['Monaco'],Artist,1901,20,23,1921
Brian Ross,['Thailand'],Athlete,1889,23,51,1912
Nicholas Davis DVM,['Burundi'],Politician,1915,29,84,1944
Charles Wilson,"['Romania', 'Niue']",Artist,1902,49,5,1951
Isaiah Bennett,['Western Sahara'],Teacher,1897,37,55,1934
Mary Douglas DVM,"['Falkland Islands (Malvinas)', 'Greece']",Artist,1890,85,88,1975
Steven Wright,"['Gibraltar', 'Libyan Arab Jamahiriya']",Politician,1883,89,50,1972
Jeffrey Maddox,"['Cyprus', 'Bahrain']",Entrepreneur,1891,0,74,1891
Alicia Baker,['Isle of Man'],Artist,1882,81,39,1963
Susan Cruz,"['Isle of Man', 'Tanzania']",Politician,1921,12,9,1933
Sara Parsons,['Montenegro'],Artist,1871,9,78,1880
David Perkins,['Estonia'],Politician,1885,30,60,1915
Nancy Gomez,['Vanuatu'],Artist,1895,59,32,1954
Julie Lambert MD,"['Bahamas', 'Guatemala']",Politician,1884,49,81,1933
Gerald Rodriguez,['Kuwait'],Artist,1892,11,64,1903
Megan Mcpherson,"['Thailand', 'Greenland']",Politician,1881,88,7,1969
Scott Chambers,"[""Cote d'Ivoire"", 'South Africa']",Military personnel,1891,48,35,1939
Christopher Mcbride,"['Andorra', 'Afghanistan']",Athlete,1879,63,84,1942
Joe Roberts,"['Ukraine', 'Uganda']",Artist,1896,40,33,1936
Tina Velez,['China'],Politician,1897,31,21,1928
Garrett Potter,['Belize'],Teacher,1918,32,87,1950
Stephanie Hart,"['Palau', 'Mauritius']",Monk,1920,12,38,1932
Jennifer Martin,"['Samoa', 'Comoros']",Politician,1917,41,27,1958
Brenda Ortega,['Paraguay'],Politician,1883,51,45,1934
Christopher Johnson,"['Algeria', 'Cuba']",Politician,1914,82,8,1996
Tamara Cowan,['Anguilla'],Teacher,1889,70,73,1959
Kevin Jensen,"['Guinea-Bissau', 'Antarctica (the territory South of 60 deg S)']",Artist,1897,83,38,1980
Brittany Wilkinson,"['Luxembourg', 'Namibia']",Entrepreneur,1907,18,26,1925
Jason Gentry,"['Ireland', 'Algeria']",Artist,1911,56,46,1967
Charles Parker,"['Belarus', 'Gibraltar']",Athlete,1882,3,52,1885
Edward Parker,"['Congo', 'Cayman Islands']",Presbyter,1889,49,29,1938
Kelly Valentine,['Chad'],Researcher,1883,79,45,1962
Sharon Fischer,"['Netherlands', 'Lebanon']",Politician,1922,67,25,1989
David Rollins,"['Kuwait', 'Lebanon']",Aristocrat,1902,74,50,1976
Andrew Schneider,['Kenya'],Artist,1891,64,32,1955
Brandon Adams,"['Bolivia', 'Haiti']",Artist,1889,41,60,1930
Donna Chambers,"['Venezuela', 'Iraq']",Politician,1897,4,25,1901
Jeremy Shaw,['Lebanon'],Torturer; concentration camp guard,1880,8,57,1888
Joseph Blackburn,['El Salvador'],Athlete,1908,27,85,1935
Keith Shannon,"['Iran', 'Gabon']",Engineer,1870,31,66,1901
Michael Brooks,['Honduras'],Politician,1918,41,29,1959
Sarah Ingram,['Malta'],Artist,1915,33,52,1948
Monica Williams,"['Congo', 'Moldova']",Politician,1891,51,64,1942
Rebecca Jackson,['Serbia'],Jurist,1889,82,81,1971
Steven Campbell,['Slovakia (Slovak Republic)'],Politician,1896,59,16,1955
Elizabeth Herrera,"['Macao', 'Dominican Republic']",Teacher,1900,76,15,1976
Michele Castillo,"['Belize', 'Canada']",Athlete,1911,39,30,1950
Lacey Cordova,"['Georgia', 'Syrian Arab Republic']",Artist,1910,38,18,1948
Clarence Johnson,['Denmark'],Researcher,1892,65,47,1957
Joseph Garcia,['Austria'],Artist,1905,80,82,1985
Riley Harris,['Indonesia'],Politician,1886,9,54,1895
Joseph Schwartz,"['Ireland', 'Antigua and Barbuda']",Artist,1922,62,29,1984
Jennifer Snyder,"['Kuwait', 'Guinea-Bissau']",Artist,1899,38,36,1937
Brittany Smith,['France'],Researcher,1910,64,28,1974
Greg Chapman,"['Haiti', 'Turkmenistan']",Athlete,1919,53,39,1972
Alex Thompson,"['Lithuania', 'Saint Pierre and Miquelon']",Artist,1910,37,56,1947
Laura Hutchinson,"['North Macedonia', ""Cote d'Ivoire""]",Artist,1907,58,69,1965
Lori Myers,"['Barbados', 'Niger']",Artist,1904,46,66,1950
Carlos Neal,"['Bermuda', 'Isle of Man']",Artist,1892,9,73,1901
Anthony Williams,"['American Samoa', 'Taiwan']",Politician,1905,43,82,1948
William Johnson,"['Saudi Arabia', 'Netherlands Antilles']",Artist,1884,51,50,1935
Judith Hatfield,"['Taiwan', 'Saint Barthelemy']",Researcher,1880,3,10,1883
Shelly Miller,['Christmas Island'],Politician,1909,55,69,1964
Michael Douglas,['Liberia'],Artist,1881,37,2,1918
Brandon Adams,"['Qatar', 'Uganda']",Athlete,1909,26,42,1935
Melissa Jones,"['France', 'Afghanistan']",Researcher,1877,44,74,1921
Kelly Stokes DVM,['Poland'],Researcher,1907,38,19,1945
Karen Jones,"['Haiti', 'Tokelau']",Politician,1893,24,62,1917
James Brown,"['French Polynesia', 'Czech Republic']",Researcher,1872,55,87,1927
Chad Schmidt,"['Bahrain', 'Algeria']",Politician,1890,15,65,1905
April Mayo,"['United Kingdom', 'French Polynesia']",Politician,1893,84,49,1977
Jessica Valdez,"['Mongolia', 'Congo']",Politician,1903,58,16,1961
Zachary Hale,"['Montserrat', 'Mexico']",Politician,1873,53,11,1926
Erik Burns,"['Reunion', 'Mayotte']",Artist,1873,17,46,1890
Nicole Garrett,"['Chad', 'Niger']",Physician,1901,73,3,1974
Jennifer Briggs,"['Iceland', 'Luxembourg']",Artist,1897,3,15,1900
Elizabeth Mcknight,"['Zambia', 'Serbia']",Researcher,1898,11,34,1909
Colin Hill,"['Papua New Guinea', 'Solomon Islands']",Manager; playboy playmate; radio personality; model; professional wrestler; beauty pageant contestant,1872,2,83,1874
Stephanie Walker,"['Brazil', 'Spain']",Researcher,1870,49,44,1919
Kimberly Lyons,['Dominica'],Ballet dancer; ballet master; choreographer; theater director,1889,69,65,1958
Chase Griffin,"['South Africa', 'Iceland']",Athlete,1880,74,18,1954
Greg Merritt,"['New Zealand', 'Uruguay']",Athlete,1908,76,53,1984
Tommy Burnett,"['Kazakhstan', 'Belarus']",Artist,1871,47,75,1918
Lindsey Williams,['Malaysia'],Artist,1894,44,54,1938
Miranda Atkinson,['Mozambique'],Military personnel,1891,16,57,1907
Lacey Murray,"['Malaysia', 'Greenland']",Artist,1914,89,38,2003
Frank Miller,"['Finland', 'Benin']",Artist,1887,17,16,1904
Kyle Mclaughlin,['Poland'],Politician,1919,26,21,1945
William Johnson,"['Czech Republic', 'Latvia']",Neurologist; psychoanalyst,1919,79,56,1998
Andrew Smith,['Israel'],Researcher,1881,55,46,1936
Charles Jones,"['Tanzania', ""Cote d'Ivoire""]",Gangster,1873,24,45,1897
Alyssa Navarro,['Liechtenstein'],Scenographer,1921,69,44,1990
Dana Williams,"['Saint Pierre and Miquelon', 'Swaziland']",Artist,1915,75,12,1990
James Wilson,['Lesotho'],Athlete,1885,59,17,1944
Ian Leon,['Venezuela'],Businessperson,1912,87,17,1999
Michelle Morgan,"['Cook Islands', 'Iraq']",Artist,1878,14,34,1892
Kristina Flores,"['Estonia', 'Kiribati']",Entrepreneur,1904,3,11,1907
Nicole Roberts,"[""Lao People's Democratic Republic""]",Politician,1876,28,8,1904
Brian Martinez,"['Oman', 'Cameroon']",Artist,1877,63,38,1940
Michael Anderson,"['Italy', 'Turkmenistan']",Artist,1908,11,22,1919
Robert Alexander,"['Finland', 'Puerto Rico']",Artist,1894,40,8,1934
Deborah Rodriguez,"['Puerto Rico', 'Bolivia']",Politician,1924,22,46,1946
Joshua Brooks,"['Guam', 'France']",Religious figure,1892,81,22,1973
Chad Rice,"['Somalia', 'Malawi']",Athlete,1916,58,17,1974
Christian Smith,"['Martinique', 'Swaziland']",Artist,1909,3,66,1912
Brittany Martin,"['Kyrgyz Republic', 'Dominica']",Artist,1889,82,36,1971
Francisco Wright,"['North Macedonia', 'El Salvador']",Politician,1909,72,87,1981
Alyssa Freeman,['Barbados'],Athlete,1889,22,34,1911
Sarah Johnston,"['Monaco', 'Cuba']",Artist,1892,63,65,1955
Michelle Montes,['American Samoa'],Artist,1875,39,42,1914
Christopher Lang,"['Congo', 'Reunion']",Artist,1880,53,44,1933
Timothy Garcia,"['Saint Helena', 'South Africa']",Athlete,1896,18,54,1914
Robert Garcia,"['Benin', 'Christmas Island']",Politician,1897,6,14,1903
Sharon Carter,['Tunisia'],Artist,1889,21,57,1910
Tyler Leonard,['Morocco'],Politician,1916,68,17,1984
Jennifer Patton,"['Antarctica (the territory South of 60 deg S)', 'South Georgia and the South Sandwich Islands']",Artist,1876,56,72,1932
Tammie Gray,['India'],Typographer,1912,15,13,1927
Kathleen Hughes,"['British Virgin Islands', 'Latvia']",Middle-distance runner,1914,32,82,1946
George Flores,['Armenia'],Athlete,1912,85,19,1997
James Bean,"['Grenada', 'Saint Martin']",Costume designer; fashion designer,1886,62,80,1948
Amber Schultz,"['Austria', 'Slovenia']",Religious figure,1895,65,47,1960
Tina Diaz,"['Taiwan', 'North Macedonia']",Mangaka; animator; lyricist,1917,83,83,2000
Matthew Parks,"['Mali', 'Croatia']",Artist,1879,49,1,1928
Jorge Daniel,['Algeria'],Researcher,1915,0,66,1915
James Martinez,"['Chad', 'Uruguay']",Artist,1878,41,22,1919
Rebecca Mccoy,"['Papua New Guinea', 'Benin']",Politician,1906,35,12,1941
Brandon Matthews,['Nigeria'],Artist,1898,28,36,1926
Christopher Mueller,"['Afghanistan', 'Uruguay']",Politician,1889,87,66,1976
Elizabeth Fleming,"['Faroe Islands', 'Sudan']",Fighter pilot,1904,61,74,1965
Don James,['Azerbaijan'],Researcher,1910,80,66,1990
Christopher Pierce,"['Djibouti', 'South Africa']",Serial killer,1914,61,41,1975
Heather Fowler,"['Mali', 'Saint Vincent and the Grenadines']",Artist,1892,61,74,1953
Michael Gibson,"['Jamaica', 'Tanzania']",Politician,1871,21,33,1892
Daniel Scott,"['Malta', 'Argentina']",Researcher,1880,46,74,1926
John Oconnor,"['Montserrat', 'Bahrain']",Artist,1920,63,49,1983
Nicholas King,"['Micronesia', 'Fiji']",Artist,1881,37,82,1918
Jason Lopez,"['Fiji', 'Iraq']",Artist,1901,61,17,1962
Sandra Barnes,['Indonesia'],Researcher,1919,44,50,1963
Michael Harris,['United Arab Emirates'],Artist,1880,86,18,1966
Joshua Norton,['Zimbabwe'],Artist,1910,49,80,1959
Laurie Blake,['French Southern Territories'],Researcher,1908,1,63,1909
David Steele,"['Mongolia', 'Czech Republic']",Artist,1910,14,53,1924
Jeremiah Johnson,"['Guadeloupe', 'Falkland Islands (Malvinas)']",Politician,1891,14,56,1905
Ricky Hill,['Greenland'],Baker,1916,29,17,1945
Carla Warner,['Cape Verde'],Artist,1878,26,28,1904
Sharon Kim,['El Salvador'],Politician,1918,24,46,1942
Lisa Pierce,['Denmark'],Artist,1904,55,23,1959
Kristen Harris,['Tunisia'],Artist,1903,70,64,1973
Cheryl Davis,['Russian Federation'],Athlete,1910,43,59,1953
Samuel Mitchell,"['Angola', 'Barbados']",Resistance fighter; pacifist,1887,84,33,1971
Lisa Weber,['French Polynesia'],Businessperson,1895,38,20,1933
John Ramos,['Bangladesh'],Professional wrestler,1880,55,82,1935
Kristen Brown,"['Denmark', 'Greece']",Artist,1886,75,45,1961
Kelly Patterson,"['Iraq', 'Belgium']",Engineer,1914,71,48,1985
Christina Paul,"['Jamaica', 'Saudi Arabia']",Politician,1894,25,80,1919
Jennifer Contreras,['Mali'],Artist,1921,61,11,1982
Jennifer Garcia DDS,"['Bosnia and Herzegovina', 'Thailand']",Artist,1882,62,14,1944
Joshua Bridges,"['United States Minor Outlying Islands', 'China']",Politician,1920,65,72,1985
Heather Davies,"['Slovakia (Slovak Republic)', 'Bhutan']",Artist,1879,26,11,1905
Samuel Bond,"['Canada', 'Suriname']",Politician,1887,31,38,1918
Terri Hall,['Korea'],Politician,1902,30,38,1932
Elizabeth Calderon,['Saint Vincent and the Grenadines'],Researcher,1884,64,28,1948
Dr. James Kelley,"['Lesotho', 'Guatemala']",Artist,1898,78,72,1976
Samantha Andrade,['Western Sahara'],Disc jockey,1884,55,12,1939
William Jordan,"['Libyan Arab Jamahiriya', 'Oman']",Researcher,1884,50,8,1934
Hunter Sims,"['Martinique', 'Argentina']",Artist,1907,9,42,1916
Caroline Walker,"['Bermuda', 'Guam']",Artist,1892,35,83,1927
Mason Coleman,['Solomon Islands'],Artist,1909,75,31,1984
Robert French,"['Swaziland', 'Philippines']",Nurse,1872,52,76,1924
Chris Powell,"['Nigeria', 'Austria']",Military personnel,1878,41,81,1919
Mr. Frank Ross,['Mauritius'],Artist,1905,19,45,1924
Belinda Garrett,['French Guiana'],Artist,1919,89,45,2008
Steven Lewis DDS,"['Grenada', 'Micronesia']",Athlete,1873,51,15,1924
Stephanie Cannon,['Tokelau'],Politician,1896,65,32,1961
Isaac Nelson,"['Zimbabwe', 'Turkmenistan']",Monarch,1906,55,54,1961
Lisa Compton,"['Turkmenistan', 'Togo']",Athlete,1922,79,15,2001
Kyle Bell,['Ghana'],Artist,1885,60,86,1945
Tanya Robinson,"['Croatia', 'Serbia']",Politician,1891,67,53,1958
Amy Payne,['Bhutan'],Artist,1887,14,52,1901
Debra Jones,"['Bouvet Island (Bouvetoya)', 'Sierra Leone']",Serial killer,1882,56,14,1938
Brian Garcia,['Mauritania'],Artist,1887,2,31,1889
Aaron Chan,"['Tunisia', 'United States Virgin Islands']",Athlete,1889,10,41,1899
Lauren Martin,['Greece'],Politician,1871,0,13,1871
Philip Fernandez,['Niger'],Professional wrestler; amateur wrestler,1909,67,50,1976
David Guerrero,['France'],Military personnel,1917,18,16,1935
Emily Owens,['United States Virgin Islands'],Sovereign,1892,38,67,1930
Sheryl Daniel,"['French Polynesia', 'Denmark']",Military personnel,1872,16,16,1888
Kimberly Randolph,"['Myanmar', 'Gambia']",Teacher,1875,20,65,1895
Shane Williamson,['Tonga'],Athlete,1897,8,57,1905
Heather Harris,"['Trinidad and Tobago', 'Timor-Leste']",Artist,1923,49,14,1972
Ms. Melissa Harris,['Luxembourg'],Politician,1901,74,84,1975
Sarah Moore,"['Norfolk Island', 'French Guiana']",Politician,1906,49,30,1955
Courtney Black,['Guernsey'],Artist,1898,78,6,1976
David Garza,"[""Cote d'Ivoire"", 'Papua New Guinea']",Motorcycle racer; racing automobile driver,1903,3,77,1906
Luis Martin,"['Burkina Faso', 'Bulgaria']",Student; revolutionary,1917,64,37,1981
David Young,['Martinique'],Politician,1919,16,44,1935
Eric Brown,['Uzbekistan'],Religious figure,1909,52,79,1961
Julia Rivera,['Mozambique'],Artist,1889,73,15,1962
Daniel Smith,"['Liechtenstein', 'Tokelau']",Politician,1902,34,26,1936
David Garcia,['Vanuatu'],Artist,1870,84,16,1954
Daniel Oneill,['Heard Island and McDonald Islands'],Joiner; resistance fighter; mountaineer,1922,40,69,1962
Dalton Brown,['Sri Lanka'],Researcher,1907,1,72,1908
Karen Burgess,['Sudan'],Military personnel,1923,4,46,1927
Derek Zhang,"['Somalia', 'Belize']",Artist,1913,10,34,1923
Tiffany Davis,['Bosnia and Herzegovina'],Costume designer,1875,54,89,1929
Michele Boyd,"['Cook Islands', 'Bangladesh']",Artist,1902,14,26,1916
Karen King,"['Canada', 'Senegal']",Artist,1874,46,88,1920
Douglas Zimmerman,['Switzerland'],Military personnel,1883,73,52,1956
Kelly Cardenas DVM,"['Belarus', 'Rwanda']",Politician,1878,32,53,1910
Emily Grant,"['Burundi', 'Wallis and Futuna']",Artist,1914,39,9,1953
Julie Owen,"['Dominican Republic', 'Latvia']",Artist,1877,89,32,1966
Jacob Frank,"['Australia', 'Oman']",Politician,1921,28,62,1949
Jonathon Taylor,"['Libyan Arab Jamahiriya', 'Belize']",Politician,1890,51,17,1941
Gina Miller,"['Belarus', 'Swaziland']",Artist,1878,62,60,1940
Vanessa Daniel,"['Guam', 'Chile']",Politician,1897,54,72,1951
Alejandro Simpson,"['Burundi', 'Mexico']",Athlete,1912,29,1,1941
Natalie Wade,['Cook Islands'],Artist,1911,55,65,1966
Ashley Williams,"['Tajikistan', 'Grenada']",Artist,1887,88,25,1975
Norman Mendez,['Nigeria'],Military personnel,1909,0,74,1909
Vincent Kerr DDS,"['Kuwait', 'Romania']",Politician,1901,31,25,1932
Natalie Washington,['Comoros'],Researcher,1872,81,37,1953
April Simpson,['Panama'],Artist,1872,81,66,1953
Shannon Chavez,"['Guyana', 'Kenya']",Artist,1877,20,11,1897
Jeffrey Mills,"['Croatia', 'Pakistan']",Artist,1901,63,84,1964
Anthony May,"[""Cote d'Ivoire""]",Religious figure,1920,8,57,1928
Kelsey Wilson,['Fiji'],Military personnel,1900,17,53,1917
Brendan Moss,"['Fiji', 'Turks and Caicos Islands']",Athlete,1871,3,83,1874
Michael Becker,['Fiji'],Artist,1915,34,14,1949
George Lopez,['Puerto Rico'],Serial killer,1890,15,59,1905
Mary Callahan,"['Bouvet Island (Bouvetoya)', 'Bermuda']",Researcher,1879,48,41,1927
David Holt,['Cook Islands'],Researcher,1896,83,19,1979
Jeremy Armstrong,"['Swaziland', 'Gambia']",Military personnel,1921,65,38,1986
Daniel Spears,['Bulgaria'],Athlete,1872,27,53,1899
Phillip Molina,['Iran'],Artist,1898,22,11,1920
Lance Berg,['Peru'],Artist,1885,65,46,1950
Stacey Smith,"['Benin', 'Lesotho']",Researcher,1911,72,53,1983
Sandra Cortez,"['Malawi', 'Niue']",Politician,1885,49,68,1934
Bonnie Simmons,['Vietnam'],Teacher,1877,25,12,1902
Brandon Adams,"['Mauritius', 'British Virgin Islands']",Politician,1922,2,81,1924
Luis Brown,"['Belize', 'Seychelles']",Artist,1871,12,50,1883
James Green,"['Bosnia and Herzegovina', 'Burkina Faso']",Serial killer,1877,73,37,1950
Meghan George,"['Colombia', 'United Kingdom']",Physician,1897,50,15,1947
Jill Moore,['Kyrgyz Republic'],Military personnel,1882,42,17,1924
Thomas Nunez III,['Uzbekistan'],Researcher,1906,2,25,1908
Jared Salas,"['Botswana', 'Tunisia']",Researcher,1898,56,71,1954
Louis Garcia,"['Egypt', 'United Arab Emirates']",Researcher,1888,37,80,1925
Robert Morales,['El Salvador'],Athlete,1921,80,9,2001
Frank Lowery,"['India', 'Georgia']",Politician,1901,88,89,1989
Katie Stewart,"['Cook Islands', 'Palau']",Military personnel,1870,31,8,1901
Aaron Jones,['Costa Rica'],Artist,1895,1,51,1896
Shelly Sharp,['Bouvet Island (Bouvetoya)'],Politician,1878,20,0,1898
Anthony Daniel,"['Saint Martin', 'Nigeria']",Artist,1881,11,60,1892
Miranda Watts,"['Zambia', 'El Salvador']",Artist,1923,66,78,1989
Amber Reyes,['Cocos (Keeling) Islands'],Racing automobile driver; formula one driver,1922,6,75,1928
Curtis Craig,"['Cayman Islands', 'Malta']",Artist,1887,28,25,1915
David Griffin,"['Lesotho', 'Latvia']",Athlete,1913,40,48,1953
Jennifer Lee,"['Jamaica', 'Israel']",Military personnel,1900,41,49,1941
Susan Osborne,"['United States Minor Outlying Islands', 'Niue']",Artist,1883,25,3,1908
George Jackson,['Slovenia'],Politician,1917,31,84,1948
Crystal Hill,"['United States Minor Outlying Islands', 'Cape Verde']",Athlete,1895,36,2,1931
Hannah Young,"['China', 'Sweden']",Politician,1923,88,48,2011
Timothy Chen,['Congo'],Artist,1885,42,17,1927
Walter Bryant,"['Jordan', 'Gibraltar']",Politician,1911,52,12,1963
Philip Myers,"['Zambia', 'British Indian Ocean Territory (Chagos Archipelago)']",Politician,1881,81,48,1962
Katherine Wheeler,"['Guernsey', 'Ethiopia']",Politician,1884,59,39,1943
Charles Robinson,['Vanuatu'],Researcher,1886,66,39,1952
Dr. Jessica Herman,"['Montserrat', 'Guyana']",Racing automobile driver; formula one driver,1879,1,60,1880
Carol Short DDS,['Tunisia'],Military personnel,1893,69,85,1962
Robert Hernandez,['Uzbekistan'],Politician,1883,65,86,1948
Derek Brown,"['French Polynesia', 'Saint Lucia']",Artist,1874,46,65,1920
Shane Mendoza,"['Philippines', 'Iran']",Athlete,1902,28,4,1930
Beth Murphy,['Sri Lanka'],Journalist,1900,34,54,1934
Samantha Murphy,"['Belize', 'Antigua and Barbuda']",Artist,1875,84,44,1959
Chad Gutierrez,['Palestinian Territory'],Rower,1910,81,26,1991
Philip Morris,['Kuwait'],Engineer,1915,34,77,1949
David Dominguez,"['Guinea-Bissau', 'Georgia']",Artist,1902,25,33,1927
Joseph Hogan,['Armenia'],Artist,1921,82,74,2003
Rachel Hardin,"['Kiribati', 'Andorra']",Politician,1898,8,28,1906
Amanda Hall,"['Kazakhstan', 'Guinea-Bissau']",Artist,1887,74,45,1961
Ryan Cunningham,"['New Caledonia', 'Austria']",Artist,1891,31,48,1922
Abigail Wilson,"['Slovenia', 'Cape Verde']",Artist,1890,28,73,1918
Tony Miller,['Turkey'],Athlete,1880,9,5,1889
Linda Walker,"['Myanmar', 'Israel']",Politician,1916,37,40,1953
Anthony Wilson,"['Eritrea', 'Northern Mariana Islands']",Artist,1885,81,47,1966
Christian Fleming,['Bahamas'],Artist,1888,82,18,1970
James Mccarthy,['Mexico'],SalonniÃ¨re; model,1911,43,49,1954
Ann Fuentes,"['Jamaica', 'Rwanda']",Artist,1912,88,86,2000
Amy Summers,"['Moldova', 'Indonesia']",Athlete,1892,21,85,1913
Cheryl Johnson,"['British Virgin Islands', 'Gabon']",Artist,1890,85,65,1975
Misty Mcdowell,['United Arab Emirates'],Politician,1880,40,27,1920
Joseph Henry,"['Saint Vincent and the Grenadines', 'Mauritania']",Artist,1903,69,85,1972
Jenna Phillips,"['French Guiana', ""Lao People's Democratic Republic""]",Politician,1921,14,35,1935
Albert Ryan,"['Netherlands', 'United Kingdom']",Politician,1874,24,46,1898
Lori Haley,"['New Caledonia', 'Japan']",Politician,1902,73,41,1975
Debbie Schaefer,['Saudi Arabia'],Military personnel,1882,1,7,1883
Ian Carey,"['United Arab Emirates', 'Saint Lucia']",Artist,1871,61,86,1932
Ethan Luna,"['Lesotho', 'Dominica']",Athlete,1904,42,84,1946
Amy Weber,"['Belarus', 'Argentina']",Artist,1870,18,7,1888
Danielle Daniels,"['Saint Martin', 'Rwanda']",Politician,1887,38,50,1925
Rebekah Holland,"['Svalbard & Jan Mayen Islands', 'Morocco']",Artist,1876,57,56,1933
Cody Jones,"['Angola', 'Jamaica']",Artist,1874,50,32,1924
Stacy Cain,"['Brunei Darussalam', 'Kenya']",Journalist,1910,47,32,1957
Travis Dickson,"['Turkey', 'Peru']",Politician,1924,44,14,1968
Robert Smith,"['United States of America', 'Lithuania']",Artist,1875,87,88,1962
Jennifer Keith,['Haiti'],Athlete,1921,3,50,1924
Alexandria Chapman,"['Mozambique', 'Maldives']",Artist,1920,9,35,1929
Gary Clark,"['Greece', 'Armenia']",Politician,1885,36,69,1921
David Velasquez,"['Comoros', 'Comoros']",Artist,1873,70,35,1943
Matthew Harding,"['Dominica', 'Christmas Island']",Artist,1877,49,16,1926
Marcus Buckley,"['Egypt', 'Iceland']",Politician,1903,28,86,1931
Lauren Reyes,['Jamaica'],Politician,1871,61,49,1932
John Warren,['Norway'],Impostor,1893,42,71,1935
Jeremy Bass,"['Benin', 'Kenya']",Politician,1922,19,85,1941
Nicole Cervantes,"['Italy', 'Indonesia']",Politician,1894,57,37,1951
Melissa Novak,"['Falkland Islands (Malvinas)', 'Eritrea']",Artist,1876,23,60,1899
Elaine Pierce,['American Samoa'],Artist,1876,40,2,1916
Nicholas Decker,"['Saint Vincent and the Grenadines', 'Gibraltar']",Politician,1896,22,4,1918
Alyssa Kennedy,['Gabon'],Politician,1923,75,59,1998
Joshua Griffin,"['Taiwan', 'Egypt']",Researcher,1882,59,84,1941
Catherine Harper,"['Denmark', 'Antarctica (the territory South of 60 deg S)']",Politician,1870,85,61,1955
Cathy Chambers,['Cambodia'],Disc jockey; rapper; music producer,1917,0,1,1917
James Burnett,['Niue'],Researcher,1918,37,82,1955
Dr. Anthony Avery MD,"['Liberia', 'Reunion']",Artist,1874,55,34,1929
Shelby Evans,['Christmas Island'],Artist,1897,78,84,1975
Mark Morris,"['Russian Federation', 'Aruba']",Politician,1876,2,54,1878
Austin Thomas,"['Albania', 'Comoros']",Researcher,1898,58,49,1956
Richard Hamilton,['France'],Politician,1903,21,9,1924
Sarah Berry,"['Thailand', 'Isle of Man']",Criminal,1898,43,29,1941
Katherine Holt,['Afghanistan'],Artist,1902,89,84,1991
Thomas Harmon,"['Tunisia', 'Hong Kong']",Artist,1910,13,31,1923
Peter Bates,['Guinea'],Athlete,1909,40,20,1949
Curtis Dominguez,"['Sweden', 'Singapore']",Artist,1914,19,59,1933
Edward Watson MD,"['Switzerland', 'French Guiana']",Artist,1922,74,44,1996
Christian Diaz,"['Canada', 'North Macedonia']",Athlete,1917,10,50,1927
John Stout,"['British Virgin Islands', 'Vanuatu']",Military personnel,1873,59,62,1932
Andrew Graham,"['Taiwan', 'Belgium']",Researcher,1901,33,26,1934
Nicholas Jones,['Madagascar'],Athlete,1919,41,56,1960
Isabella Johnson,"['Ecuador', 'Faroe Islands']",Artist,1924,37,4,1961
Brittany Dunn,"['Belarus', 'Grenada']",Artist,1901,9,82,1910
Susan Brooks,['San Marino'],Athlete,1923,65,78,1988
Edward Johnson,['French Southern Territories'],Artist,1922,58,85,1980
Jason Nguyen,"['French Southern Territories', 'Tokelau']",Athlete,1880,48,44,1928
Dylan Ingram,['Saint Barthelemy'],Politician,1878,19,14,1897
Kathy Johnson,['Norfolk Island'],Artist,1878,56,25,1934
Timothy Harris,['Syrian Arab Republic'],Artist,1913,44,65,1957
Mark Kennedy,"['Portugal', 'Moldova']",Artist,1887,36,52,1923
Timothy Allison,"['Tokelau', 'Botswana']",Artist,1887,12,39,1899
James Taylor,['Haiti'],Artist,1907,9,40,1916
Renee Rose,['Bouvet Island (Bouvetoya)'],Cinematographer,1872,66,82,1938
Tina Peters,"['Korea', 'Maldives']",Artist,1870,7,65,1877
Laura Martinez,"['United States Minor Outlying Islands', 'Zimbabwe']",Politician,1897,25,11,1922
Michele Sanders,['Myanmar'],Artist,1873,17,25,1890
Lauren Leonard,"['Montenegro', 'Singapore']",Artist,1900,3,89,1903
Kristie Robinson,['Burundi'],Artist,1904,8,9,1912
Amber Smith,['Afghanistan'],Politician,1900,75,28,1975
Joshua Simmons,"['Greenland', 'Kuwait']",Artist,1916,19,49,1935
Bobby Walters,"['Uzbekistan', 'Tanzania']",Artist,1901,22,39,1923
Kristen Murphy,['Canada'],Artist,1905,76,58,1981
Jonathan Walker,['Liechtenstein'],Politician,1896,87,70,1983
Megan Evans,"['Falkland Islands (Malvinas)', 'Armenia']",Politician,1910,8,17,1918
Cynthia Rodriguez,['Macao'],Politician,1882,48,61,1930
Emma Garcia,['Kuwait'],Artist,1872,35,41,1907
Jonathan Irwin,"['Belgium', 'Suriname']",Politician,1916,85,89,2001
Shawn Singh,['Namibia'],Artist,1922,24,32,1946
Rebecca Mcdaniel,"['Bouvet Island (Bouvetoya)', 'Uzbekistan']",Artist,1881,25,39,1906
Ana Medina,['Morocco'],Politician,1910,13,24,1923
Darrell Lynch,['Lebanon'],Politician,1923,60,82,1983
Samuel Preston,['Guinea-Bissau'],Artist,1893,27,66,1920
Troy Walker,['Myanmar'],Artist,1908,12,13,1920
Barbara Mcintosh,['Antarctica (the territory South of 60 deg S)'],Politician,1873,18,56,1891
Jeffrey Snyder,"['Tokelau', 'Cyprus']",Politician,1876,37,21,1913
Jessica Fox,"['Guatemala', 'Lithuania']",Military personnel,1884,12,41,1896
Sheila Garcia,['Guinea-Bissau'],Politician,1874,58,34,1932
Jennifer Oneal,"['Cuba', 'New Caledonia']",Artist,1917,84,12,2001
Sandra Carroll,['Montenegro'],Military personnel,1888,69,40,1957
Gina Roy,['Greece'],Artist,1886,38,44,1924
Chad Spencer,"['Papua New Guinea', 'Gibraltar']",Artist,1899,58,3,1957
Kevin Miller,['Zimbabwe'],Artist,1909,43,32,1952
Thomas Gallegos,"['Mauritania', 'Yemen']",Artist,1880,68,67,1948
Tricia White,['Papua New Guinea'],Politician,1889,7,55,1896
Michelle Bennett,['Gambia'],Artist,1895,8,87,1903
Xavier Lane,['Maldives'],Researcher,1871,55,4,1926
Lawrence Hernandez,['Austria'],Engineer,1890,85,28,1975
Michael Gregory,"['Montenegro', 'Myanmar']",Military personnel,1887,54,25,1941
Andrew Mills,['Jamaica'],Philosopher,1880,39,20,1919
Gina Hunter,['Liberia'],Military personnel,1899,37,18,1936
Kristin Hendricks,"['Lesotho', 'Greece']",Artist,1897,64,51,1961
James Hernandez,"['Equatorial Guinea', 'Tuvalu']",Researcher,1905,57,23,1962
Shane Davidson,['Suriname'],Artist,1897,58,26,1955
James Gordon,['Maldives'],Athlete,1919,41,67,1960
Rebekah Hays,"['Cocos (Keeling) Islands', 'Saint Martin']",Circus performer,1888,76,47,1964
Loretta Boyd,['Barbados'],Serial killer; criminal,1878,28,51,1906
Melissa Williams,"['Reunion', 'Uzbekistan']",Artist,1924,22,21,1946
Michael Osborne,"['Bermuda', 'Syrian Arab Republic']",Athlete,1871,51,81,1922
David Meyer,"['Gambia', 'Western Sahara']",Artist,1918,4,50,1922
Stephanie Long,"['Trinidad and Tobago', 'Niger']",Artist,1885,73,72,1958
Ralph Gibson,"['Italy', 'Bangladesh']",Politician,1870,73,65,1943
Max Edwards,"['Cape Verde', 'Saint Helena']",Artist,1880,22,34,1902
Heidi Sullivan,"['Singapore', 'Taiwan']",Athlete,1888,22,65,1910
Mark Anderson,"['India', 'New Zealand']",Researcher,1877,83,68,1960
Christy Thornton,['Vanuatu'],Artist,1877,77,20,1954
Megan Smith,"['New Zealand', 'Senegal']",Artist,1878,2,66,1880
Walter Donaldson,"['Panama', 'Spain']",Artist,1897,86,48,1983
Martha Guzman,['Western Sahara'],Teacher,1893,23,68,1916
Rachel Patterson,"['Andorra', 'Kuwait']",Researcher,1891,67,54,1958
Kelly Weiss,"['Austria', 'Thailand']",Researcher,1920,29,89,1949
Mario Lambert,"['Puerto Rico', 'Aruba']",Artist,1872,32,1,1904
David Day,['Uruguay'],Artist,1919,86,10,2005
Renee Anthony,['Palau'],Politician,1887,57,82,1944
Robert Hudson,['South Africa'],Athlete,1914,30,18,1944
Lindsay Carter,"['Turkmenistan', 'Puerto Rico']",Athlete,1907,0,0,1907
Joshua Holt,['Panama'],Artist,1876,19,78,1895
Patrick Long,"['Indonesia', 'Congo']",Politician,1910,75,21,1985
Robin Davis,"['Aruba', 'Belgium']",Artist,1877,23,81,1900
Mr. Phillip Cox Jr.,['Jersey'],Artist,1919,55,22,1974
Michelle Potter,"['Isle of Man', 'Kiribati']",Religious figure,1887,0,86,1887
Donna Luna,"['Azerbaijan', 'Afghanistan']",Artist,1873,87,84,1960
Robin Payne,['France'],Military personnel,1898,65,84,1963
Robert Hernandez,"['Azerbaijan', 'New Zealand']",Artist,1874,89,20,1963
Timothy Berry,"['Brunei Darussalam', 'Liberia']",Artist,1896,85,69,1981
Kathleen Garza,['Samoa'],Athlete,1891,70,20,1961
Steven Brown,"['Tunisia', 'Holy See (Vatican City State)']",Artist,1909,19,33,1928
Scott Bell,"['Moldova', 'Egypt']",Prostitute,1877,8,38,1885
Stephen Roach,"['Tajikistan', 'Barbados']",Teacher,1903,69,24,1972
Marcus Smith,"['Taiwan', 'Malta']",Researcher,1921,73,64,1994
Bill Kelly,"['Gibraltar', 'Dominica']",Artist,1876,52,55,1928
Kylie Chang,"['Austria', 'Moldova']",Artist,1899,0,23,1899
Jessica Smith,['Albania'],Artist,1922,72,21,1994
Dawn Jackson,['Grenada'],Politician,1883,38,79,1921
Dennis Murphy,['Switzerland'],Military personnel,1907,8,57,1915
Cynthia Freeman,"['Germany', 'Togo']",Military personnel,1923,40,81,1963
Anthony Anderson,"['Ecuador', 'Cape Verde']",Physician,1896,62,80,1958
Carla Johnson,"['Switzerland', 'Tokelau']",Nun; pianist,1922,67,5,1989
Michelle Smith,['Saint Lucia'],Researcher,1882,86,32,1968
Michael Cook,"['Thailand', 'Saint Martin']",Artist,1879,73,33,1952
Matthew Green,"['French Southern Territories', 'Samoa']",Politician,1921,54,0,1975
Marie Jones,"['Mongolia', 'Morocco']",Formula one driver,1888,71,42,1959
Joshua Gomez,"['China', 'Western Sahara']",Artist,1878,62,73,1940
Joseph Wagner,['Slovakia (Slovak Republic)'],Artist,1918,16,22,1934
Mr. Dustin Combs,['Finland'],Artist,1886,2,11,1888
James Jackson,"['Ecuador', 'Uruguay']",Artist,1878,20,19,1898
James Williams,"['Tonga', 'Oman']",Artist,1919,0,57,1919
Luis Soto,"['Guernsey', 'Kiribati']",Explorer,1890,74,52,1964
Jeffrey Cummings,['Saint Kitts and Nevis'],Politician,1893,42,62,1935
David Brandt,['Bolivia'],Artist,1881,79,48,1960
Mary Livingston,"['Australia', 'Qatar']",Athlete,1891,10,42,1901
Larry Smith,"['Mexico', 'Guyana']",Artist,1877,67,4,1944
Juan Perez,['Suriname'],Athlete,1923,37,33,1960
Carrie Roy,['Brunei Darussalam'],Artist,1899,82,71,1981
Catherine Morgan,"['Tunisia', 'Belarus']",Artist,1910,25,57,1935
Richard Oneal,"['Liberia', 'Cuba']",Architect,1902,61,55,1963
Alexander Robertson,"['Nauru', ""Lao People's Democratic Republic""]",Athlete,1906,10,8,1916
Anna Becker MD,['Egypt'],Artist,1922,70,7,1992
Teresa Hebert,['Cocos (Keeling) Islands'],Artist,1916,14,9,1930
Thomas Bennett,['Vietnam'],Journalist,1881,36,22,1917
Diana Morales,"['France', 'Austria']",Artist,1870,52,40,1922
Destiny Nelson,['Russian Federation'],Military personnel,1882,57,53,1939
Theodore Sparks,['Saint Lucia'],Researcher,1901,9,12,1910
Melissa Bell,"['Moldova', 'Reunion']",Artist,1887,47,50,1934
Eric Stewart,"['Equatorial Guinea', 'Turks and Caicos Islands']",Artist,1915,14,89,1929
Luis Blankenship,"['Northern Mariana Islands', 'Madagascar']",Politician,1884,72,71,1956
Michael Owens,"['Netherlands Antilles', 'Saint Kitts and Nevis']",Artist,1903,45,42,1948
Robert Ramos,['Dominican Republic'],Researcher,1906,65,54,1971
Robert Evans,"['Holy See (Vatican City State)', 'Seychelles']",Politician,1902,15,6,1917
Robert King,['Antarctica (the territory South of 60 deg S)'],Artist,1907,70,88,1977
Bonnie Castro,['Greenland'],Artist,1906,53,80,1959
Devin Olson,['Bouvet Island (Bouvetoya)'],Researcher,1915,86,81,2001
Brandon Caldwell,"['Tokelau', 'Bermuda']",Military personnel,1873,26,14,1899
Matthew Campbell,"['Qatar', 'Gabon']",Artist,1913,51,77,1964
Adam Morris,['Cook Islands'],Politician,1889,0,73,1889
Dustin Mcclain,['Egypt'],Artist,1880,54,57,1934
Katrina Hill,['Italy'],Artist,1903,49,89,1952
Justin Foster,"['Gambia', 'South Africa']",Artist,1883,32,68,1915
Bradley Campbell,"['Kazakhstan', ""Lao People's Democratic Republic""]",Athlete,1892,57,62,1949
Daniel Smith,"['Iran', 'Georgia']",Politician,1910,78,34,1988
Angela Powell,"['Korea', 'Madagascar']",Athlete,1887,52,24,1939
Cassandra Lloyd,"['Greenland', 'South Georgia and the South Sandwich Islands']",Artist,1884,25,25,1909
Michael Peterson,"['Singapore', 'Luxembourg']",Mangaka,1893,17,88,1910
Amanda Brown,"['Algeria', 'Norway']",Athlete,1873,20,16,1893
Charles Lee,"['Belgium', 'Guyana']",Politician,1903,46,3,1949
Christopher Rodriguez,"['Saudi Arabia', 'Argentina']",Artist,1892,13,8,1905
Phillip Harper,['Bhutan'],Military personnel,1921,35,87,1956
Amanda Vasquez,"['Qatar', 'Cocos (Keeling) Islands']",Politician,1905,81,64,1986
Randall Dyer,['Afghanistan'],Artist,1907,24,60,1931
Kenneth Hutchinson,"['Holy See (Vatican City State)', 'Luxembourg']",Businessperson,1880,79,12,1959
David Cervantes,"['Gambia', 'Svalbard & Jan Mayen Islands']",Artist,1876,14,80,1890
Angela Sanchez,['Guatemala'],Politician,1893,62,34,1955
Charles Thompson,"['Ghana', 'Uruguay']",Politician,1887,38,14,1925
Christian Brown,['Bhutan'],Politician,1882,18,63,1900
Claudia Evans,['Chad'],Politician,1888,65,48,1953
Michael Frost,['Solomon Islands'],Artist,1907,6,21,1913
Carla Fernandez,['Jersey'],Politician,1873,21,35,1894
Daniel Smith,['Guadeloupe'],Politician,1924,21,40,1945
Joshua Santos MD,['Niger'],Athlete,1888,4,61,1892
Manuel Thornton,['Sierra Leone'],Serial killer; prostitute,1910,79,88,1989
Carolyn Adkins,"['Turks and Caicos Islands', 'Kiribati']",Politician,1919,24,18,1943
Tony Spencer,"['Brazil', 'Taiwan']",Artist,1901,33,72,1934
Katelyn Mitchell,"['Cocos (Keeling) Islands', 'Thailand']",Engineer,1878,62,21,1940
Lisa King,['Djibouti'],Teacher,1887,19,35,1906
Mr. Peter King,['British Indian Ocean Territory (Chagos Archipelago)'],Researcher,1910,32,20,1942
Charles Bentley,['Niue'],Athlete,1888,15,13,1903
Theresa Simpson,"['Argentina', 'Ethiopia']",Athlete,1910,72,26,1982
Eric Thomas,"['Kuwait', 'United Arab Emirates']",Politician,1894,28,54,1922
Ariana Carlson,['Saint Martin'],Bushranger,1899,32,50,1931
Shannon English,['British Virgin Islands'],Formula one driver,1914,33,12,1947
Lisa Anderson,['Dominican Republic'],Businessperson,1913,0,60,1913
Samuel Brown,"['Norfolk Island', 'Chile']",Criminal,1919,49,42,1968
Alec Rhodes,['Lithuania'],Researcher,1907,63,32,1970
Kristi Young,['Bulgaria'],Artist,1883,20,13,1903
Adam Zhang,"['Tuvalu', 'New Caledonia']",Artist,1913,17,49,1930
Christopher Rodriguez,"['Oman', 'Armenia']",Artist,1923,51,65,1974
Peter Richards,"['Taiwan', 'Central African Republic']",Military personnel,1910,14,57,1924
Roger Rowland,"['Luxembourg', 'United Kingdom']",Businessperson,1870,82,74,1952
Margaret Bryant,"['Martinique', 'Liberia']",Athlete,1887,58,13,1945
Traci Woods,"['Mongolia', 'Czech Republic']",Politician,1872,71,47,1943
Peter Pham,['Norway'],Researcher,1871,67,39,1938
Linda Cantu,['Iran'],Artist,1907,57,88,1964
Susan Johnston,"['Saint Martin', 'San Marino']",Nurse,1911,71,19,1982
James Fowler,['France'],Artist,1886,71,56,1957
Mrs. Kristi Brown,['Swaziland'],Politician,1907,24,45,1931
Alexandria Harper,['Angola'],Artist,1884,58,9,1942
Thomas Ellis,['Rwanda'],Politician,1919,67,78,1986
Jennifer Watkins,"['Taiwan', 'Korea']",Politician,1871,13,40,1884
Amanda Meyer,['Jamaica'],Artist,1885,49,66,1934
Tina Macdonald,"['Slovenia', 'Guatemala']",Artist,1875,23,69,1898
Tony Wagner,['Turkey'],Artist,1913,72,2,1985
Angela Collins,"['Cocos (Keeling) Islands', 'Finland']",Executive producer; film producer,1918,24,45,1942
Charles Lee,['Brunei Darussalam'],Politician,1892,31,25,1923
Nicholas Berry,['Swaziland'],Artist,1878,55,89,1933
Rhonda Torres,['Benin'],Artist,1878,41,61,1919
Amber Aguirre,"['Netherlands Antilles', 'Ireland']",Artist,1907,57,72,1964
Kimberly Fowler,"['Bosnia and Herzegovina', 'Central African Republic']",Politician,1915,50,74,1965
Miguel Rogers,"['Lesotho', 'Luxembourg']",Artist,1922,44,23,1966
Linda Lewis,['Kuwait'],Artist,1901,89,1,1990
William Wang,"['Ukraine', 'Armenia']",Serial killer,1924,6,15,1930
Bethany Meyer,"['Iceland', 'Czech Republic']",Artist,1908,27,74,1935
Daniel Parks,"['United Arab Emirates', 'Nigeria']",Artist,1914,0,13,1914
Shawna Williams,['Netherlands Antilles'],Artist,1879,29,19,1908
Todd Lopez,['Papua New Guinea'],Military personnel,1910,32,26,1942
Jennifer Shaw,"['Cook Islands', 'British Virgin Islands']",Artist,1879,66,83,1945
Daniel Fleming,['United States Virgin Islands'],Journalist,1901,72,32,1973
Ashley Barrett,"['Guinea', 'Lithuania']",Religious figure,1916,71,22,1987
Andrew Shelton,['Tuvalu'],Politician,1872,22,75,1894
Mr. Gregory Johnson,"['Netherlands', 'Bahamas']",Politician,1896,65,1,1961
Jasmin Mclean,"['Germany', 'Libyan Arab Jamahiriya']",Military personnel,1872,80,79,1952
Michael Levine,"['Reunion', 'United States Virgin Islands']",Artist,1872,24,69,1896
Margaret Walters,"['Spain', 'Morocco']",Politician,1913,83,67,1996
Michelle Harrison,"['South Georgia and the South Sandwich Islands', 'Netherlands Antilles']",Artist,1872,80,30,1952
Melissa Cooper,['United States Minor Outlying Islands'],Artist,1887,68,15,1955
Jacob Williams,['Azerbaijan'],Resistance fighter; trade unionist,1893,57,11,1950
Theresa Oconnor DVM,"['Norfolk Island', 'Haiti']",Politician,1898,4,40,1902
David Williams,['Finland'],Politician,1921,36,79,1957
Tyler Knapp,['Guernsey'],Athlete,1875,73,48,1948
Robert Martin,"['Fiji', 'Sweden']",Artist,1907,1,57,1908
Tracy Hamilton,"['Qatar', 'Costa Rica']",Researcher,1918,27,31,1945
Katie Jones,"['Tanzania', 'South Africa']",Military personnel,1889,0,39,1889
Monica Richards,"['Turkmenistan', 'Paraguay']",Military personnel,1904,58,14,1962
Lucas Malone,"['Swaziland', 'Burkina Faso']",Artist,1923,75,47,1998
Sandra Gray DVM,['Libyan Arab Jamahiriya'],Artist,1922,50,59,1972
Adrian Stewart,['Latvia'],Artist,1879,62,37,1941
April Parsons,"['South Georgia and the South Sandwich Islands', 'Belgium']",Artist,1913,21,0,1934
Tony Reese,['Malawi'],Military personnel,1873,79,22,1952
Ashley Brown,"['Nepal', 'Japan']",Artist,1872,79,26,1951
Amanda Vega,"['Saint Lucia', 'Romania']",Criminal; smuggler,1876,85,61,1961
Jimmy Bowen,"['Malawi', 'Trinidad and Tobago']",Politician,1880,54,22,1934
William Holland,"['Tanzania', 'Liechtenstein']",Politician,1903,39,66,1942
Samuel Ramirez,['Cape Verde'],Politician,1916,19,49,1935
Anthony Brown,"['Madagascar', 'Luxembourg']",Athlete,1880,39,43,1919
Alyssa Garrett,['Holy See (Vatican City State)'],Artist,1898,38,25,1936
Rebecca Cabrera,"['United Arab Emirates', 'Antigua and Barbuda']",Athlete,1924,63,6,1987
Mckenzie Rodriguez,['Suriname'],Religious figure,1909,20,69,1929
Chad Cannon,['Israel'],Athlete,1876,25,15,1901
Ashley Lyons,['Namibia'],Military personnel,1918,47,77,1965
Shirley Castillo,['Central African Republic'],Researcher,1889,63,9,1952
Jennifer Peterson,"['Greece', 'United States Minor Outlying Islands']",Artist,1909,21,34,1930
Allen Mcintosh,['Barbados'],Military personnel,1877,60,33,1937
Samantha Pittman,['Poland'],Politician,1916,22,38,1938
Vincent Parker,"['Eritrea', 'Israel']",Artist,1919,26,36,1945
Rachel Wolf,['Fiji'],Sprinter,1905,80,64,1985
Jodi Mason,"['American Samoa', 'Libyan Arab Jamahiriya']",Artist,1888,79,22,1967
Tracey Nguyen,['Bahrain'],Religious figure,1915,41,21,1956
Jenny Smith,['United Arab Emirates'],Artist,1914,17,78,1931
John Gilbert,['Turkey'],Politician,1870,58,63,1928
Michael Lopez,['France'],Officer of the french navy; explorer,1922,20,31,1942
Steven Hartman,['Burundi'],Athlete,1889,27,7,1916
John Smith,['Algeria'],Athlete,1894,78,24,1972
Joshua Pugh,"['Tonga', 'Yemen']",Researcher,1898,40,6,1938
Sharon Bailey,['Dominica'],Aristocrat,1889,61,41,1950
Mark Delacruz,['Mayotte'],Military personnel,1876,62,88,1938
Katherine Jones,"['Oman', 'Egypt']",Artist,1876,36,14,1912
Grace Meyer,"['Spain', 'Paraguay']",Politician,1879,38,14,1917
Sarah Williams,['Fiji'],Medievalist,1888,3,71,1891
Gregory Campbell,['Uzbekistan'],Artist,1886,75,9,1961
Jennifer Carroll,['Congo'],Military personnel,1877,75,49,1952
Heather Lang,['Rwanda'],Aristocrat,1874,49,69,1923
Samantha Wall,"['Benin', 'Tanzania']",Artist,1887,83,89,1970
Antonio Powell,['Germany'],Researcher,1915,42,9,1957
Joseph Reyes,"['Congo', 'Montserrat']",Artist,1905,7,89,1912
Sara Diaz,['Tajikistan'],Businessperson,1913,47,46,1960
Steven Taylor,"['Oman', 'French Southern Territories']",Chamberlain,1900,71,58,1971
Jerry Saunders,['Singapore'],Artist,1889,5,84,1894
Jennifer Cunningham,['Nicaragua'],Artist,1889,28,56,1917
Michael May IV,['Turks and Caicos Islands'],Athlete,1894,27,37,1921
Deanna Harper,"['Oman', 'Macao']",Artist,1890,44,71,1934
Megan Martin,['Rwanda'],Athlete,1915,71,6,1986
Dr. Joshua Wilson,['Guinea-Bissau'],Artist,1889,56,26,1945
Benjamin James,['Uruguay'],Artist,1899,47,68,1946
Nancy Williams,['South Africa'],Physician,1921,70,10,1991
Heather Rice,['Denmark'],Artist,1916,84,79,2000
Joseph Smith,['Guinea'],Politician,1910,5,22,1915
Candice Ward,['Hong Kong'],Artist,1892,52,43,1944
Todd Moreno,"['Cape Verde', 'Azerbaijan']",Athlete,1872,5,39,1877
Brenda White,['Korea'],Teacher,1879,20,19,1899
James Hall,"['Angola', 'Svalbard & Jan Mayen Islands']",Athlete,1894,22,21,1916
Bryan Long,['Hungary'],Teacher,1895,75,45,1970
Tina Houston,['Cuba'],Artist,1890,17,47,1907
David Powell,"['Slovenia', 'Tokelau']",Artist,1887,24,87,1911
Mr. Christopher Mccullough II,"['Burundi', 'Korea']",Artist,1914,65,51,1979
Carol Richards,['Angola'],Athlete,1902,17,60,1919
Veronica Cuevas,['Sweden'],Politician,1922,8,18,1930
Taylor Wilson,"['Armenia', 'Liberia']",Politician,1879,62,28,1941
Diane Williams MD,['Sri Lanka'],Artist,1897,62,3,1959
Christopher Gonzalez,"['Greenland', 'Benin']",Artist,1913,6,55,1919
Lisa Miller,"['Falkland Islands (Malvinas)', 'Togo']",Artist,1910,14,71,1924
Robert Bates,['Estonia'],Engineer,1884,39,5,1923
Danielle Smith,['Spain'],Artist,1915,79,16,1994
Samantha Barker,"['American Samoa', 'Eritrea']",Artist,1924,52,74,1976
John Hill DVM,['Guatemala'],Politician,1886,79,62,1965
Carla Benton,['Malaysia'],Politician,1874,74,39,1948
Elizabeth Brown,['Palau'],Artist,1892,71,20,1963
Keith Gonzalez,"['Oman', 'Guinea']",Artist,1918,43,48,1961
Deborah Monroe,['Israel'],Politician,1878,20,67,1898
Brandon Gonzalez,"['Sao Tome and Principe', 'Bahamas']",Artist,1894,59,50,1953
Tracy Burns,"['San Marino', 'Malta']",Athlete,1875,44,38,1919
Pamela Skinner,['Australia'],Artist,1890,60,0,1950
Casey Underwood,"['Ukraine', 'Aruba']",Researcher,1904,41,31,1945
Allison Wilson,"['Guam', 'Argentina']",Politician,1888,29,12,1917
Joe Moore,['Switzerland'],Military personnel,1922,7,7,1929
Michael Francis,['Christmas Island'],Politician,1880,87,40,1967
John Ashley,"['Azerbaijan', 'Malawi']",Athlete,1916,52,84,1968
James Gamble,['Andorra'],Artist,1900,13,21,1913
Mary Aguilar,"['India', 'Ecuador']",Military personnel,1892,28,16,1920
Vickie Patterson,"['Malaysia', 'Timor-Leste']",Researcher,1889,48,19,1937
Sarah Murray,['American Samoa'],Athlete,1893,27,38,1920
Ronald Weiss,"['Ethiopia', 'Costa Rica']",Artist,1900,4,11,1904
John Rivas,['Antigua and Barbuda'],Artist,1914,2,37,1916
Kristi Clark,"['Jamaica', 'Saint Vincent and the Grenadines']",Artist,1908,16,23,1924
Ryan Rivers,"['British Virgin Islands', 'Aruba']",Researcher,1896,51,56,1947
Samuel Crosby,['Kenya'],Military personnel,1895,80,39,1975
Katie Smith,['Congo'],Artist,1902,57,31,1959
Ashley Green,['Russian Federation'],Politician,1901,56,84,1957
Tracy Frost,['Uruguay'],Psychiatrist; neurologist,1905,74,88,1979
Kendra Young,"['Gabon', 'Netherlands']",Military personnel,1899,41,5,1940
Heather Smith,['Ethiopia'],Artist,1908,13,52,1921
Rodney Giles,"['Bolivia', 'Sudan']",Teacher,1919,10,51,1929
Stephen Guzman,['Aruba'],Politician,1880,78,85,1958
Victor Smith,"['Bolivia', 'Barbados']",Politician,1910,70,48,1980
Abigail Hampton,"['Costa Rica', 'Sao Tome and Principe']",Artist,1885,79,59,1964
Pamela Sherman,"['Cambodia', 'Falkland Islands (Malvinas)']",Aristocrat,1879,82,60,1961
Ernest Wheeler,['Ireland'],Artist,1893,6,73,1899
Todd Miller,['Gibraltar'],Artist,1902,49,68,1951
William Jordan,['Panama'],Politician,1903,77,8,1980
Jennifer Vaughan,['Saint Kitts and Nevis'],Politician,1872,51,18,1923
Heather Valdez,['Egypt'],Athlete,1910,17,64,1927
David Palmer,['Bosnia and Herzegovina'],Artist,1900,89,1,1989
Robert Foster,"['Maldives', 'Qatar']",Artist,1889,21,47,1910
Sabrina Smith,['Mali'],Artist,1899,14,78,1913
Victor Stevenson,['Suriname'],Politician,1874,11,73,1885
Alexander Patel,"['Romania', 'Nepal']",Artist,1876,51,14,1927
Matthew Murillo,['Tajikistan'],Artist,1877,7,78,1884
Jennifer Case,['Cocos (Keeling) Islands'],Politician,1878,21,31,1899
Thomas Mercer,"['Nicaragua', 'Kuwait']",Politician,1878,34,22,1912
Victoria Dillon,"['Macao', 'Palestinian Territory']",Artist,1903,72,64,1975
Randy Trujillo,['Honduras'],Religious figure,1896,49,88,1945
Bill Stanton,['Peru'],Military personnel,1907,35,30,1942
Antonio Butler,['Liberia'],Artist,1880,45,15,1925
Amy Collins,['Mongolia'],Artist,1910,50,44,1960
Randy Randolph,"['United Kingdom', 'Aruba']",Researcher,1883,32,71,1915
Michelle Fritz,"['Pakistan', 'Ukraine']",Artist,1880,12,73,1892
Theodore Cervantes,['United Kingdom'],Religious figure,1877,52,34,1929
Joseph Willis,"['Vietnam', 'Mauritius']",Athlete,1872,28,46,1900
Makayla Wilkerson,"['Chile', 'Samoa']",Researcher,1896,41,47,1937
Sonya Ruiz,"['Angola', 'Pakistan']",Artist,1912,54,43,1966
Lauren Savage,"['Portugal', 'Fiji']",Teacher,1903,87,18,1990
James Hughes,['Belarus'],Translator,1905,75,66,1980
Joel Pena,"['United States of America', 'Hungary']",Political activist,1871,19,24,1890
Andrea Jones,['Burkina Faso'],Politician,1911,23,2,1934
Michael Carey,"['Cuba', 'Ecuador']",Artist,1872,49,39,1921
Charles Mitchell,['Japan'],Artist,1898,43,15,1941
Latoya Phillips,['Timor-Leste'],Artist,1886,44,29,1930
Ronnie Gomez,"['Palau', 'Albania']",Artist,1911,5,82,1916
Donna Campbell,['Jersey'],Artist,1904,8,15,1912
Terry Hernandez,"['Canada', 'Greece']",Athlete,1871,24,35,1895
Nicholas Burke,"['Canada', 'Canada']",Comedian; stand-up comedian,1918,88,88,2006
William Miller,['Libyan Arab Jamahiriya'],Artist,1916,37,86,1953
Alex Smith,"['Mayotte', 'New Zealand']",Artist,1871,42,87,1913
Mrs. Diane Gonzalez,"['Gibraltar', 'Swaziland']",Gangster,1903,5,66,1908
Daniel Vasquez,"['Dominica', 'Sierra Leone']",Researcher,1920,22,32,1942
Justin Gordon,"['Syrian Arab Republic', 'Chad']",Teacher,1873,38,11,1911
Garrett Rodriguez,"['Hong Kong', 'Namibia']",Artist,1914,44,25,1958
Jennifer Miller,['North Macedonia'],Artist,1871,52,36,1923
Susan Davis,"['Sweden', 'Colombia']",Gangster; criminal,1910,33,51,1943
Daniel Logan,"['United Arab Emirates', 'Cuba']",Artist,1885,21,81,1906
Jacob Frazier,"['Saint Lucia', 'Maldives']",Artist,1895,72,55,1967
Haley Barron,['Mexico'],Athlete,1914,18,52,1932
Steven Mendoza,['Antarctica (the territory South of 60 deg S)'],Artist,1914,27,42,1941
Mr. Gerald Torres,['Saint Lucia'],Artist,1877,52,51,1929
Richard Bonilla,['Seychelles'],Politician,1897,88,26,1985
Christopher Moore,['Dominica'],Artist,1872,49,28,1921
Alexander Martinez,['Armenia'],Artist,1897,3,9,1900
Sandra Long,['Pakistan'],Businessperson,1904,66,62,1970
Brittany Hernandez,"['Bermuda', 'Myanmar']",Artist,1919,0,55,1919
Laura Wood,"['Zambia', 'Nepal']",Athlete,1913,85,71,1998
Jessica Smith,['Iran'],Artist,1880,49,34,1929
Pamela Hamilton,['Venezuela'],Researcher,1875,40,77,1915
Sarah Yang,"['Kuwait', 'Kyrgyz Republic']",Researcher,1906,8,33,1914
Christine Cooper,['San Marino'],Artist,1915,40,52,1955
Michele Dickerson,"['Poland', 'Mauritius']",Artist,1896,69,4,1965
Gail Pitts,['Niue'],Artist,1884,21,64,1905
Melody Cline,['Bhutan'],Politician,1886,7,83,1893
Kimberly Brooks,['Namibia'],Religious figure,1877,45,3,1922
Kellie Adams,['Montenegro'],Artist,1923,37,39,1960
Andrew Gomez,"['French Polynesia', 'Finland']",Artist,1911,16,71,1927
Sarah Knight,"['Algeria', 'Saint Helena']",Researcher,1888,21,19,1909
Lindsay Chan,['Niue'],Artist,1877,29,11,1906
Phillip Hayes,['Jordan'],Artist,1891,32,54,1923
Wayne Lee,"['Czech Republic', 'Cyprus']",Military personnel,1910,70,45,1980
Thomas Garrett,"['Bahrain', 'Malaysia']",Jurist,1884,12,57,1896
Sierra Wells,['Guam'],Researcher,1896,19,64,1915
Tommy Cunningham,['Costa Rica'],Politician,1914,49,70,1963
Diana Jordan,"['Trinidad and Tobago', 'Indonesia']",Racing automobile driver,1909,28,57,1937
Cindy Johnson,['Tuvalu'],Artist,1889,66,68,1955
Richard Moore,['Gambia'],Artist,1871,52,71,1923
Zachary Pena,['Burundi'],Researcher,1924,46,74,1970
Kathleen Smith,"['Comoros', 'Malaysia']",Athlete,1875,4,20,1879
Elizabeth Bailey,['Austria'],Artist,1919,26,82,1945
Linda Martin,"['Mongolia', 'Nicaragua']",Artist,1921,68,8,1989
Mark Cox,"['Vietnam', 'Guatemala']",Politician,1883,81,34,1964
Susan Ramos,['United Kingdom'],Athlete,1875,18,26,1893
Andrew Salazar,"['Guyana', 'New Caledonia']",Artist,1872,31,14,1903
Chris Rodgers,"['French Polynesia', 'Poland']",Artist,1899,86,30,1985
Kyle Douglas,"['Madagascar', 'Georgia']",Politician,1874,45,43,1919
Richard Allen,"['Myanmar', 'French Polynesia']",Artist,1883,64,48,1947
Carolyn Anderson,['Cameroon'],Artist,1918,8,70,1926
Brenda Fisher,['Indonesia'],Politician,1895,40,2,1935
Elizabeth Jackson,['Dominica'],Researcher,1905,61,64,1966
Stuart Garcia,"['Zambia', 'Saint Barthelemy']",Researcher,1886,38,64,1924
Tammy Luna,"['Israel', 'Germany']",Politician,1920,40,12,1960
Sonia Bailey,"['China', 'Guinea-Bissau']",Athlete,1894,24,71,1918
Ricky Harris,"['Serbia', 'Costa Rica']",Politician,1875,69,68,1944
Mr. Benjamin Wilkinson Jr.,"['Australia', 'French Southern Territories']",Military personnel,1900,62,73,1962
Hunter Anderson,"[""Lao People's Democratic Republic""]",Artist,1898,28,87,1926
Jacob Gordon,"['Burkina Faso', 'San Marino']",Artist,1897,55,69,1952
Michelle Morris,['Korea'],Artist,1877,40,81,1917
David Norton,['Slovakia (Slovak Republic)'],Artist,1909,37,72,1946
Melissa Owens,['Saint Kitts and Nevis'],Physician,1882,61,20,1943
John Cruz,"['Barbados', 'Cameroon']",Athlete,1902,29,47,1931
Amanda Davis,['Guadeloupe'],Artist,1921,73,54,1994
Stacey Anderson,['Niue'],Artist,1901,87,10,1988
Nathan Gonzalez,['Somalia'],Artist,1902,18,8,1920
Curtis Kirk,['Aruba'],Revolutionary,1876,53,19,1929
Cynthia Jackson,['Trinidad and Tobago'],Artist,1901,59,67,1960
Patrick Hamilton,['Bahamas'],Artist,1910,57,70,1967
Crystal Case,['Samoa'],Artist,1910,69,11,1979
Jamie Howard,['Maldives'],Researcher,1911,39,16,1950
Barbara Shaw,"['Falkland Islands (Malvinas)', 'Australia']",Artist,1886,55,41,1941
Carmen Hayes,"['Denmark', 'United States Minor Outlying Islands']",Athlete,1883,10,72,1893
Sandra Nelson,"['Mongolia', 'Yemen']",Businessperson,1910,1,77,1911
Roberto Perez,['Slovenia'],Fencer,1899,57,31,1956
Susan Campos,"['Niger', 'Nepal']",Athlete,1904,44,4,1948
Justin Perkins,['South Georgia and the South Sandwich Islands'],Researcher,1906,40,5,1946
Andrew Richardson,"['France', 'Russian Federation']",Researcher,1881,57,7,1938
Debra Bonilla,"['Philippines', 'India']",Artist,1899,49,85,1948
Joseph Austin,['Panama'],Researcher,1877,2,24,1879
Dr. Ruben Johnson DDS,"['Aruba', 'Brunei Darussalam']",Journalist,1877,29,32,1906
Dr. Andrew Cunningham,['Slovakia (Slovak Republic)'],Artist,1921,30,88,1951
Kevin Morales,"['Mali', 'Pitcairn Islands']",Racing automobile driver,1878,50,72,1928
Kristi Johnston,['Andorra'],Politician,1871,48,31,1919
James Hutchinson,['Afghanistan'],Researcher,1908,69,83,1977
Anthony Small,['Guatemala'],Artist,1878,66,56,1944
Michael Davis,['Liechtenstein'],Athlete,1893,29,72,1922
Theresa Fischer,['Djibouti'],Artist,1871,87,73,1958
Brandon Bishop,['Barbados'],Artist,1896,62,37,1958
Jeffrey Williams,"['Paraguay', 'Lebanon']",Politician,1909,7,31,1916
Marilyn Hebert,['Uruguay'],Artist,1878,10,64,1888
Christine Vazquez,['Malta'],Artist,1886,54,54,1940
Daniel Carter,['Georgia'],Artist,1876,60,43,1936
Justin Chang,['Cayman Islands'],Artist,1901,63,3,1964
Jeremy Lowe,['Malawi'],Artist,1912,39,68,1951
Robert Johnson,['Haiti'],Courtesan; exotic dancer; dancer; spy,1877,88,81,1965
Michael Rose,"['Oman', 'Mauritius']",Criminal,1922,48,57,1970
William Sullivan,"['United Arab Emirates', 'Swaziland']",Athlete,1907,47,10,1954
Ashley Curry,"['French Southern Territories', 'Saint Kitts and Nevis']",Artist,1918,42,65,1960
David Hall,['Tunisia'],Artist,1896,7,85,1903
Danielle Murphy,"['Guernsey', 'Kiribati']",Politician,1870,38,66,1908
Dylan Reyes,['Russian Federation'],Politician,1894,34,88,1928
Mckenzie Stevens,['Mayotte'],Artist,1899,39,0,1938
Christopher Washington,"['Algeria', 'Ireland']",Artist,1923,70,82,1993
Autumn Johnston,['Slovakia (Slovak Republic)'],Artist,1903,63,40,1966
Shawn Lyons,"['Moldova', 'Norfolk Island']",Athlete,1885,18,7,1903
Tina Miller,"['Puerto Rico', 'Afghanistan']",Artist,1921,36,17,1957
Phillip Jackson,"['Belarus', 'Gabon']",Researcher,1923,47,8,1970
Teresa Oneill,['Argentina'],Aristocrat,1920,58,46,1978
Dylan Green,"['Argentina', 'Ireland']",Politician,1892,54,16,1946
Marilyn Green MD,['Suriname'],Artist,1912,8,66,1920
Ryan Reese,"['Czech Republic', 'Turkey']",Athlete,1883,20,56,1903
Jerry Costa,"['Somalia', 'Bulgaria']",Artist,1911,79,42,1990
Lawrence Rivera,['Monaco'],Philosopher,1892,18,46,1910
Travis Wilson,"['Singapore', 'Iceland']",Aristocrat,1874,74,82,1948
Diane Carter,['Cyprus'],Religious figure,1916,70,59,1986
Stephen Johnson,['Armenia'],Artist,1899,13,85,1912
Deborah Wright,"['Dominica', 'India']",Athlete,1885,44,67,1929
Paula Mcmillan,"['French Polynesia', 'Turkmenistan']",Artist,1871,47,20,1918
Austin Jones,"['South Africa', 'France']",Cinematographer,1879,61,49,1940
Steven Price,"['Russian Federation', 'Guyana']",Artist,1921,54,26,1975
John Harrison,['Libyan Arab Jamahiriya'],Researcher,1881,19,41,1900
Carl Hanson,"['Burundi', 'Latvia']",Artist,1871,16,87,1887
James Ibarra,['Marshall Islands'],Politician,1886,52,36,1938
Jordan Morgan,['Sweden'],Artist,1901,78,26,1979
Dominique Wyatt,['Zimbabwe'],Artist,1881,60,11,1941
Timothy Nguyen,['Bangladesh'],Artist,1877,89,43,1966
Brian Johnson,"['Gambia', 'United Kingdom']",Politician,1894,53,57,1947
Stephanie Washington,['Uruguay'],Researcher,1896,81,55,1977
Elizabeth Foster,"['Marshall Islands', ""Cote d'Ivoire""]",Politician,1870,84,45,1954
Ryan Turner,"['United Kingdom', 'Togo']",Athlete,1913,3,3,1916
Jasmine Hamilton,['Spain'],Military personnel,1871,13,22,1884
Michael Wiley,"['Guadeloupe', 'Saudi Arabia']",Artist,1889,49,22,1938
Jon Gardner,['Bulgaria'],Artist,1870,40,43,1910
Kevin Pacheco,['Belgium'],Artist,1893,44,41,1937
Amber Roberson,"['Wallis and Futuna', 'Congo']",Religious figure,1898,34,7,1932
Dustin Collins,"['American Samoa', 'Liechtenstein']",Rhythmic gymnast,1920,35,25,1955
Bradley Murphy,"['Moldova', 'Faroe Islands']",Artist,1904,46,18,1950
Natalie Rich,"['Moldova', 'South Georgia and the South Sandwich Islands']",Artist,1906,55,21,1961
Brenda Larson,"['Bahrain', 'Comoros']",Athlete,1920,85,77,2005
Catherine Woodward,['Spain'],Politician,1888,60,88,1948
Patrick Vazquez,['Spain'],Politician,1883,80,0,1963
Angela Roberts,"['Jersey', 'New Caledonia']",Politician,1907,33,46,1940
Christopher Dominguez,"['Montserrat', 'Christmas Island']",Military personnel,1872,62,77,1934
Sarah Vang,['Guernsey'],Athlete,1883,47,41,1930
Linda Nixon,['Dominica'],Researcher,1884,55,56,1939
Tyler Ford,"['Iraq', 'Svalbard & Jan Mayen Islands']",Businessperson,1891,88,14,1979
Eric Morris,"['Bolivia', 'Korea']",Politician,1878,53,49,1931
Amanda Nguyen,"['Pakistan', 'Mongolia']",Artist,1875,47,0,1922
Christopher Morris,['Saint Barthelemy'],Military personnel,1881,58,10,1939
Robert Jones,"['Venezuela', 'Hong Kong']",Politician,1895,65,64,1960
Lawrence Frazier,"['Romania', 'French Polynesia']",Artist,1907,4,42,1911
Angela Jones,['Israel'],Politician,1885,63,76,1948
Cindy Franklin,"['United States Virgin Islands', 'Tanzania']",Researcher,1888,11,7,1899
Mrs. Sara Davis,"['Bhutan', 'Slovenia']",Researcher,1880,4,19,1884
Mr. Mark Young,"['Zimbabwe', 'Ireland']",Artist,1881,71,66,1952
Valerie Dominguez,"['Hungary', 'Qatar']",Artist,1892,77,78,1969
Frank Carson,['Senegal'],Formula one driver,1915,54,54,1969
Zachary Collins,['Norway'],Amateur wrestler,1903,67,31,1970
Michelle Kelly,['South Georgia and the South Sandwich Islands'],Athlete,1871,67,20,1938
Adrienne Cruz,['Senegal'],Politician,1873,60,2,1933
Lisa Miller,['Venezuela'],Artist,1904,45,51,1949
Valerie Davis,"['Palestinian Territory', 'Macao']",Artist,1918,9,10,1927
Jasmine White,['Burundi'],Politician,1905,64,16,1969
Richard Koch,"['Tanzania', 'Falkland Islands (Malvinas)']",Politician,1897,39,17,1936
Yvonne Robinson,"['Norway', 'Tunisia']",Artist,1889,48,58,1937
Erica Johnson,"['Israel', 'New Caledonia']",Artist,1921,21,2,1942
Gregory Hall,['Philippines'],Engineer,1886,9,18,1895
Gary Lewis,['Tokelau'],Military personnel,1918,63,1,1981
Mary Walker,"['Afghanistan', 'British Virgin Islands']",Artist,1886,24,66,1910
David Turner,['Guinea'],Artist,1887,19,40,1906
Jacqueline Smith,"['Thailand', 'Egypt']",Artist,1908,73,85,1981
Daniel Clayton,"['Guernsey', 'Malaysia']",Presbyter,1876,34,83,1910
Samantha Miller,['Lithuania'],Athlete,1883,73,47,1956
Jeffrey Garcia,['South Georgia and the South Sandwich Islands'],Religious figure,1919,12,41,1931
Tyler Mejia,['Guyana'],Athlete,1911,6,11,1917
Christopher Reed,"['Western Sahara', 'Niue']",Researcher,1908,3,20,1911
Karen Allison,"['Equatorial Guinea', 'Antigua and Barbuda']",Flight attendant; nurse,1914,67,68,1981
Oscar Hill,"['Central African Republic', 'Tunisia']",Victim,1899,17,9,1916
Cody Perez,['Georgia'],Politician,1913,80,5,1993
Kristin Brown,['Guernsey'],Artist,1875,40,10,1915
John Holmes,"['South Africa', 'Ireland']",Artist,1899,18,88,1917
Jeremy Hill,"['Mauritius', 'Saint Helena']",Artist,1870,75,52,1945
Calvin Martinez,['Cape Verde'],Athlete,1897,36,27,1933
Lisa Martinez,['Nicaragua'],Politician,1920,17,35,1937
Brian Thompson,"['Monaco', 'Pakistan']",Artist,1917,22,83,1939
Kimberly Decker,"['Puerto Rico', 'Falkland Islands (Malvinas)']",Politician,1877,60,10,1937
Peter Lopez,"['Russian Federation', 'Saint Kitts and Nevis']",Politician,1896,22,86,1918
George Burke,"['Antarctica (the territory South of 60 deg S)', 'Ecuador']",Statesperson,1887,33,33,1920
Richard Brown,"['Portugal', 'Lithuania']",Criminal; street vendor,1883,75,61,1958
Danny Ruiz,['Eritrea'],Artist,1916,65,21,1981
Margaret Vazquez,"['New Caledonia', 'Singapore']",Artist,1876,42,67,1918
Kelly Rice,['Zambia'],Artist,1879,41,2,1920
Carol Esparza,"['Burundi', 'Japan']",Artist,1877,48,62,1925
Brittany Rasmussen,"['Burundi', 'Tunisia']",Artist,1908,53,52,1961
Tara Harrison,"['Haiti', 'Svalbard & Jan Mayen Islands']",Artist,1875,5,59,1880
Monica Walker,['Saint Martin'],Artist,1887,57,29,1944
Charles Cross,"['Ghana', 'Austria']",Politician,1897,80,68,1977
Philip Pruitt,['Mali'],Artist,1876,60,47,1936
Scott Solomon,"['Ghana', 'Guinea-Bissau']",Artist,1889,4,6,1893
Heather Morris,"['Costa Rica', 'United States of America']",Serial killer,1889,11,42,1900
Mrs. Amanda Valdez,"['India', 'Cyprus']",Architect,1921,87,31,2008
Christine Jones,['Montserrat'],Politician,1910,87,72,1997
Jennifer Wright,['Malta'],Artist,1891,88,42,1979
Zachary Murphy,['Italy'],Researcher,1878,28,25,1906
Aaron Harvey,['Sao Tome and Principe'],Religious leader,1878,0,37,1878
Wendy Anderson,"['Congo', 'Central African Republic']",Artist,1884,35,14,1919
Brian Mcguire,['Paraguay'],Athlete,1911,62,6,1973
James Smith,['Italy'],Artist,1923,6,63,1929
Connie Harrison,"['United Arab Emirates', 'Cocos (Keeling) Islands']",Conductor; music director; theater director,1886,37,23,1923
Vincent Espinoza,"['Saint Kitts and Nevis', 'Singapore']",Artist,1885,24,52,1909
Desiree Flores,"['Kazakhstan', 'Moldova']",Artist,1896,88,7,1984
Anthony Griffin,['American Samoa'],Artist,1906,38,42,1944
Mary Quinn,['United States Virgin Islands'],Researcher,1918,50,75,1968
Matthew Butler,"['Angola', 'Colombia']",Politician,1914,9,85,1923
Chad Silva,['Albania'],Artist,1885,16,77,1901
Amanda Ross,"['Iceland', 'Cambodia']",Artist,1870,60,38,1930
Abigail Gonzalez,['Nauru'],Politician,1908,8,25,1916
Vincent Wilkinson,['Palestinian Territory'],Artist,1896,58,31,1954
Elizabeth Diaz,['Azerbaijan'],Artist,1871,42,27,1913
Rhonda Ho,['New Zealand'],Artist,1888,65,10,1953
Elizabeth Torres,"['Palau', 'Bermuda']",Athlete,1912,22,32,1934
Logan Johnson,"['Swaziland', 'Bolivia']",Cellist,1884,77,13,1961
Lisa Wright,['Equatorial Guinea'],Artist,1920,20,72,1940
Elizabeth Beasley,"['Bolivia', 'Kazakhstan']",Researcher,1881,29,83,1910
Karen Thompson,['Latvia'],Politician,1901,62,85,1963
Ashlee Duran,"['Solomon Islands', 'Fiji']",Politician,1894,62,20,1956
John Smith,['Uganda'],Politician,1886,82,11,1968
Derrick Santiago,"['Honduras', 'Solomon Islands']",Researcher,1901,70,76,1971
Jenna Benitez,"['Montenegro', 'Poland']",Prostitute,1911,73,6,1984
Joseph Williamson,['Mauritania'],Artist,1904,81,58,1985
Sara Levy,"['Norfolk Island', 'Mauritius']",Researcher,1909,75,40,1984
Jordan Williams,"['Serbia', 'Saint Barthelemy']",Businessperson,1899,51,73,1950
Andrea Williams,"['Bangladesh', 'Isle of Man']",Researcher,1885,65,11,1950
Richard Johnson,['Poland'],Politician,1886,25,3,1911
Nicole Martinez,['South Africa'],Artist,1884,48,24,1932
Scott Rodriguez,['Holy See (Vatican City State)'],Researcher,1891,68,16,1959
Kevin Burton,"['Algeria', 'Mozambique']",Artist,1898,64,60,1962
Daniel Harvey,['New Caledonia'],Researcher,1870,2,61,1872
Brandon Munoz,"['British Virgin Islands', 'Indonesia']",Athlete,1918,54,58,1972
Robert Williams,"['Kazakhstan', 'Palau']",Artist,1875,51,77,1926
Amanda Taylor DDS,"['Hong Kong', 'Dominica']",Artist,1879,25,78,1904
Erin Quinn,"['Saint Barthelemy', 'Belarus']",Artist,1907,71,14,1978
Jeremiah Griffin,"['Saint Barthelemy', 'Azerbaijan']",Teacher,1895,27,24,1922
Brian Brown,"['Madagascar', 'Anguilla']",Politician,1896,7,40,1903
Samantha Booth,['Congo'],Military personnel,1895,44,16,1939
Melissa Gray,['Christmas Island'],Researcher,1883,27,2,1910
Jared Thomas,"['Algeria', 'New Zealand']",Politician,1878,20,46,1898
Lindsey Hughes,['Poland'],Athlete,1877,22,35,1899
Holly Pittman,"['El Salvador', 'Gambia']",Publisher,1887,86,23,1973
Jennifer Dyer,['Ghana'],Artist,1908,55,12,1963
Adam Tucker,['Korea'],Artist,1871,37,88,1908
Rose Jones,"['Spain', 'South Africa']",Artist,1915,26,55,1941
Tina Hernandez,"['Armenia', 'Taiwan']",Artist,1909,88,26,1997
Tammy Mitchell,"['Qatar', 'Tajikistan']",Politician,1902,58,38,1960
Abigail Bush,['Colombia'],Politician,1887,31,81,1918
Tyrone Williams,"['Madagascar', 'Netherlands']",Researcher,1888,40,88,1928
James Lewis,['Botswana'],Artist,1880,25,52,1905
Jay Frederick,['Norfolk Island'],Politician,1916,88,85,2004
Kayla Archer,"['Norfolk Island', 'Malta']",Military personnel,1890,39,23,1929
Gregory Dennis,['Croatia'],Artist,1886,29,21,1915
Brianna Webster,['Marshall Islands'],Artist,1899,59,60,1958
Alisha Nguyen,"['Palau', ""Cote d'Ivoire""]",Politician,1899,65,8,1964
Lynn Casey,"['Equatorial Guinea', 'Switzerland']",Politician,1886,63,31,1949
Scott Guzman,['Falkland Islands (Malvinas)'],Military personnel,1909,81,47,1990
Nancy Davis,"['Chad', 'Kuwait']",Entrepreneur,1895,22,56,1917
Brett Turner,"['Afghanistan', 'Philippines']",Artist,1917,55,36,1972
Gina Nelson,"['Cameroon', 'Argentina']",Researcher,1872,70,24,1942
Jennifer Hanson,"['Afghanistan', 'Senegal']",Politician,1906,5,36,1911
Kimberly Alvarado,"['Wallis and Futuna', 'Swaziland']",Artist,1894,48,73,1942
Brittany Baker,"['Morocco', 'Philippines']",Artist,1889,36,36,1925
Ashley Hurst,"['Azerbaijan', 'Guadeloupe']",Artist,1913,69,19,1982
Dawn Lewis,['Australia'],Artist,1875,68,88,1943
Michael Paul Jr.,['Tanzania'],Politician,1912,24,36,1936
Kristen Moore,['Liberia'],Researcher,1901,14,68,1915
Mary Brown,"['Slovakia (Slovak Republic)', 'French Guiana']",Artist,1878,48,26,1926
Jennifer Perry,"['Saint Lucia', 'Bermuda']",Teacher,1900,56,49,1956
Teresa Lopez,['Qatar'],Researcher,1894,36,34,1930
Megan Hall,"['Algeria', 'Tajikistan']",Politician,1886,63,17,1949
Nicholas Cooper,"['Kiribati', 'Iceland']",Researcher,1881,84,7,1965
Dr. Carlos Meyers,"['Senegal', 'French Polynesia']",Politician,1890,9,55,1899
Amanda Kim,"['Serbia', 'Romania']",Artist,1871,71,79,1942
Devin Lang,['Egypt'],Artist,1902,79,86,1981
Tyrone Lucas,['Croatia'],Teacher,1905,54,73,1959
Melinda Smith,"['Canada', 'Guam']",Artist,1874,30,22,1904
Karen Ortega,"['Latvia', 'Namibia']",Artist,1902,83,2,1985
Gary Moore,"['Guam', 'Benin']",Artist,1908,51,76,1959
Jennifer Anderson,['Belize'],Artist,1922,37,28,1959
Tanya Mayo,['Togo'],Athlete,1905,65,77,1970
Michelle Rodriguez,['China'],Athlete,1890,4,34,1894
Nicole Mitchell,"['India', 'Syrian Arab Republic']",Explorer,1920,35,27,1955
Sandra Frazier,"['Jordan', 'Tunisia']",Athlete,1873,44,35,1917
Kathleen Joseph,"['Burkina Faso', 'Togo']",Criminal,1898,41,0,1939
Caitlin Stewart,"['United Arab Emirates', 'Cuba']",Politician,1913,39,69,1952
Jessica Atkins,['Ethiopia'],Artist,1902,68,83,1970
Jenna Mckay,['Macao'],Artist,1915,29,29,1944
Shawn Phillips,['Turks and Caicos Islands'],Researcher,1922,85,56,2007
Miranda Stevenson,"['Saint Barthelemy', 'Zimbabwe']",Politician,1920,2,77,1922
Mark Bennett,['Puerto Rico'],Artist,1885,7,54,1892
Sarah Davis,['Tokelau'],Artist,1891,40,69,1931
Kathryn Smith,"['Turkmenistan', 'Algeria']",Artist,1914,78,73,1992
Rachel Garcia,"['Zambia', 'Afghanistan']",Artist,1881,61,85,1942
Candice Martinez,['Uzbekistan'],Artist,1901,15,8,1916
Elizabeth Huynh,"['Venezuela', 'Samoa']",Politician,1896,77,0,1973
Francisco Martin,['Cambodia'],Artist,1906,53,30,1959
Nicole Patel,"['Togo', 'Tuvalu']",Artist,1878,42,75,1920
Steven Finley,['Finland'],Artist,1916,9,14,1925
Dawn Jones,['New Caledonia'],Artist,1901,5,56,1906
William Allen,"['Zimbabwe', 'Tunisia']",Aristocrat,1907,11,11,1918
Kevin Roth,['Czech Republic'],Athlete,1894,86,44,1980
Gina Eaton,['Wallis and Futuna'],Artist,1903,68,38,1971
Sylvia Bennett,"['Singapore', 'Israel']",Politician,1891,64,7,1955
Terry Harris,['Nauru'],Artist,1890,56,80,1946
Deanna Freeman,['Armenia'],Politician,1894,33,44,1927
Steven White,"['Poland', 'Malawi']",Politician,1908,15,79,1923
Sheryl Mendoza,"['Iraq', 'Samoa']",Researcher,1888,17,19,1905
Robert Neal,['Central African Republic'],Artist,1923,33,6,1956
Evelyn Mason,"['Niue', 'Hungary']",Artist,1871,23,84,1894
Ian Romero,"['Western Sahara', 'Armenia']",Businessperson,1890,71,86,1961
Daniel Lozano,['Iceland'],Artist,1903,42,49,1945
Jonathan Reyes,"['Vietnam', 'Azerbaijan']",Imam,1881,86,9,1967
William Little,"['Ireland', 'Portugal']",Artist,1919,45,52,1964
Alicia Mcguire,"['Montserrat', 'Croatia']",Artist,1907,3,32,1910
Jeremy Carr,"['Greece', 'Fiji']",Artist,1902,84,43,1986
Melissa Davis,"['Turks and Caicos Islands', 'Tonga']",Artist,1891,11,16,1902
Marc Horton,"['Botswana', 'Botswana']",Artist,1907,60,85,1967
Thomas Burgess,['Eritrea'],Model,1884,17,69,1901
Jocelyn Johnson,"['Bosnia and Herzegovina', 'Costa Rica']",Politician,1891,54,73,1945
Zachary Jones,['Niger'],Military personnel,1870,64,10,1934
Carol Rodriguez,['Palau'],Artist,1920,85,17,2005
Jeffrey Vasquez,"['Marshall Islands', 'Mauritania']",Artist,1920,74,82,1994
Jessica Vance,"['Algeria', 'Qatar']",Politician,1920,43,47,1963
Richard Williams,['Philippines'],Athlete,1884,28,22,1912
Robert Smith,"['Ecuador', 'Equatorial Guinea']",Engineer,1914,7,23,1921
John Watts,"['Algeria', 'Tuvalu']",Researcher,1876,55,13,1931
Karen Joseph,['Cocos (Keeling) Islands'],Artist,1906,37,48,1943
Amanda Butler,['Zimbabwe'],Researcher,1875,14,17,1889
Tina Reynolds,['Saint Vincent and the Grenadines'],Military personnel,1903,42,30,1945
Blake Snyder,"['Nepal', 'Equatorial Guinea']",Artist,1905,74,26,1979
Sarah Cooke,"['Chad', 'Guernsey']",Military personnel,1889,81,32,1970
Lisa Myers,"['American Samoa', 'Russian Federation']",Researcher,1919,65,66,1984
Mark Hall Jr.,['Rwanda'],Artist,1923,58,12,1981
Joel Zavala,['Morocco'],Athlete,1917,60,81,1977
Kelly Lynch,"['Sudan', 'Niue']",Artist,1889,8,82,1897
Brian Morales,['Burundi'],Politician,1897,30,5,1927
Nancy Johnson,"['Tonga', 'Antarctica (the territory South of 60 deg S)']",Athlete,1871,79,5,1950
Mark Matthews,"['Singapore', 'Bouvet Island (Bouvetoya)']",Athlete,1922,36,63,1958
Kevin Mason DDS,"['Cambodia', 'Portugal']",Artist,1898,78,34,1976
Crystal Lowery,['Estonia'],Physician,1894,28,38,1922
Rhonda Lopez,"['Lesotho', 'Kuwait']",Artist,1919,76,75,1995
Amanda Spence,['Syrian Arab Republic'],Artist,1876,4,67,1880
Mr. Jason Richards,"['Bouvet Island (Bouvetoya)', 'Dominican Republic']",Artist,1883,88,89,1971
Joseph Terry,['Nauru'],Artist,1917,83,55,2000
Alicia Black,['Korea'],Artist,1870,80,4,1950
Stephanie Henderson,"['Kuwait', 'Dominican Republic']",Military personnel,1917,27,86,1944
Amanda Gibbs,"['Tanzania', 'Costa Rica']",Artist,1921,35,11,1956
John Jones,"['Wallis and Futuna', 'Ethiopia']",Athlete,1875,62,73,1937
Cassandra Morales,['Egypt'],Politician,1891,23,24,1914
Michael Wright,['Ireland'],Artist,1923,75,12,1998
Kyle Johnson,"['New Caledonia', 'Switzerland']",Artist,1906,10,56,1916
Timothy Pollard,"['Netherlands', 'Bhutan']",Artist,1872,31,15,1903
Antonio Wong,"['Paraguay', 'South Africa']",Monarch,1871,15,59,1886
Jordan Williams,"['Guernsey', 'North Macedonia']",Artist,1879,27,61,1906
Daniel Smith,"['Cameroon', 'Andorra']",Athlete,1902,39,21,1941
Bobby Cannon,['Holy See (Vatican City State)'],Politician,1900,1,20,1901
Catherine Owen,"['Samoa', 'Sudan']",Artist,1899,40,43,1939
Jennifer Thomas,['Guatemala'],Artist,1877,4,33,1881
William Fuller,"['Malawi', 'Croatia']",Researcher,1893,83,22,1976
Matthew Simpson,['Ukraine'],Athlete,1888,47,9,1935
Mary Larson,"['Afghanistan', 'Nicaragua']",Student,1875,20,83,1895
Seth Allen,"['French Polynesia', 'Timor-Leste']",Artist,1882,5,45,1887
Annette Everett,['Bahamas'],Racing automobile driver; formula one driver,1900,59,83,1959
Nicole Moreno,['Cameroon'],Researcher,1870,58,41,1928
Rebecca Hill,"['Brunei Darussalam', 'Suriname']",Artist,1924,84,19,2008
Brian Mccormick,['French Polynesia'],Teacher,1920,59,20,1979
Kyle Leonard,"['Nicaragua', 'Equatorial Guinea']",Researcher,1889,42,13,1931
Andrea Johnson,['Uruguay'],Artist,1879,51,41,1930
April Rivers,"['Iceland', 'Jordan']",Artist,1901,59,63,1960
Sarah Fleming,['Myanmar'],Military personnel,1901,22,11,1923
Adam Jones,['San Marino'],Politician,1875,74,66,1949
James Edwards,['Mali'],Artist,1895,80,59,1975
John Wang,['Denmark'],Artist,1886,16,47,1902
Brent Hill,['Jamaica'],Artist,1896,88,78,1984
Kristin Horton,['Timor-Leste'],Artist,1886,45,41,1931
Peter Stewart,['Eritrea'],Artist,1900,12,5,1912
Lynn Whitaker,['Belize'],Artist,1911,19,47,1930
Blake Walker,['Vanuatu'],Athlete,1923,34,82,1957
Jennifer Daniels,['Tunisia'],Artist,1885,64,34,1949
Shannon Palmer,"['Spain', 'Myanmar']",Artist,1905,73,41,1978
Edward Lee,['Australia'],Artist,1901,29,13,1930
Andrew Oliver,"['Norway', 'Zimbabwe']",Engineer,1898,23,76,1921
Tiffany Elliott,['Russian Federation'],Religious figure,1900,8,13,1908
David Rivera,['Kenya'],Athlete,1898,81,59,1979
Edwin Lucas,"['Netherlands Antilles', 'Denmark']",Artist,1908,48,79,1956
Ashley Hansen,['Malta'],Fashion designer,1871,32,81,1903
Stanley Rubio,"['Qatar', 'Madagascar']",Politician,1887,11,71,1898
Michael Owens,['Korea'],Artist,1909,13,0,1922
Laura Haley,['Kuwait'],Athlete,1909,84,36,1993
Michael Williams,"['Nicaragua', 'Turks and Caicos Islands']",Athlete,1915,22,22,1937
Lauren Orozco,['Comoros'],Politician,1916,78,80,1994
Andrew Schultz,"['Peru', 'Antarctica (the territory South of 60 deg S)']",Artist,1923,81,69,2004
Jonathan Blake,"['United Arab Emirates', 'Guadeloupe']",Politician,1920,53,58,1973
Scott Smith,['Bouvet Island (Bouvetoya)'],Aristocrat,1878,64,80,1942
Anthony Frederick,['Western Sahara'],Serial killer,1916,2,52,1918
Michael Flowers,['Saint Vincent and the Grenadines'],Artist,1897,65,64,1962
David Estrada,['Egypt'],Artist,1896,13,56,1909
Yolanda Torres,['Iraq'],Artist,1887,59,54,1946
Mary Hall,"['Faroe Islands', 'Romania']",Artist,1913,33,7,1946
Andrew Harris,['Saudi Arabia'],Cardiologist,1874,76,26,1950
Timothy Jennings,['Reunion'],Politician,1901,19,23,1920
Caleb Hartman,"['Congo', 'Kiribati']",Artist,1874,33,51,1907
Hannah Munoz,"['Bangladesh', 'Lithuania']",Businessperson,1873,20,77,1893
Thomas Roberts,"['Djibouti', 'Eritrea']",Artist,1895,24,37,1919
Teresa Rosales,"['Iran', 'Qatar']",Artist,1897,21,62,1918
Brenda Myers,"['Suriname', 'Korea']",Politician,1875,53,82,1928
Curtis Chandler,"['Faroe Islands', 'Honduras']",Artist,1916,86,61,2002
Robert Hensley,['Djibouti'],Artist,1910,49,35,1959
Pamela Dennis,"['Norway', 'Syrian Arab Republic']",Researcher,1885,52,88,1937
Matthew Pitts,['Brunei Darussalam'],Artist,1889,4,19,1893
Natasha Adkins,['Norway'],Researcher,1885,11,33,1896
Mary Walker,"['Serbia', 'Christmas Island']",Religious figure,1879,89,27,1968
Renee Meyer,"['Bangladesh', 'Malaysia']",Artist,1909,45,42,1954
Terri Bennett,"['Colombia', 'Jamaica']",Police officer,1916,29,83,1945
Jason Hammond,"['Netherlands', 'Malta']",Artist,1885,2,73,1887
Dr. Shane Mercado,"['Isle of Man', 'Lesotho']",Parson,1903,39,12,1942
Henry Hall,"['Mozambique', 'Kyrgyz Republic']",Researcher,1914,76,7,1990
Michael Farley,"['Comoros', 'Eritrea']",Politician,1898,18,51,1916
Brian Obrien,"['Mayotte', 'Comoros']",Designer,1876,6,11,1882
William Sims,['Andorra'],Businessperson,1875,21,38,1896
Jay Farley,"['Anguilla', 'Russian Federation']",Artist,1923,9,4,1932
Tracy Fischer,"['Armenia', 'North Macedonia']",Artist,1892,54,80,1946
Eric Cook,['Cyprus'],Politician,1876,89,82,1965
Jason Massey,"['Honduras', 'Kiribati']",Astrologer; surgeon,1906,62,8,1968
Thomas Hunter,"['Denmark', 'Martinique']",Artist,1923,5,47,1928
Ms. Mary Ward,['Greece'],Athlete,1909,70,6,1979
Janice Little,['Malawi'],Artist,1879,57,78,1936
Lauren Watkins,"['Portugal', 'Heard Island and McDonald Islands']",Athlete,1889,61,83,1950
Gregory Hill,['Montenegro'],Artist,1897,19,53,1916
Scott Malone,['Sri Lanka'],Athlete,1886,9,22,1895
Kathleen Barker,"['Malawi', 'Ghana']",Politician,1875,22,58,1897
Melissa Haynes,"['Ireland', 'Somalia']",Artist,1922,40,22,1962
Kenneth Hayes,"['Sweden', 'Ethiopia']",Publisher,1896,11,18,1907
Steven Delgado,['Mozambique'],Artist,1882,89,76,1971
Tammy Fitzgerald,"['Burundi', 'Thailand']",Politician,1872,15,86,1887
Henry Greene,['Italy'],Athlete,1876,10,83,1886
Raymond Obrien,"['Puerto Rico', 'Bahamas']",Prosecutor,1905,57,88,1962
Jordan Schmidt,['Trinidad and Tobago'],Artist,1885,89,33,1974
Bruce Garcia,"['Botswana', 'Israel']",Artist,1900,66,53,1966
Amanda Smith,['Thailand'],Artist,1884,16,88,1900
Mandy Wang,['Zimbabwe'],Engineer,1891,32,70,1923
Terry Beard,"['Thailand', 'Martinique']",Criminal,1908,9,24,1917
Sherri Rodriguez,['Sudan'],Artist,1875,57,34,1932
Brianna Martinez,"['Saint Barthelemy', 'Dominica']",Artist,1910,17,12,1927
Tracey Johnson,"['Cocos (Keeling) Islands', 'Zambia']",Artist,1901,63,33,1964
Patrick Oliver,"['Bouvet Island (Bouvetoya)', 'Cape Verde']",Artist,1873,74,54,1947
Norma Parker,['Netherlands'],Politician,1899,63,88,1962
Caroline Smith,['Croatia'],Artist,1871,70,89,1941
Hannah Norman,['Burundi'],Artist,1878,33,1,1911
Christina Bennett,['Spain'],Entrepreneur,1882,75,6,1957
Natalie Murphy,"['Equatorial Guinea', 'Romania']",Artist,1900,81,56,1981
Mary Thompson,['Afghanistan'],Businessperson,1888,38,57,1926
Theodore Bauer,"['Tajikistan', 'Palestinian Territory']",Artist,1915,88,29,2003
Stephanie Sanchez,"['Brazil', 'Netherlands Antilles']",Athlete,1897,43,11,1940
Christopher Daniels,['Germany'],Politician,1874,74,27,1948
Kimberly Johnson,"['Yemen', 'United States Virgin Islands']",Politician,1898,45,73,1943
Jordan Campbell,"['Cuba', 'New Caledonia']",Artist,1891,25,30,1916
Gregory Obrien,"['Puerto Rico', 'Micronesia']",Artist,1917,37,41,1954
Brandon Watkins,['Greece'],Fashion designer; personal stylist; designer,1883,84,20,1967
Reginald Davis,"['Gambia', 'Cocos (Keeling) Islands']",Artist,1888,26,7,1914
Kevin Walker,['Netherlands'],Politician,1911,74,26,1985
David Webb,['Colombia'],Politician,1919,70,2,1989
Jennifer Wallace,['Trinidad and Tobago'],Artist,1908,7,50,1915
Katherine Lambert,['Taiwan'],Artist,1901,60,58,1961
Charlotte Jones,"['Japan', 'Chad']",Athlete,1901,57,49,1958
Joseph Campbell,['Guinea-Bissau'],Politician,1908,8,70,1916
Megan Paul,"['Montserrat', 'Antarctica (the territory South of 60 deg S)']",Athlete,1920,62,37,1982
Veronica Hansen,"['Grenada', 'Marshall Islands']",Artist,1916,19,31,1935
Kristina Miller,['Switzerland'],Researcher,1886,13,25,1899
Yolanda Solis,"['Namibia', 'Nicaragua']",Judoka,1923,17,11,1940
Kristine Higgins,"['Cook Islands', 'Bahrain']",Fashion designer,1882,31,11,1913
Matthew Lopez,['Philippines'],Artist,1924,13,28,1937
Julie Rogers,"['British Virgin Islands', 'Norfolk Island']",Researcher,1906,5,84,1911
John Wilson,"['Bangladesh', 'Egypt']",Artist,1894,77,66,1971
Jessica Harper,['Congo'],Artist,1888,33,84,1921
Cathy Webster,['Mayotte'],Politician,1903,34,23,1937
Ryan Wright,"['Ireland', 'South Africa']",Politician,1896,54,65,1950
James Garner,"['Peru', 'Andorra']",Artist,1910,77,25,1987
Luis Bender,['United Kingdom'],Politician,1919,1,6,1920
Jessica Graves,"['French Polynesia', 'South Africa']",Artist,1915,31,49,1946
Ashley Best,['Brunei Darussalam'],Artist,1887,64,45,1951
Linda Rogers,['Slovakia (Slovak Republic)'],Politician,1878,24,10,1902
Emily Mcbride,"['China', 'Indonesia']",Artist,1896,66,88,1962
Daniel Spencer,['Djibouti'],Immunologist,1891,8,21,1899
Douglas Williams,"['Holy See (Vatican City State)', 'Turks and Caicos Islands']",Artist,1904,65,81,1969
Sandra Cole,['Tanzania'],Researcher,1875,42,9,1917
Richard Hansen,"['Romania', 'Barbados']",Artist,1895,70,31,1965
Colleen Moore,['Dominica'],Researcher,1892,30,5,1922
Carmen Mata,"['Mongolia', 'Malta']",Researcher,1923,12,15,1935
Antonio Williams,['Samoa'],Artist,1871,40,0,1911
Curtis Sanchez,"['Equatorial Guinea', 'Benin']",Artist,1891,86,76,1977
Lindsay Harris,['Hong Kong'],Artist,1908,60,75,1968
April Stewart,['Swaziland'],Criminal,1888,33,49,1921
Dr. David Bell,['Guatemala'],Artist,1908,54,33,1962
Laura Owens,['Antigua and Barbuda'],Athlete,1889,61,17,1950
Paul Rivas,"['British Virgin Islands', 'Turkey']",Artist,1901,82,45,1983
Jenna Hartman,['Singapore'],Artist,1879,50,51,1929
Danielle Briggs,['Palau'],Athlete,1870,51,76,1921
Mary Shea,"['Antarctica (the territory South of 60 deg S)', 'Saint Barthelemy']",Racing automobile driver,1909,38,5,1947
Michael Lopez,"['Hong Kong', 'Bhutan']",Researcher,1896,55,1,1951
Amanda Mcdonald,"['Falkland Islands (Malvinas)', 'San Marino']",Artist,1877,85,47,1962
Todd Vaughn,"['Niue', 'Malaysia']",Artist,1889,6,28,1895
Mr. James Miller,['Dominica'],Military personnel,1880,76,57,1956
Tyler Gray,['Myanmar'],Artist,1902,37,72,1939
Robert Edwards,"['Angola', 'Lebanon']",Politician,1905,8,78,1913
Aaron Murphy,['Fiji'],Religious figure,1915,71,61,1986
Nicole Foster,"['Angola', 'Mexico']",Artist,1888,35,77,1923
Melissa Davis,"['Taiwan', 'Somalia']",Artist,1911,22,5,1933
Theresa Copeland,"[""Cote d'Ivoire""]",Politician,1920,34,13,1954
Melissa Stewart,"['Syrian Arab Republic', 'United States of America']",Journalist,1918,13,53,1931
Brandon Singh,['Nicaragua'],Politician,1896,28,62,1924
Samantha Mercer,['Indonesia'],Artist,1889,3,6,1892
Cassandra Coleman,['Slovakia (Slovak Republic)'],Artist,1906,5,56,1911
Katelyn Ramsey MD,"['British Indian Ocean Territory (Chagos Archipelago)', 'Indonesia']",Teacher,1902,2,71,1904
Roger Howe,['Mongolia'],Politician,1916,36,68,1952
Kristy Moore,['Gabon'],Psychologist; psychoanalyst; existential therapist,1921,34,76,1955
Lee Sanchez,"['Pakistan', 'Pakistan']",Researcher,1897,82,13,1979
Edward Hunter,['Zambia'],Artist,1910,19,14,1929
Michael Costa,['American Samoa'],Artist,1918,9,73,1927
Reginald Keller,"['Palau', 'Guatemala']",Artist,1902,85,21,1987
Rachel Thompson,"['Serbia', 'Cape Verde']",Amateur wrestler,1901,52,13,1953
Francisco Reynolds,['Grenada'],Politician,1902,79,47,1981
Melissa Roman,"['French Guiana', 'Hong Kong']",Politician,1906,26,56,1932
Nathaniel Lucas,['French Southern Territories'],Politician,1891,30,73,1921
Dominique Kelley,['Cambodia'],Researcher,1897,45,23,1942
Molly Turner,['Tunisia'],Artist,1908,33,42,1941
Jordan Flowers,['Sweden'],Politician,1910,13,11,1923
Carrie Grimes,"['Netherlands Antilles', 'Nauru']",Artist,1888,18,21,1906
Mark Thompson,['Grenada'],Artist,1902,5,38,1907
James Miller,['Lesotho'],Artist,1918,86,10,2004
Courtney King,"['Brunei Darussalam', 'Antigua and Barbuda']",Artist,1912,1,28,1913
Joshua Mason,['Palau'],Artist,1909,78,25,1987
Bruce Weiss,"['Italy', 'Mozambique']",Politician,1885,47,20,1932
Rebecca West MD,"['Hong Kong', 'Papua New Guinea']",Astronomer,1881,3,42,1884
Felicia Fernandez,"['Uzbekistan', 'Colombia']",Artist,1908,35,41,1943
Donald Brown,"['Namibia', 'Luxembourg']",Artist,1870,89,61,1959
Lisa Castro,['Reunion'],Artist,1883,2,71,1885
Carol Roberts,"['Slovenia', 'Turkmenistan']",Researcher,1881,11,4,1892
Tyler Davis,"['Swaziland', 'Antarctica (the territory South of 60 deg S)']",Religious figure,1880,33,69,1913
James Mendez,['Uganda'],Artist,1894,32,89,1926
Lisa Shields,"['Falkland Islands (Malvinas)', 'Cuba']",Artist,1906,75,88,1981
William Lee MD,['Angola'],Politician,1890,81,50,1971
Paul Harris,['Ghana'],Politician,1891,36,27,1927
Bonnie Morgan,['Luxembourg'],Politician,1870,23,77,1893
Stacey Taylor,['Malawi'],Chamberlain,1889,37,19,1926
Chad Case,['Libyan Arab Jamahiriya'],Physician,1886,58,40,1944
Catherine Perry,"['Bangladesh', 'Norway']",Artist,1912,74,34,1986
Robin Ramos,['Iceland'],Artist,1885,71,82,1956
Julia Green,"['Egypt', 'Malaysia']",Artist,1876,85,40,1961
William Mendez,"['Finland', 'Marshall Islands']",Artist,1907,47,1,1954
Wendy Snyder,"['Jersey', 'Trinidad and Tobago']",Military personnel,1879,55,74,1934
Melissa Dougherty,"['Mozambique', 'Saint Barthelemy']",Artist,1890,69,65,1959
James Robinson,['Equatorial Guinea'],Researcher,1871,75,61,1946
Nancy Moore,['Equatorial Guinea'],Artist,1916,82,4,1998
Leroy Campbell,"['Kazakhstan', 'Nigeria']",Artist,1886,15,4,1901
Angela Schultz,['Mali'],Artist,1897,68,21,1965
Isabel Guzman,['Pitcairn Islands'],Athlete,1889,55,12,1944
Erica Vang,"['Croatia', 'Wallis and Futuna']",Artist,1890,24,43,1914
Cynthia Manning,['Ukraine'],Artist,1883,29,73,1912
Susan Bailey,['Italy'],Nurse,1872,40,52,1912
Courtney Adams,"['Seychelles', 'Togo']",Military personnel,1902,59,3,1961
Matthew Stewart,['Seychelles'],Athlete,1909,5,36,1914
Mr. Alan Soto,"['Cocos (Keeling) Islands', 'Tunisia']",Artist,1901,57,20,1958
Michael Keller,"['Tunisia', 'Mozambique']",Researcher,1892,4,30,1896
Kelsey Bryan,"['United Kingdom', 'Cape Verde']",Artist,1898,24,82,1922
Ashley Allen,"['Aruba', 'Andorra']",Politician,1920,83,67,2003
Emily Johnson,['Central African Republic'],Researcher,1917,34,82,1951
Riley Dunlap,['Zimbabwe'],Rabbi,1888,66,71,1954
Leah Johnson,"['Isle of Man', 'Croatia']",Artist,1914,10,6,1924
Ariana Downs,"['Somalia', 'Christmas Island']",Artist,1905,43,22,1948
Michael Hobbs,['Comoros'],Politician,1890,73,18,1963
Aaron Arellano,"['Djibouti', 'Jamaica']",Artist,1893,87,8,1980
Dylan Jackson,['United States Virgin Islands'],Politician,1904,53,4,1957
Victor Green,"['Albania', 'North Macedonia']",Politician,1885,36,15,1921
Michael Smith,['Czech Republic'],Politician,1891,18,12,1909
Jeremy Coleman DDS,['Isle of Man'],Artist,1924,33,59,1957
Robin Townsend,['Mongolia'],Artist,1908,75,2,1983
Vanessa Gilmore DDS,"['Monaco', 'Niue']",Artist,1874,42,11,1916
Jill Arnold,['Sierra Leone'],Artist,1871,6,60,1877
Brian Atkinson,['French Southern Territories'],Engineer,1887,60,81,1947
Jody Vasquez,"['Guernsey', 'Lebanon']",Artist,1893,32,16,1925
Michael Rogers,"['British Virgin Islands', 'Netherlands']",Teacher,1915,61,81,1976
Heather Walsh,"['Qatar', 'Lithuania']",Athlete,1906,18,15,1924
Keith Gray,['Mauritania'],Athlete,1872,8,38,1880
Aaron Smith,['Central African Republic'],Co-driver; racing automobile driver; rally driver,1912,2,54,1914
Samantha Price,"['Kazakhstan', 'Bangladesh']",Artist,1873,40,85,1913
Randy Sims,"['Tajikistan', 'Lithuania']",Researcher,1875,84,83,1959
Sara Randolph,['Azerbaijan'],Politician,1917,55,28,1972
Ruben Blevins,['Mexico'],Artist,1890,20,41,1910
Michael Jackson,"['Vietnam', 'Czech Republic']",Artist,1915,0,8,1915
Connor Miller,['Uruguay'],Politician,1900,35,35,1935
Amber Evans,['Albania'],Military personnel,1901,77,10,1978
Dr. John Lee,"['Jersey', 'Belgium']",Athlete,1906,78,18,1984
Donna Berg,"['Monaco', 'Samoa']",Artist,1874,13,63,1887
Ashley Monroe,['United Kingdom'],Politician,1874,14,70,1888
Anna Tucker,"['Nepal', 'Marshall Islands']",Artist,1878,83,64,1961
Leonard Hall,"['Antigua and Barbuda', 'Bangladesh']",Artist,1899,81,57,1980
Elizabeth Franklin,['Latvia'],Artist,1879,67,61,1946
Kevin Villarreal,"['Moldova', 'American Samoa']",Artist,1919,52,24,1971
Samuel Clark,"['Senegal', 'Guinea-Bissau']",Midwife; serial killer,1901,39,56,1940
Brian Myers,['British Virgin Islands'],Teacher,1880,28,57,1908
Courtney Johns,"[""Cote d'Ivoire""]",Artist,1887,18,1,1905
Steven Frazier,"['France', 'Norfolk Island']",Artist,1909,81,6,1990
Sierra Shaw,"['Equatorial Guinea', 'British Virgin Islands']",Politician,1905,4,60,1909
Alex Schneider,"['Turkmenistan', 'Philippines']",Alpine skier,1924,4,36,1928
Lori Rivera,['Afghanistan'],Artist,1896,30,42,1926
Rebecca Daugherty,"['Guadeloupe', 'Western Sahara']",Entrepreneur,1897,16,48,1913
Joanna Butler,"['Croatia', 'Solomon Islands']",Artist,1904,43,77,1947
Stacey Salazar,"['Bhutan', 'Estonia']",Politician,1893,83,80,1976
David Parker,"['Sao Tome and Principe', 'Paraguay']",Artist,1871,38,33,1909
Shannon Booker,"['Christmas Island', 'Mauritania']",Researcher,1875,25,5,1900
Anthony Burke,['Kuwait'],Artist,1892,17,8,1909
Tyler Brown,"['Lebanon', 'Saint Helena']",Psychiatrist; spy,1918,11,57,1929
Miguel Brown,['Nauru'],Researcher,1901,39,73,1940
Deanna Khan,['French Guiana'],Artist,1874,21,18,1895
Candice Roy,['Palau'],Athlete,1913,51,69,1964
Michael Johnston,['Thailand'],Politician,1881,80,27,1961
Joe Gonzales,['Iraq'],Artist,1907,53,13,1960
Amy Allen,"['Guyana', 'Dominica']",Researcher,1881,41,81,1922
Grace Baker,['Austria'],Artist,1907,43,26,1950
Jennifer Jackson,['Somalia'],Politician,1876,88,53,1964
Philip Vaughan,['United States of America'],Politician,1887,1,22,1888
Crystal Murphy,"['Tunisia', 'Somalia']",Military personnel,1884,46,52,1930
Heidi Santiago,"['Angola', 'Qatar']",Politician,1883,64,52,1947
Eric Simmons,"['Mauritius', 'Eritrea']",Athlete,1887,21,77,1908
Jonathan Boyd,['Burkina Faso'],Guitarist,1880,15,2,1895
Lori Guerra,['Philippines'],Athlete,1911,46,81,1957
Susan Navarro,"['Cameroon', 'Myanmar']",Drug trafficker; prostitute,1916,53,76,1969
Danielle Rangel,['Mozambique'],Artist,1891,72,27,1963
Gabriela Harris,"['Jersey', 'Korea']",Researcher,1924,73,37,1997
Michelle Scott,['Russian Federation'],Athlete,1909,34,67,1943
Steven Hudson,['Albania'],Witness,1887,41,38,1928
Stacey Robinson,['Solomon Islands'],Politician,1903,51,26,1954
Thomas Mcpherson,"['Belgium', 'Anguilla']",Politician,1905,15,63,1920
Mary Flores,"['Congo', 'Kyrgyz Republic']",Researcher,1872,21,48,1893
April Wall,"['Oman', 'United Kingdom']",Researcher,1879,39,75,1918
Crystal Leblanc,['Nepal'],Artist,1910,53,82,1963
Amanda Ross,['Rwanda'],Artist,1882,47,63,1929
Amanda Blair,['Eritrea'],Artist,1917,28,61,1945
Matthew Bishop,"['Cyprus', 'Kuwait']",Journalist,1890,30,26,1920
Marco Conley,['Svalbard & Jan Mayen Islands'],Politician,1876,51,45,1927
David Brooks,['Samoa'],Politician,1923,59,43,1982
James Ross,['Holy See (Vatican City State)'],Athlete,1882,70,63,1952
Brandy Herrera,['Chad'],Artist,1913,31,57,1944
Anthony Guzman,['French Southern Territories'],Artist,1878,29,58,1907
Tiffany Bell,"['Turkey', 'Cayman Islands']",Politician,1897,31,44,1928
Matthew Wright,"['El Salvador', 'Myanmar']",Artist,1923,54,14,1977
Brandon Briggs,"['United States Virgin Islands', 'Switzerland']",Spy,1913,39,1,1952
Emily Rose,"['Eritrea', 'Falkland Islands (Malvinas)']",Artist,1893,47,36,1940
Tara Ford,"['Niger', 'Czech Republic']",Athlete,1905,38,10,1943
Angela Miller,"['Myanmar', 'Saint Pierre and Miquelon']",Politician,1876,31,81,1907
Stephen Hensley,"['Croatia', 'Luxembourg']",Artist,1891,27,71,1918
Karen Wood,['Mexico'],Artist,1886,40,72,1926
Gary Mcknight,"['Andorra', 'Northern Mariana Islands']",Artist,1891,88,14,1979
Kelly Everett,"['Cook Islands', 'Papua New Guinea']",Athlete,1916,84,24,2000
Samantha Aguirre,"['Central African Republic', 'Kazakhstan']",Politician,1906,15,10,1921
Brandon Alexander,"['Bouvet Island (Bouvetoya)', 'Mali']",Politician,1919,22,39,1941
Bill Baker,"['Estonia', 'Zambia']",Athlete,1912,34,70,1946
Stacey Shepherd,['Portugal'],Artist,1901,31,6,1932
Debra Morales,"['Mayotte', 'Cook Islands']",Artist,1922,82,16,2004
Carol Jenkins,['Palestinian Territory'],Artist,1875,11,64,1886
Kayla Stewart,['Western Sahara'],Artist,1877,49,48,1926
Mark Mccoy,['Reunion'],Artist,1906,75,44,1981
Scott Williams,['Tanzania'],Artist,1875,25,71,1900
Jesse Ramsey,"['Turkey', 'Bouvet Island (Bouvetoya)']",Artist,1878,41,69,1919
Michelle Harris,"['Isle of Man', 'Senegal']",Athlete,1885,45,32,1930
Justin Rodriguez,"['China', 'Malaysia']",Politician,1921,16,34,1937
Sandra Gordon,"['French Polynesia', 'Malaysia']",Researcher,1921,50,59,1971
Thomas Hart,"['Dominican Republic', 'Burkina Faso']",Artist,1886,80,12,1966
James Bean,['Montserrat'],Politician,1921,14,1,1935
John Moore,['Colombia'],Artist,1885,5,85,1890
Joy Johnson,['Austria'],Artist,1876,7,36,1883
Patricia Larson,"['Monaco', 'Dominican Republic']",Artist,1881,53,40,1934
David Brown,"['South Georgia and the South Sandwich Islands', 'Namibia']",Politician,1917,79,12,1996
Julie Sherman,"['Mauritius', 'Dominica']",Artist,1899,11,36,1910
Jeff Reyes,['Malta'],Military personnel,1893,47,43,1940
Hannah Roberts,"['Sri Lanka', 'Wallis and Futuna']",Politician,1885,87,37,1972
Denise Higgins,"['Denmark', 'Faroe Islands']",Politician,1898,74,80,1972
Matthew Coffey,"['Tunisia', 'Moldova']",Politician,1888,12,26,1900
Susan Clark,"['Korea', 'Sweden']",Politician,1898,31,68,1929
Paige Bruce,['Palestinian Territory'],Athlete,1921,27,32,1948
Aaron Flores,['Burundi'],Researcher,1922,24,31,1946
Laura Hunter,['Belgium'],Researcher,1884,42,86,1926
James Bennett,['Bahamas'],Artist,1885,30,10,1915
James Davis,"['Georgia', 'Uzbekistan']",Artist,1884,42,59,1926
Daniel Gutierrez,['Armenia'],Politician,1871,50,39,1921
Melanie Adams,['Fiji'],Artist,1894,77,11,1971
Eric Arias,"['Paraguay', 'American Samoa']",Artist,1886,81,69,1967
Andrew Hawkins,"[""Lao People's Democratic Republic""]",Military personnel,1910,33,70,1943
Jessica Williamson,"['Saint Lucia', 'Tunisia']",Artist,1875,32,39,1907
Beth Brewer,['Maldives'],Athlete,1904,66,30,1970
Micheal Rivera,['Morocco'],Athlete,1891,14,37,1905
David Black,['Sweden'],Researcher,1905,86,17,1991
Brittany Taylor,"['Libyan Arab Jamahiriya', 'Brunei Darussalam']",Human rights activist,1908,37,64,1945
Kayla Green MD,"['Panama', 'Solomon Islands']",Artist,1877,81,63,1958
Kayla Parks,['Mozambique'],Researcher,1911,67,46,1978
Sara Howard,['Guadeloupe'],Artist,1914,80,36,1994
Richard Hobbs,"['Kazakhstan', 'Germany']",Artist,1911,33,77,1944
Joseph Goodman,['Norfolk Island'],Artist,1916,15,35,1931
Elizabeth Coffey,['Guatemala'],Athlete,1882,31,59,1913
Emma Fitzgerald,"['Turkey', 'Vietnam']",Businessperson,1903,67,15,1970
George Fuller,"['Spain', 'Guam']",Artist,1913,55,17,1968
Joseph Jones,"['Liberia', 'San Marino']",Military personnel,1902,32,40,1934
Joshua Hernandez,['Niue'],Politician,1890,60,54,1950
Kelly Wells,['United Kingdom'],Biologist; physiologist; pathologist,1908,43,27,1951
Emily Stafford,['Uzbekistan'],Artist,1884,24,23,1908
Heidi Lopez,"['Kenya', 'Cambodia']",Artist,1872,5,3,1877
Trevor Delgado,"['Latvia', 'United States of America']",Artist,1898,53,44,1951
Jason Hopkins,"['French Southern Territories', 'Hungary']",Artist,1886,79,9,1965
Misty Weaver,"['Micronesia', 'Spain']",Politician,1917,2,14,1919
Christian Coleman,['Togo'],Architect,1872,31,11,1903
Elizabeth Moore,['British Indian Ocean Territory (Chagos Archipelago)'],Researcher,1924,86,73,2010
Candace Hill,"['Macao', 'Algeria']",Artist,1919,45,23,1964
Jessica Davis,['Uganda'],Regent,1885,81,47,1966
Veronica Norris,"[""Lao People's Democratic Republic""]",Researcher,1921,3,16,1924
Wendy Castaneda,['Holy See (Vatican City State)'],Patron of the arts,1887,59,25,1946
Antonio Dougherty,"['Malawi', 'Mauritania']",Ballet dancer,1872,38,88,1910
Sandy Collins,"['French Southern Territories', 'Tonga']",Politician,1901,8,65,1909
Maria Vasquez,['Georgia'],Politician,1908,18,5,1926
Leah Bradford,['Yemen'],Artist,1876,80,17,1956
Jennifer Hooper,"['Papua New Guinea', 'Ghana']",Artist,1887,74,58,1961
Christopher Christian,['Kenya'],Serial killer; criminal,1896,40,20,1936
Christopher Miles,['Palestinian Territory'],Artist,1898,75,69,1973
Melinda Miller,['Saint Helena'],Researcher,1891,15,42,1906
Shawn Lozano,['Haiti'],Artist,1897,46,13,1943
Jerry Rodriguez,"['Bouvet Island (Bouvetoya)', 'Norway']",Waiter,1874,78,18,1952
Kristina Hayes,['Georgia'],Artist,1890,4,79,1894
Andrew Brooks,['Montserrat'],Politician,1908,13,26,1921
Maria Davis,"['Bangladesh', 'Tonga']",Artist,1890,25,11,1915
Michelle Adams,['Romania'],Artist,1920,19,35,1939
John White,"['Ghana', 'Slovakia (Slovak Republic)']",Sovereign,1895,21,36,1916
Amy Odonnell,"['Niger', 'Kiribati']",Politician,1896,7,76,1903
Jacob Nunez,"['Central African Republic', 'Tonga']",Nurse; serial killer,1878,36,85,1914
Alicia Rodriguez,"['Swaziland', 'Cayman Islands']",Sovereign,1894,20,45,1914
Jesse Trevino,['Korea'],Artist,1885,68,82,1953
Larry Patton,"['Japan', 'Colombia']",Politician,1913,5,69,1918
Shane Mitchell,['Iraq'],Politician,1921,20,36,1941
Andrew Wu,['Timor-Leste'],Politician,1883,59,23,1942
Christopher Rivera,['Turkmenistan'],Artist,1917,3,33,1920
Amy Chan,['Sri Lanka'],Artist,1921,34,32,1955
Brandy Lee PhD,"['Philippines', 'French Polynesia']",Military personnel,1891,47,86,1938
Justin Murray,['India'],Athlete,1889,39,66,1928
Paul Russell,"['Northern Mariana Islands', 'Chile']",Politician,1893,60,36,1953
Chelsea Lane,"['Indonesia', 'Oman']",Artist,1877,54,76,1931
Trevor Scott,"['Belarus', 'Gambia']",Artist,1876,30,80,1906
Nicholas Howell,"['Ghana', 'Brunei Darussalam']",Researcher,1916,71,77,1987
Roger Goodman,"['Colombia', 'Mexico']",Aristocrat,1901,7,85,1908
Justin Jones,"['Saint Kitts and Nevis', 'Tonga']",Religious figure,1887,15,82,1902
Edward Grant,"['Belize', 'Denmark']",Artist,1921,69,86,1990
Christine Ramirez,['Russian Federation'],Artist,1916,46,54,1962
Adam Lane,"[""Lao People's Democratic Republic"", 'Egypt']",Artist,1922,17,61,1939
Amy Watkins,"['Jersey', 'Myanmar']",Artist,1882,51,3,1933
Nicole Jensen,['South Georgia and the South Sandwich Islands'],Artist,1892,66,42,1958
David Potter,['Egypt'],Politician,1923,3,86,1926
Emily Allen,['Estonia'],Artist,1922,47,18,1969
Carla Ware,"['Saint Barthelemy', 'Bouvet Island (Bouvetoya)']",Artist,1900,71,16,1971
Lori Olsen,['San Marino'],Artist,1881,6,80,1887
Allison Gutierrez,['Bangladesh'],Artist,1885,73,22,1958
Elizabeth Perez,"['Burkina Faso', 'Vietnam']",Artist,1906,58,42,1964
Melanie Evans,"['French Southern Territories', 'Kiribati']",Artist,1884,45,46,1929
Eric Baker,"['Panama', 'Tokelau']",Artist,1902,17,43,1919
Robert Gutierrez,['Andorra'],Artist,1914,73,32,1987
Jessica Galvan,['Nepal'],Researcher,1886,51,75,1937
Devin Terry,['Tanzania'],Military personnel,1923,23,39,1946
Bryan Fisher,"['Poland', 'United States Minor Outlying Islands']",Artist,1883,11,81,1894
Robin Jones,['Serbia'],Politician,1887,51,76,1938
Dominique Clark,['Peru'],Artist,1905,76,79,1981
Amy Johnson,['San Marino'],Artist,1883,72,5,1955
John Khan,['Yemen'],Christians jehovahâ€™s witnesses,1878,71,23,1949
Kayla Bailey,"['Netherlands Antilles', 'Madagascar']",Artist,1890,44,60,1934
Christian Martinez Jr.,"['Christmas Island', 'Macao']",Artist,1900,70,14,1970
Vanessa Lee,['Nauru'],Artist,1883,5,78,1888
Sheri Beasley,"['Montenegro', 'Germany']",Racing automobile driver,1875,7,19,1882
Tami Jones,"['Grenada', 'Saint Pierre and Miquelon']",Politician,1909,11,72,1920
Bradley Taylor DVM,['Finland'],Artist,1903,26,12,1929
Christopher Watson,"['Seychelles', 'Czech Republic']",Artist,1902,27,48,1929
Kari Fernandez,"['Guinea', 'Sweden']",Criminal,1892,13,46,1905
Susan Miles,['Philippines'],Artist,1918,37,27,1955
Thomas Jennings,['Hong Kong'],Artist,1902,87,53,1989
Douglas Hanson,['Mexico'],Researcher,1890,52,19,1942
Patrick Combs,"['United States Virgin Islands', 'Australia']",Teacher,1922,46,27,1968
Karen Serrano,['Greece'],Politician,1898,76,37,1974
Lisa Gordon,"['Egypt', 'Armenia']",Artist,1921,7,70,1928
Brandi Jordan,['North Macedonia'],Artist,1891,60,43,1951
Kristy Harris,"['Uruguay', 'Burkina Faso']",Politician,1900,88,15,1988
Roger Wilson,['Azerbaijan'],Politician,1900,49,58,1949
Randall Patterson,['Netherlands'],Artist,1908,10,40,1918
Maria Brown,['Thailand'],Researcher,1916,20,56,1936
Justin Gomez,['Nauru'],Artist,1910,71,5,1981
Nancy Casey DVM,"['Nigeria', 'Lithuania']",Artist,1889,66,67,1955
Joel Conway,"['Algeria', 'Saint Vincent and the Grenadines']",Researcher,1883,82,51,1965
James Burns,['Gabon'],Artist,1880,11,60,1891
Lisa Monroe,"['Latvia', 'Saudi Arabia']",Politician,1887,2,15,1889
Catherine Ellis,['Botswana'],Artist,1871,4,8,1875
Jill Rowland,['China'],Athlete,1891,62,38,1953
Eric Chambers,['Tanzania'],Researcher,1903,28,13,1931
Sarah Tyler,"['Dominica', 'Turks and Caicos Islands']",Artist,1872,20,55,1892
Bruce Adams,['Malaysia'],Artist,1912,12,26,1924
Sabrina Sullivan,"['Bangladesh', 'Marshall Islands']",Artist,1877,66,46,1943
Jennifer Blanchard,['United Arab Emirates'],Politician,1907,71,38,1978
Mr. Glenn Kim DDS,['Israel'],Nun; christians jehovahâ€™s witnesses,1894,53,69,1947
Cassie Price,['Iran'],Human rights activist,1916,42,46,1958
Christopher Reynolds,['Iceland'],Artist,1889,62,12,1951
Cory Buck,['Eritrea'],Artist,1905,52,11,1957
Christopher Cunningham,"['Congo', 'Trinidad and Tobago']",Aikidoka,1898,83,24,1981
Mr. Eric Barron,['Seychelles'],Politician,1905,38,47,1943
Jason Sanders,"['North Macedonia', 'Thailand']",Artist,1879,4,41,1883
Candace Robinson,"['Canada', 'Oman']",Athlete,1871,8,26,1879
James Sawyer,['Tajikistan'],Artist,1881,40,26,1921
Audrey Morris,['Belize'],Politician,1918,85,47,2003
Nicholas Castro,['Sweden'],Military personnel,1907,24,32,1931
Gary Anderson,['French Guiana'],Mountaineer,1876,3,30,1879
Lisa Smith,"['Taiwan', 'Faroe Islands']",Artist,1894,13,4,1907
Jermaine Russell,['Luxembourg'],Researcher,1871,37,79,1908
Beth Smith,"['Colombia', 'Mauritius']",Politician,1894,78,43,1972
Sharon Williams,"['Pakistan', 'Comoros']",Artist,1915,73,17,1988
Laura Marshall,['Lesotho'],Artist,1919,11,59,1930
Bruce Turner,['Philippines'],Artist,1894,58,75,1952
George Brooks,['Mexico'],Researcher,1921,32,22,1953
Barbara Irwin,"['Georgia', 'Venezuela']",Artist,1920,35,48,1955
Katherine Beck,"['Barbados', 'Malta']",Athlete,1916,79,13,1995
Natalie Dennis,"['Mali', 'Kiribati']",Military personnel,1916,55,39,1971
Debra Baker,['Turkey'],Researcher,1904,69,88,1973
Brian Carney,['Nigeria'],Artist,1894,50,65,1944
Lauren Mcdowell,['Georgia'],Artist,1902,55,61,1957
Danielle Knight,"['Senegal', 'Romania']",Artist,1894,52,53,1946
Haley Arnold,"['Chad', 'Senegal']",Military personnel,1899,86,64,1985
Audrey Cline,['Latvia'],Politician,1898,89,38,1987
Stephanie Cochran,"['Botswana', 'Czech Republic']",Researcher,1905,33,73,1938
Kimberly Schultz,['Northern Mariana Islands'],Artist,1896,10,7,1906
Jeremiah Baker,['Northern Mariana Islands'],Athlete,1919,33,69,1952
Michael Johnson,['Paraguay'],Artist,1893,32,62,1925
Thomas Lopez,"['Guernsey', 'Dominica']",Ice dancer,1889,68,11,1957
Courtney Hunter,"['Libyan Arab Jamahiriya', 'Albania']",Politician,1917,65,60,1982
Cassandra Hanson,"['Australia', 'Syrian Arab Republic']",Athlete,1910,44,67,1954
Austin Randall,['Nauru'],Lawyer,1910,13,17,1923
Dustin Morris,['Timor-Leste'],Artist,1870,83,6,1953
Charles Richards,"['Belize', 'Dominican Republic']",Model,1873,82,22,1955
John Lee,"['Cook Islands', 'Turkey']",Researcher,1893,39,40,1932
Norma Mcdonald,"['United States Minor Outlying Islands', 'Switzerland']",Psychiatrist,1916,0,42,1916
Stephanie Mccullough,['Madagascar'],Author; television producer; television presenter; chef; autobiographer,1910,54,26,1964
Selena Johnson,['Afghanistan'],Alpine skier,1900,84,70,1984
Sarah Weeks,['Paraguay'],Artist,1877,74,29,1951
Anthony Reyes,"['Marshall Islands', 'Kenya']",Artist,1886,80,55,1966
Jennifer Klein,"['Brazil', 'Iraq']",Athlete,1906,5,23,1911
Samantha Williamson,['French Guiana'],Researcher,1911,88,81,1999
Shawn Hardy,['Svalbard & Jan Mayen Islands'],Artist,1912,82,51,1994
Kelsey Wilson,"['Western Sahara', 'Andorra']",Athlete,1922,7,0,1929
Emily Soto,['Syrian Arab Republic'],Politician,1901,15,29,1916
Gary Mcdaniel,['Tuvalu'],Artist,1920,50,29,1970
Joseph Moore,['Belarus'],Acrobat; circus performer,1924,82,20,2006
Elizabeth Green,"['Venezuela', 'United States Virgin Islands']",Artist,1893,29,24,1922
Melinda Davis,['Samoa'],Politician,1906,24,1,1930
Richard Mays,['Lesotho'],Artist,1890,68,80,1958
Sarah Fox,"['Botswana', 'Chile']",Politician,1888,19,84,1907
Melody Suarez,"['Guinea', 'Angola']",Artist,1905,78,31,1983
Shelly Fields,['Anguilla'],Politician,1889,46,84,1935
Mary Burnett,"['Netherlands Antilles', 'Tajikistan']",Artist,1909,69,46,1978
Kenneth Clark,['Belgium'],Engineer,1870,61,49,1931
John Richardson,['Palau'],Researcher,1880,40,35,1920
Anthony Taylor,['Congo'],Politician,1903,3,14,1906
Destiny Wang,['Ghana'],Artist,1885,33,82,1918
Caroline Roberson,['Cambodia'],Athlete,1899,64,53,1963
Mary Bentley,['Mozambique'],Military personnel,1898,84,56,1982
Chad Bernard,"[""Lao People's Democratic Republic"", 'Reunion']",Military personnel,1892,55,20,1947
Adam Mcdaniel,"['Seychelles', 'Niger']",Criminal,1914,31,52,1945
Ryan Jackson,"['Suriname', 'Guyana']",Athlete,1888,59,54,1947
Jeffrey Garcia,['China'],Artist,1910,62,4,1972
Kristi Hester,"['French Polynesia', 'Rwanda']",Astronomer,1870,16,21,1886
Jonathan Clark,['Saudi Arabia'],Aristocrat,1909,43,89,1952
Jacob Davis,"['Saudi Arabia', 'Antigua and Barbuda']",Politician,1877,38,43,1915
Stephen French,['Hungary'],Artist,1870,18,27,1888
Jacob Bartlett,['Bermuda'],Politician,1871,73,5,1944
Anthony Beck,['Taiwan'],Politician,1875,45,53,1920
Holly Edwards,"['Peru', 'Cayman Islands']",Athlete,1922,72,65,1994
Ashley Thompson,['Senegal'],Politician,1884,40,33,1924
Michelle Wilson,"['Switzerland', 'Puerto Rico']",Politician,1883,46,82,1929
Michelle Castro,['Spain'],Researcher,1892,40,29,1932
Christopher Washington,"['Guam', 'Moldova']",Artist,1922,11,85,1933
James Friedman,"['Equatorial Guinea', 'South Georgia and the South Sandwich Islands']",Monarch,1888,48,29,1936
Amanda Santiago,['Norfolk Island'],Impresario; film producer,1908,76,81,1984
Denise Patterson,['Belarus'],Mountain guide; mountaineer,1896,0,87,1896
Jeffrey Clayton,['Peru'],Artist,1924,36,23,1960
George Hanson,"['Israel', 'Barbados']",Politician,1881,52,49,1933
Christopher Gibson,"['Malawi', 'Northern Mariana Islands']",Artist,1879,82,43,1961
Dawn Wiley,"['Guatemala', 'Dominican Republic']",Military personnel,1913,30,27,1943
Gabriela Daniels,['Svalbard & Jan Mayen Islands'],Politician,1872,84,73,1956
Erik Roy,['French Southern Territories'],Artist,1919,3,7,1922
Sarah Miller,"['Sierra Leone', 'Montenegro']",Researcher,1922,46,89,1968
Claudia Vega,"['Dominica', 'Guatemala']",Politician,1911,81,84,1992
Scott Shah,['Mongolia'],Artist,1914,36,5,1950
Cory Burke,['Saint Helena'],Artist,1914,28,79,1942
Adam Frazier,['Yemen'],Politician,1910,41,59,1951
Maurice Lindsey,['Malawi'],Artist,1914,78,80,1992
Megan Lopez,['Palestinian Territory'],Artist,1899,20,80,1919
Heather Allen,"['Gambia', 'Guinea']",Artist,1905,25,13,1930
Daniel Peters,['Turkmenistan'],Artist,1876,32,71,1908
Rebecca Smith,"['Czech Republic', 'Western Sahara']",Artist,1899,14,34,1913
Matthew Taylor,"['Malta', 'Saint Martin']",Athlete,1905,5,44,1910
Kaylee Hayes,['Holy See (Vatican City State)'],Artist,1902,39,20,1941
Jason Payne,['Iceland'],Artist,1921,43,50,1964
Paula Walker,"['Azerbaijan', 'Namibia']",Artist,1883,34,29,1917
Jesse Cummings,"['Marshall Islands', 'Guam']",Artist,1875,13,36,1888
Danielle Jones,"['Saudi Arabia', 'Ecuador']",Politician,1898,58,44,1956
Jimmy Alvarado,"['Ghana', 'Tanzania']",Artist,1891,2,79,1893
Christine Dominguez,"['Haiti', 'Qatar']",Anthropologist,1904,19,76,1923
Jeff Schneider,"['Brazil', 'South Africa']",Record producer; music executive,1906,21,80,1927
Carol Harris,"['Cocos (Keeling) Islands', 'Togo']",Artist,1894,61,43,1955
Yesenia Mcfarland,['Chile'],Housekeeper,1873,76,54,1949
Lisa Thomas,"['Saint Pierre and Miquelon', 'Kuwait']",Artist,1902,0,40,1902
Jessica Harmon,"['Guatemala', 'Germany']",Costume designer; fashion designer; designer,1875,29,0,1904
Jonathan Pacheco,"['Aruba', 'Thailand']",Artist,1899,34,40,1933
Daniel Pena,"['Kenya', 'United States of America']",Politician,1906,89,24,1995
Thomas Brewer,['Taiwan'],Athlete,1892,26,50,1918
Charles Torres,['Turkmenistan'],Researcher,1902,36,31,1938
Erika Carter,['Guyana'],Artist,1879,46,0,1925
Christine Gross,['Afghanistan'],Artist,1901,69,19,1970
Diane Thomas,['Algeria'],Artist,1900,25,22,1925
Amy Morales,['Tunisia'],Politician,1893,38,39,1931
Sara Wood,"['Trinidad and Tobago', 'Nigeria']",Resistance fighter,1874,3,7,1877
Hannah Shields,['Saint Vincent and the Grenadines'],Researcher,1875,11,38,1886
Michael Stark,['Guadeloupe'],Politician,1880,39,75,1919
Seth Obrien,"['Guyana', 'Luxembourg']",Artist,1915,73,6,1988
James Austin,['Ireland'],Artist,1892,36,38,1928
Rachel Edwards,['Hungary'],Artist,1909,47,11,1956
Jackie Gomez,"['Slovakia (Slovak Republic)', 'Trinidad and Tobago']",Military personnel,1878,29,75,1907
Susan Cantrell,"['New Caledonia', 'Northern Mariana Islands']",Artist,1891,10,35,1901
Morgan Wiley,['Saint Kitts and Nevis'],Artist,1924,18,0,1942
Kathy Williams,['Zambia'],Artist,1906,86,42,1992
Jose Hill,"['Gibraltar', 'Switzerland']",Artist,1914,28,57,1942
Courtney Waller,['Sao Tome and Principe'],Artist,1879,44,42,1923
Sharon Jackson,"['Brazil', 'Djibouti']",Physician,1881,18,60,1899
Timothy Lyons,['Gambia'],Artist,1879,56,83,1935
Linda Fox,['Congo'],Artist,1871,8,11,1879
Steven Robinson,"['Niger', 'Burkina Faso']",Artist,1895,8,20,1903
Erica Hernandez,"['Burundi', 'Lithuania']",Amateur wrestler,1912,68,54,1980
Dylan Page,['Saint Lucia'],Artist,1876,42,81,1918
Lauren Dean,['Haiti'],Politician,1906,20,33,1926
Teresa Turner,"['Venezuela', 'New Zealand']",Military personnel,1905,31,23,1936
John Brooks,"['Madagascar', 'Cape Verde']",Athlete,1919,40,20,1959
Dennis Lucas,['Nauru'],Artist,1870,23,8,1893
Rachel Hughes PhD,['Suriname'],Politician,1905,49,72,1954
Sarah Wallace,['Cook Islands'],Artist,1894,42,73,1936
Sara Robertson,"['Saint Barthelemy', 'Egypt']",Politician,1875,40,32,1915
Morgan Garner,['Angola'],Businessperson,1919,58,17,1977
Jennifer Cook,['Gambia'],Journalist,1871,14,29,1885
Rebecca Boyer,"['Niger', 'Holy See (Vatican City State)']",Artist,1881,50,3,1931
Robert Myers,"['Nigeria', 'Northern Mariana Islands']",Researcher,1896,83,37,1979
Amber Rios,['Zambia'],Sailor,1873,77,42,1950
William Heath,['Antigua and Barbuda'],Researcher,1891,55,81,1946
Joseph Mendez,"['Peru', 'Turks and Caicos Islands']",Researcher,1890,59,8,1949
Meredith Gordon,"['Chile', 'Uruguay']",Journalist,1874,77,7,1951
Karen Barnes,['Equatorial Guinea'],Artist,1884,57,58,1941
Erica West,"['Qatar', 'Central African Republic']",Entrepreneur,1914,40,75,1954
Sarah Alexander,['Montserrat'],Count,1895,74,80,1969
James Paul,"['Cuba', ""Cote d'Ivoire""]",Artist,1900,2,15,1902
Barbara Frey,"['Andorra', 'Comoros']",Engineer,1917,55,36,1972
Nicole Bishop,['Tanzania'],Politician,1916,58,47,1974
Miss Jill Silva,"['Guyana', 'Oman']",Teacher,1909,68,52,1977
Jason Davis,"['French Southern Territories', 'American Samoa']",Engineer,1891,60,89,1951
Daniel Marshall,"['Aruba', 'Nigeria']",Artist,1881,43,74,1924
Noah Rodriguez,['Cocos (Keeling) Islands'],Competitive diver,1883,79,55,1962
Christopher Chapman,['Finland'],Researcher,1881,29,34,1910
Suzanne Cook,['Norway'],Politician,1923,86,81,2009
Angela Carlson,['Singapore'],Artist,1890,58,25,1948
Kevin Holland,['Taiwan'],Artist,1923,11,10,1934
Jason Garcia,['El Salvador'],Researcher,1916,8,81,1924
Whitney Hill,"['Venezuela', 'Denmark']",Researcher,1895,51,34,1946
Jack Meyers,['Greenland'],Artist,1921,39,55,1960
Jason Smith,"['Finland', 'Kuwait']",Researcher,1902,60,41,1962
Andrew Cooper,['Hong Kong'],Researcher,1901,58,70,1959
Mary Griffin,"['Central African Republic', 'Trinidad and Tobago']",Businessperson,1924,33,84,1957
Priscilla Miller,"['Guinea', 'Christmas Island']",Artist,1881,69,16,1950
James Richard,"['Algeria', 'Bolivia']",Artist,1916,81,81,1997
Timothy Watson,['El Salvador'],Athlete,1900,41,86,1941
Michelle Pollard,"['Australia', 'Myanmar']",Athlete,1889,41,75,1930
Chloe Best,['Togo'],Politician,1890,72,63,1962
Julie Williams,['Croatia'],Artist,1921,81,35,2002
Stephen Cook,['Cameroon'],Artist,1884,61,59,1945
Cody Bush,['Papua New Guinea'],Artist,1877,71,76,1948
Susan Bell,['Niger'],Artist,1920,32,44,1952
Kelsey Glover,"['Lithuania', 'Sri Lanka']",Physician,1892,46,47,1938
Mr. James Hill Jr.,['Bangladesh'],Artist,1893,18,87,1911
Hannah Bell,"['British Virgin Islands', 'Japan']",Politician,1908,81,51,1989
Luke Herman,['Greenland'],Artist,1893,53,1,1946
Mathew Rivas,"['Gibraltar', 'Cambodia']",Politician,1880,42,82,1922
Lindsey Moore,"['Cape Verde', 'Isle of Man']",Drug trafficker; prostitute,1879,26,72,1905
Jennifer Graham,"['Yemen', 'Cuba']",Artist,1906,73,48,1979
Charlene Mcknight,"['Lebanon', 'Antarctica (the territory South of 60 deg S)']",Politician,1908,16,61,1924
Jennifer Johnson,['Holy See (Vatican City State)'],Artist,1871,15,27,1886
Jordan White,"['Sweden', 'Luxembourg']",Artist,1892,11,74,1903
Cindy Benson,"['China', 'Myanmar']",Entrepreneur,1883,52,38,1935
Aaron Bennett,"['Peru', 'Azerbaijan']",Preacher,1921,34,88,1955
Christopher Taylor,['Pakistan'],Samurai,1881,50,22,1931
Dawn Jenkins,"['Papua New Guinea', 'Niger']",Artist,1907,46,87,1953
Charles Singh DVM,"['Moldova', 'United Kingdom']",Artist,1898,42,33,1940
Jennifer Chen,['Nigeria'],Artist,1913,48,48,1961
Benjamin Williams,"['Belarus', 'Sierra Leone']",Politician,1903,84,17,1987
Charles Alvarado,"['Greenland', 'Belgium']",Politician,1912,36,64,1948
Mr. Earl Hernandez,"['Germany', 'Guyana']",Artist,1914,46,43,1960
Brian Johnson,['Egypt'],Politician,1905,39,85,1944
Stacy Jones,"['Heard Island and McDonald Islands', 'Monaco']",Politician,1906,16,18,1922
Jacqueline Walker,['San Marino'],Artist,1921,87,39,2008
Elizabeth Douglas,"['Solomon Islands', 'Cook Islands']",Researcher,1914,82,24,1996
Jeremiah Stevens,['Chad'],Artist,1875,37,17,1912
Jerry Norman,['Iran'],Artist,1916,35,74,1951
Justin Wood,['Guinea'],Artist,1915,66,49,1981
Maria Gonzalez,['Pakistan'],Artist,1888,22,7,1910
Amy Pace,['Faroe Islands'],Artist,1890,8,48,1898
Lydia Evans,['Djibouti'],Politician,1893,20,8,1913
Jill Thomas,"['Greece', 'Madagascar']",Entrepreneur,1882,24,32,1906
Kayla Lopez,['Australia'],Politician,1880,67,51,1947
Edward Howard,['Egypt'],Athlete,1917,20,7,1937
Tracey Brown,['Puerto Rico'],Artist,1904,81,22,1985
Tara Miller,"['Netherlands Antilles', 'Qatar']",Artist,1903,54,8,1957
Thomas Lopez,"['American Samoa', 'Saint Vincent and the Grenadines']",Researcher,1888,12,4,1900
Theodore Williams,['Equatorial Guinea'],Engineer,1916,87,69,2003
Savannah Romero,"['Guam', 'Guatemala']",Artist,1906,39,60,1945
Rachel Taylor,['Mayotte'],Artist,1877,83,6,1960
Tammy Andrews,['Sierra Leone'],Artist,1913,80,10,1993
Mary Johnson,['British Virgin Islands'],Researcher,1904,26,36,1930
Jeffery Summers,['Vietnam'],Motorcycle racer; racing automobile driver; formula one driver,1894,68,80,1962
Andrea Marshall,"['Niue', 'Serbia']",Athlete,1905,67,22,1972
Casey Gibson,"['Suriname', 'Cyprus']",Artist,1910,44,31,1954
Elijah Paul,"['Slovenia', 'Guinea-Bissau']",Witness,1874,59,44,1933
Lisa Mccoy,['Haiti'],Researcher,1915,72,67,1987
Stephen Barrett,['Swaziland'],Sociologist,1916,74,0,1990
Malik Morgan,"['Kuwait', 'Svalbard & Jan Mayen Islands']",Sovereign,1901,31,48,1932
Amy Evans,['Bulgaria'],Politician,1924,21,71,1945
Dr. Nicole Stephens,['Moldova'],Businessperson,1917,30,62,1947
Charlene Paul,['Japan'],Military personnel,1877,3,33,1880
Ryan Navarro,"[""Lao People's Democratic Republic"", 'Tokelau']",Artist,1908,9,44,1917
Donna House,['Tanzania'],Motorcycle racer; rally driver,1876,76,62,1952
Jenna Dixon,"['Gibraltar', 'Netherlands']",Artist,1918,62,59,1980
Beth Miller,['Cayman Islands'],Assassin,1900,84,28,1984
Steven Morales,['Tunisia'],Cinematographer,1873,47,84,1920
Sara Johnson,"['Sweden', 'Iraq']",Religious figure,1875,15,28,1890
Danielle Espinoza,['American Samoa'],Researcher,1909,21,7,1930
Kimberly Robinson,"['Guinea', 'Western Sahara']",Politician,1898,38,58,1936
John Bond,['Liechtenstein'],Researcher,1874,85,69,1959
Justin Mitchell,['South Africa'],Artist,1893,7,45,1900
Laurie Nicholson,"['Djibouti', 'British Indian Ocean Territory (Chagos Archipelago)']",Artist,1886,11,75,1897
Sandra Perkins,"['Qatar', 'United States Minor Outlying Islands']",Privateer; pirate,1884,54,85,1938
Edward Bell,['Jersey'],Artist,1890,62,82,1952
Cynthia Anderson,"['Madagascar', 'Romania']",Researcher,1882,70,4,1952
Mr. Matthew Scott,"['Croatia', 'Uruguay']",Military personnel,1905,33,20,1938
Julie Fowler,['Montserrat'],Artist,1879,11,13,1890
Chad Willis,['Belgium'],Sprinter,1881,76,49,1957
David Edwards,"['Bermuda', 'Mongolia']",Rock climber; skydiver; mountaineer,1886,46,30,1932
Emily Burke,['Cook Islands'],Revolutionary,1897,39,35,1936
Jason Russo,"['Central African Republic', 'San Marino']",Artist,1923,20,49,1943
Brittany Pineda,"['Honduras', 'Cameroon']",Researcher,1886,2,55,1888
Michael Gutierrez,"['Brazil', 'Kiribati']",Athlete,1870,8,48,1878
Casey Brown,['Reunion'],Artist,1915,53,62,1968
Suzanne Perez,"['Romania', 'Congo']",Politician,1877,32,37,1909
Jamie Park MD,['Christmas Island'],Artist,1885,47,46,1932
Dwayne Sweeney,"['Ireland', 'Gambia']",Artist,1883,58,19,1941
Jaclyn Hensley,"['China', 'Pakistan']",Artist,1917,29,68,1946
Miranda Farrell,"['Liechtenstein', 'British Virgin Islands']",Politician,1894,47,21,1941
Richard Thompson,"['Hong Kong', 'Martinique']",Judge,1916,38,13,1954
Christopher Wagner,['Holy See (Vatican City State)'],Artist,1916,11,80,1927
Monica Melton,['Serbia'],Politician,1901,86,58,1987
Alexander Wood,"['Marshall Islands', 'Netherlands']",Politician,1887,42,77,1929
Warren Mueller,"['Antarctica (the territory South of 60 deg S)', 'Iraq']",Architect,1872,35,75,1907
Cory Kent,"['Martinique', 'Christmas Island']",Artist,1886,46,80,1932
Andrew Taylor,['Lesotho'],Politician,1912,72,9,1984
Bianca Jackson,"['Japan', 'Saint Vincent and the Grenadines']",Artist,1904,54,31,1958
William Ford,"['Lithuania', 'United States of America']",Artist,1884,79,62,1963
Linda Bennett,['United Kingdom'],Mangaka,1870,31,64,1901
Rebecca Hunter,['Rwanda'],Explorer,1915,68,40,1983
Calvin Dyer,['Zimbabwe'],Sovereign,1916,71,67,1987
Gwendolyn Foster,['North Macedonia'],Artist,1897,10,5,1907
Richard Young,['South Africa'],Politician,1887,86,71,1973
Sherri Smith,"['Marshall Islands', 'Fiji']",Researcher,1881,56,76,1937
April Thomas,['Norfolk Island'],Researcher,1882,8,47,1890
Danny Flores,['Jersey'],Artist,1899,66,63,1965
Amy Rollins,['Guadeloupe'],Monarch,1906,88,27,1994
William Ramirez,['Australia'],Professional wrestler; amateur wrestler,1924,89,75,2013
Russell Cook,['United Kingdom'],Artist,1902,57,1,1959
Barbara Wolf,['Sao Tome and Principe'],Artist,1870,9,19,1879
Tracy Perez,"['Guinea', 'Libyan Arab Jamahiriya']",Artist,1896,10,18,1906
Leslie Smith,['Belgium'],Aristocrat,1920,35,31,1955
Kelly Rogers,['Australia'],Athlete,1875,35,7,1910
James Cruz,"['Tokelau', 'Armenia']",Athlete,1873,51,25,1924
Mr. George Green,['Saint Kitts and Nevis'],Artist,1878,46,64,1924
Ann Roberts,['Venezuela'],Athlete,1900,51,61,1951
Andrew Griffin,"['Tonga', 'El Salvador']",Artist,1883,29,8,1912
Carolyn Booth,"['Georgia', 'Congo']",Businessperson,1899,8,41,1907
Amy Gilbert,['Martinique'],Artist,1870,34,26,1904
Gregory Rice,"['British Virgin Islands', 'Guernsey']",Artist,1899,0,32,1899
Alexandra King,"['Afghanistan', 'Rwanda']",Monarch,1874,40,80,1914
Grace Winters DVM,['Czech Republic'],Politician,1889,12,26,1901
Anthony Mendez,['Timor-Leste'],Politician,1898,6,37,1904
Martin Miller,['Peru'],Artist,1892,76,11,1968
Traci Moore,['Madagascar'],Serial killer,1924,76,76,2000
Stephen Flores,['Cuba'],Artist,1915,5,41,1920
Austin Ruiz,['Cayman Islands'],Fencer,1872,42,86,1914
Justin Bautista,['Morocco'],Alpine skier,1911,78,84,1989
Douglas Morton,"['Philippines', 'British Virgin Islands']",Artist,1876,88,82,1964
Holly Hernandez,"['Ecuador', 'American Samoa']",Artist,1905,65,22,1970
Patricia Romero,['Solomon Islands'],Politician,1886,29,82,1915
Janice Nelson,['Liechtenstein'],Athlete,1899,42,0,1941
Jason Butler,['Hungary'],Athlete,1910,81,36,1991
Charles Pitts,"['Dominican Republic', 'Bosnia and Herzegovina']",Artist,1891,0,13,1891
Mary Harris DDS,"['Algeria', 'Turks and Caicos Islands']",Military personnel,1907,0,85,1907
John Gardner,"['Chile', 'Suriname']",Artist,1918,10,70,1928
Andrew Hopkins,['Albania'],Architect,1901,78,75,1979
Erika Walker,"['Australia', 'Uruguay']",Artist,1881,87,42,1968
Leslie Warner,['Liechtenstein'],Athlete,1908,31,10,1939
Mark Williams,['Afghanistan'],Politician,1890,24,37,1914
James Collins,['Pitcairn Islands'],Athlete,1916,44,7,1960
Rebecca Perez,"['Netherlands Antilles', 'Saint Vincent and the Grenadines']",Artist,1893,11,85,1904
Andrew Brown,['Madagascar'],Artist,1880,19,7,1899
Abigail Salas,['Ireland'],Politician,1886,75,20,1961
Kyle Thomas,['Bermuda'],Artist,1880,26,25,1906
Jill Mason,['Nicaragua'],Researcher,1908,49,83,1957
Eric White,['Namibia'],Politician,1901,30,41,1931
Makayla Garcia,"['Saudi Arabia', 'Switzerland']",Politician,1888,46,87,1934
Alejandro Norton MD,"['Maldives', 'Saint Barthelemy']",Artist,1911,70,0,1981
Thomas Chandler,"['Lebanon', 'Liberia']",Politician,1911,72,40,1983
Kellie Parks,"['Cocos (Keeling) Islands', 'Pitcairn Islands']",Researcher,1879,26,6,1905
John Wilson,"['Eritrea', 'Azerbaijan']",Artist,1919,30,0,1949
Sandra Gutierrez,['Botswana'],Politician,1889,33,7,1922
Gina Underwood,['Martinique'],Athlete,1878,55,66,1933
Shawn Ramirez,['Belize'],Artist,1874,77,73,1951
Marie Johnson,"['Cayman Islands', 'American Samoa']",Artist,1889,74,42,1963
Robert West DDS,"['Zambia', 'Taiwan']",Athlete,1871,67,10,1938
Stephanie Davis,['Somalia'],Religious figure,1878,33,76,1911
Suzanne Adams,['Mayotte'],Resistance fighter; aristocrat,1875,4,2,1879
Brian Perez,"['Niue', 'Cape Verde']",Monarch,1921,68,83,1989
Connor Bailey,['Anguilla'],Artist,1903,63,37,1966
Katie Chase,"['Comoros', 'Australia']",Artist,1900,38,47,1938
Brandy Wang,"['Brunei Darussalam', 'Montserrat']",Artist,1914,73,6,1987
Michelle Weaver,"['Saint Vincent and the Grenadines', 'Turkmenistan']",Researcher,1915,39,77,1954
Deborah Howard,['Bulgaria'],Artist,1898,84,19,1982
Katherine Ward,"['Belize', 'Fiji']",Politician,1873,38,66,1911
Erin Turner,"['Argentina', 'New Caledonia']",Artist,1918,51,60,1969
John Barber,['Northern Mariana Islands'],Artist,1887,41,31,1928
Randall Lee,['Lithuania'],Artist,1899,73,6,1972
Tim Rodriguez,"['Timor-Leste', 'Serbia']",Politician,1908,16,66,1924
Brenda Smith,['Saudi Arabia'],Politician,1890,49,22,1939
Christopher Williams,['Finland'],Politician,1907,47,61,1954
Kaitlyn Riley,"['Nepal', 'Mali']",Researcher,1894,10,58,1904
Kayla Mcmillan,['Bulgaria'],Artist,1882,43,60,1925
Brenda Dennis,['Vietnam'],Artist,1901,68,39,1969
Renee Brown,['Burundi'],Military personnel,1913,43,22,1956
Eric Figueroa,"['France', 'Congo']",Artist,1897,40,54,1937
Kristina Smith,"['Papua New Guinea', 'Norway']",Artist,1882,19,46,1901
Mr. Richard Rodriguez Jr.,['South Africa'],Researcher,1882,78,68,1960
Jessica Hawkins DVM,['Saudi Arabia'],Athlete,1890,16,43,1906
Debbie Vance,['Papua New Guinea'],Knight of the order of the temple,1906,86,41,1992
Trevor Knapp,"['Austria', 'Poland']",Murderer; peace activist,1907,9,19,1916
Terry Freeman,['Faroe Islands'],Engineer,1921,72,59,1993
Christina Jones,"['Georgia', 'Bangladesh']",Artist,1878,42,66,1920
Ryan Hanna,['Tajikistan'],Artist,1877,59,20,1936
Jose Wood,['Guernsey'],Researcher,1910,65,53,1975
Steven Davis,['Cambodia'],Artist,1891,16,85,1907
Brittney Rogers,['Mongolia'],Politician,1908,61,34,1969
James Smith,['Anguilla'],Artist,1912,5,69,1917
Chelsea Fuentes,"['Bhutan', 'Italy']",Athlete,1893,47,73,1940
Matthew Vaughn,['Costa Rica'],Artist,1873,6,5,1879
Michael Hayes,"['Guinea-Bissau', 'Saint Barthelemy']",Regent,1916,52,66,1968
Ian Ingram,"['Saint Helena', 'Timor-Leste']",Artist,1899,47,57,1946
Dave Villa,['Zimbabwe'],Journalist,1905,6,28,1911
Amber Becker,"['Albania', 'Togo']",Artist,1889,79,7,1968
Rebecca Dixon,"['Colombia', 'Pitcairn Islands']",Artist,1913,19,18,1932
Melissa Myers,['Yemen'],Serial killer,1872,44,60,1916
Gary Acevedo,['Guernsey'],Athlete,1899,19,10,1918
Jonathan Schultz,['Congo'],Artist,1893,89,77,1982
Kelly Lopez,['Tonga'],Artist,1883,7,89,1890
Mr. Brian Barton,['Gabon'],Artist,1881,83,77,1964
Lisa Hoover,['Czech Republic'],Artist,1876,81,74,1957
Michael Savage,['Montenegro'],Athlete,1903,23,16,1926
Brian Coleman,"['Kenya', 'Belgium']",Artist,1872,0,76,1872
Tonya Armstrong,"['Sudan', 'Latvia']",Artist,1922,16,21,1938
Mr. Darryl Sanders,"['China', 'Guinea']",Artist,1911,31,84,1942
Mariah Boyd,['Pitcairn Islands'],Artist,1898,82,18,1980
Alison Young,"['Swaziland', 'Ghana']",Politician,1908,53,35,1961
Michael Anthony,['Papua New Guinea'],Artist,1918,46,51,1964
Matthew Estrada,"['Chile', 'Pitcairn Islands']",Artist,1877,45,74,1922
James Johnson,['Montserrat'],Politician,1919,15,9,1934
Jessica Orr,['Guinea-Bissau'],Monarch,1909,2,13,1911
Jason Strickland,['Ethiopia'],Torturer,1880,78,18,1958
Clinton Moore,"['Cuba', 'Egypt']",Artist,1872,69,16,1941
Brittany Foster,"['Cape Verde', 'North Macedonia']",Politician,1875,13,76,1888
Justin Singleton,"['Netherlands', 'Belarus']",Politician,1910,39,89,1949
David Barrera,"['Faroe Islands', 'Martinique']",Artist,1899,88,85,1987
Derrick Ward,['Colombia'],Comedian; stand-up comedian,1918,69,56,1987
Tina White,['Philippines'],Politician,1879,58,41,1937
Rachel Mayer,"['Monaco', 'Netherlands']",Politician,1891,33,39,1924
Nicole Miller,"['Mexico', 'Angola']",Artist,1903,49,48,1952
Christy Hall,"['Kiribati', 'Ukraine']",Artist,1918,46,75,1964
Judith Wilson,['Paraguay'],Artist,1899,0,43,1899
Dylan Lowe,"['El Salvador', 'Lebanon']",Artist,1873,52,42,1925
Evan French,"['Niger', 'French Southern Territories']",Artist,1896,31,89,1927
Anthony Parks,"['Luxembourg', 'Mauritania']",Sovereign,1900,27,17,1927
Joseph Gentry,['Algeria'],Artist,1890,44,3,1934
Maria Boone,['Croatia'],Artist,1919,44,15,1963
Joshua Mueller,"['Tuvalu', 'Anguilla']",Artist,1885,0,57,1885
Matthew Mcknight,"['Australia', 'Italy']",Researcher,1924,59,82,1983
Sonia Ortiz,['Sri Lanka'],Teacher,1904,1,65,1905
Angela Richards,['Niue'],Racing automobile driver; formula one driver,1887,37,87,1924
Matthew Miller,"['Antigua and Barbuda', 'Thailand']",Entrepreneur,1915,56,51,1971
Diamond Smith,['Heard Island and McDonald Islands'],Artist,1913,47,26,1960
Grace Edwards,['Argentina'],Athlete,1920,63,40,1983
Tamara Campbell,"['Syrian Arab Republic', 'Taiwan']",Artist,1904,31,79,1935
Stephanie Carpenter,['Iraq'],Researcher,1914,20,38,1934
Drew Moore,"['Georgia', 'Niger']",Physician,1887,53,13,1940
Kathleen Morris,['Grenada'],Researcher,1871,87,45,1958
Glenn Rodriguez,['Denmark'],Politician,1908,11,80,1919
Carrie Rodriguez,"['Portugal', 'Hong Kong']",Artist,1882,76,41,1958
Erik Hensley,"['Jamaica', 'Pakistan']",Model,1909,41,31,1950
David Edwards,['Switzerland'],Cinematographer,1901,13,55,1914
Cory Harrison,['French Polynesia'],Artist,1871,11,82,1882
Mrs. Elizabeth Higgins,['Moldova'],Nurse; torturer; concentration camp guard,1891,15,11,1906
Steve Khan,"['Palestinian Territory', 'Trinidad and Tobago']",Artist,1911,45,38,1956
Melinda Johnson,"['Hong Kong', 'Gibraltar']",Artist,1894,36,86,1930
Joann Edwards,"['Timor-Leste', 'Seychelles']",Researcher,1882,9,3,1891
Jennifer Carr,"['Haiti', 'Sri Lanka']",Serial killer,1900,68,58,1968
Richard Pearson,"['Bhutan', 'Haiti']",Military personnel,1908,47,64,1955
Jimmy Hayes,"['Cayman Islands', 'Malaysia']",Public figure; civil rights advocate; human rights activist; autobiographer,1915,64,23,1979
Jonathan Cantrell,['Trinidad and Tobago'],Politician,1921,4,52,1925
Steven Terry,['Papua New Guinea'],Competitive diver,1916,47,23,1963
Dustin Harmon,['Yemen'],Artist,1919,44,26,1963
Nicole Black,"['Somalia', 'Niue']",Politician,1910,73,19,1983
Kyle Martinez,['Norway'],Engineer,1886,38,79,1924
Jennifer Robinson,['Malaysia'],Artist,1894,87,38,1981
Devin Brooks,"['Moldova', 'Congo']",Athlete,1879,68,55,1947
Gregory King,"['Cambodia', 'Vietnam']",Artist,1882,14,78,1896
Jacqueline Palmer,['North Macedonia'],Artist,1918,73,76,1991
Ivan Cunningham,['Jamaica'],Artist,1899,89,20,1988
Cynthia Suarez,"['Greenland', 'Denmark']",Politician,1906,54,48,1960
Courtney Hart,"['Faroe Islands', 'Greece']",Politician,1898,61,16,1959
Joanna Aguirre,"['Saint Barthelemy', 'Swaziland']",Politician,1922,19,56,1941
Anthony Williams,"['Palau', 'Pitcairn Islands']",Author; television producer; television presenter; chef; autobiographer,1902,78,35,1980
Sarah Mckinney,"['Tajikistan', 'Tanzania']",Artist,1893,85,68,1978
Michael Sutton,"['Tanzania', 'Morocco']",Artist,1909,17,44,1926
Michael Phillips,['Norway'],Entrepreneur,1876,36,87,1912
William Russo,['Mauritania'],Coxswain,1901,24,73,1925
David Williams,['Montenegro'],Politician,1888,48,4,1936
John Solis,"['Holy See (Vatican City State)', 'Turkey']",Businessperson,1871,13,11,1884
Matthew Hughes,['Mayotte'],Athlete,1919,37,11,1956
Marie Medina,['Heard Island and McDonald Islands'],Artist,1880,70,83,1950
Matthew Hernandez,"['Northern Mariana Islands', 'Bahamas']",Artist,1872,4,53,1876
Ashley Lee,"['Yemen', 'Saint Kitts and Nevis']",Manager; judoka; professional wrestler,1903,58,52,1961
Brandon Smith,['Korea'],Politician,1920,73,72,1993
Lee Villarreal,['Guyana'],Artist,1916,65,24,1981
Cassandra Miller,['Saint Pierre and Miquelon'],Nurse; social worker,1870,18,56,1888
Daniel Harris,"['Iran', 'Ireland']",Politician,1892,57,25,1949
Peter Wilson,['Suriname'],Politician,1897,36,27,1933
Christine Lopez,['New Zealand'],Politician,1897,87,9,1984
Thomas Rodriguez,"['Finland', 'Chad']",Military personnel,1877,38,25,1915
Tyler Jordan,"['Faroe Islands', 'Guernsey']",Artist,1895,9,59,1904
Thomas Tucker,"['Heard Island and McDonald Islands', 'Timor-Leste']",Artist,1914,67,17,1981
Kevin Smith,['Finland'],Military personnel,1898,85,73,1983
Brad Morris,['Saint Martin'],Artist,1901,23,8,1924
Eric Gibbs,['Congo'],Architect,1914,32,80,1946
William Santos,"['Albania', 'Indonesia']",Artist,1924,40,47,1964
Sarah Mcintosh,"['Macao', 'Cocos (Keeling) Islands']",Artist,1909,64,45,1973
Brandon Cook,"['Montenegro', 'Chad']",Paleontologist,1872,43,50,1915
Rebecca Camacho,['Isle of Man'],Politician,1921,80,25,2001
Robert Smith,['Congo'],Researcher,1887,63,84,1950
Samantha Harris,"['Nigeria', 'Anguilla']",Artist,1881,33,74,1914
Anna Ortega,['Puerto Rico'],Researcher,1900,12,25,1912
Elizabeth Fernandez DDS,"['Falkland Islands (Malvinas)', 'Monaco']",Artist,1894,21,11,1915
Brady Allen,['Paraguay'],Artist,1879,44,50,1923
Rebecca Harrington,['Costa Rica'],Politician,1893,7,75,1900
Fred Long,"['Dominican Republic', 'Czech Republic']",Artist,1884,58,55,1942
David Nguyen,['Uruguay'],Politician,1924,32,59,1956
Dr. Karla Thomas,['Algeria'],Military personnel,1887,9,9,1896
Courtney Roberts,['Italy'],Artist,1905,8,61,1913
Sarah Stone,['Greenland'],Politician,1923,61,46,1984
Vickie Cooper,"['Norway', 'Jordan']",Researcher,1918,56,61,1974
Donna Smith,"['United States Virgin Islands', 'Mali']",Artist,1880,44,56,1924
Katrina Peck,['Bermuda'],Artist,1886,77,81,1963
Melissa White,['Holy See (Vatican City State)'],Artist,1871,18,58,1889
Nicole Williams,['Bahamas'],Artist,1882,47,35,1929
James Humphrey,"['Estonia', 'Maldives']",Researcher,1900,35,22,1935
Shelby Hernandez,"['Benin', 'Congo']",Physician,1915,86,32,2001
Melanie Salazar,"['Barbados', 'Micronesia']",Military personnel,1877,67,64,1944
Daisy Singh,['Guinea-Bissau'],Politician,1873,79,38,1952
Alexandria Weber,['Micronesia'],Researcher,1873,76,71,1949
Alexandra Bishop,"['Greenland', 'Maldives']",Artist,1891,27,42,1918
Amanda Hill,"['Saint Kitts and Nevis', 'Mozambique']",Artist,1905,26,58,1931
Courtney Phillips,['Thailand'],Artist,1875,73,26,1948
Jose Gray,"['Jersey', 'Jamaica']",Artist,1886,29,77,1915
Ryan Campbell,"['Greece', 'Guernsey']",Researcher,1885,61,65,1946
Elizabeth Simpson,['Andorra'],Artist,1887,20,48,1907
Christopher Davis,['Netherlands'],Athlete,1913,83,75,1996
Ryan Vargas,['Mauritania'],Artist,1906,25,28,1931
Ashley Conner,['France'],Artist,1888,62,45,1950
Luis Moss,['Sierra Leone'],Artist,1875,77,0,1952
Troy Snyder,"['Guinea-Bissau', 'Zambia']",Astronomer,1880,46,5,1926
Alexis Gallegos,['British Indian Ocean Territory (Chagos Archipelago)'],Athlete,1893,47,82,1940
Jennifer Armstrong,"['Niue', 'Montenegro']",Artist,1892,2,41,1894
Holly Rose,"['China', 'Marshall Islands']",Researcher,1908,56,75,1964
Jennifer Roth,['Aruba'],Politician,1917,33,70,1950
Jessica Montgomery,['Gabon'],Artist,1873,30,23,1903
Mr. Adam Griffith DDS,"['Congo', 'Heard Island and McDonald Islands']",Artist,1918,74,76,1992
Christopher Estrada,['Marshall Islands'],Artist,1917,64,35,1981
Jennifer Willis,"['Sierra Leone', 'Bouvet Island (Bouvetoya)']",Athlete,1870,9,14,1879
Mr. Donald Nunez,"['Guinea', 'Montserrat']",Athlete,1911,38,83,1949
Scott Torres,['Uganda'],Artist,1905,53,46,1958
Jennifer Hebert,"[""Cote d'Ivoire""]",Military personnel,1900,46,9,1946
Paul Schultz,"['Philippines', 'Bermuda']",Explorer,1871,9,50,1880
Catherine Rice,"['Nigeria', 'Yemen']",Military personnel,1878,62,35,1940
Jessica Smith,"['Reunion', 'Poland']",Resistance fighter,1914,56,73,1970
Joanne Mcdonald,['Comoros'],Politician,1882,82,38,1964
Nathan Bradley,['United States Virgin Islands'],Executioner,1873,81,12,1954
Richard Gardner,"['American Samoa', 'Algeria']",Artist,1919,55,1,1974
James Russell,"['Bhutan', 'Sweden']",Politician,1916,11,79,1927
Laura Ochoa,['Papua New Guinea'],Artist,1887,25,84,1912
Laura Kidd,"['Montserrat', 'Mexico']",Artist,1907,54,53,1961
William Macdonald,['Nicaragua'],Athlete,1911,19,70,1930
Anna Howell,['India'],Politician,1908,29,77,1937
Nicholas Martinez,['Zambia'],Artist,1890,86,50,1976
William Patel,"['Thailand', 'Antigua and Barbuda']",Teacher,1875,33,23,1908
Sharon Moreno,"['Georgia', 'Portugal']",Artist,1907,52,65,1959
Catherine Heath,['Iraq'],Artist,1891,67,53,1958
Patrick Miller,['Austria'],Businessperson,1896,63,79,1959
Karen Phillips,"['Qatar', 'South Georgia and the South Sandwich Islands']",Researcher,1897,7,85,1904
Terry Miller,['Tajikistan'],Artist,1914,66,62,1980
Destiny Clark,['Isle of Man'],Artist,1879,42,38,1921
Maria Morris,['Costa Rica'],Artist,1908,10,67,1918
Andrea Johnson,"['Antarctica (the territory South of 60 deg S)', 'Tuvalu']",Gangster,1889,47,40,1936
Stephanie Duran,"['Niue', 'Nicaragua']",Athlete,1900,77,57,1977
David Williams,['Poland'],Artist,1921,22,19,1943
Meghan Alvarado,"['Western Sahara', 'Portugal']",Physician,1896,60,26,1956
Yolanda Roberts,['British Virgin Islands'],Artist,1913,38,27,1951
William Cortez,"['Trinidad and Tobago', 'Algeria']",Artist,1879,50,54,1929
Raymond Jenkins Jr.,"['Guinea-Bissau', 'Finland']",Artist,1879,80,86,1959
Glen Griffin,['Kyrgyz Republic'],Artist,1899,17,18,1916
Dr. Taylor Beck,"['Reunion', 'Uzbekistan']",Artist,1878,25,5,1903
Jessica Parsons,"['Western Sahara', 'Bangladesh']",Artist,1916,89,76,2005
Brandon Andrade,['Montserrat'],Politician,1899,38,59,1937
Trevor Jensen,"['Turkey', 'Papua New Guinea']",Military personnel,1904,56,56,1960
Gordon Walton,['Ukraine'],Religious figure,1913,61,29,1974
Natalie Perez,"['Micronesia', 'Falkland Islands (Malvinas)']",Politician,1914,6,25,1920
Samantha Bass,['Czech Republic'],Artist,1883,8,47,1891
Joe Cox,"['Andorra', 'Vanuatu']",Artist,1911,29,33,1940
Robert Cooper,"['Togo', 'Suriname']",Politician,1875,72,56,1947
Alicia Williams,['Greenland'],Researcher,1887,45,8,1932
Brooke Stone,['Macao'],Politician,1907,31,50,1938
Jacqueline Taylor,['Afghanistan'],Artist,1924,71,36,1995
Judy Rivera,['Afghanistan'],Manual worker; anarchist,1913,21,15,1934
Travis Soto,['Macao'],Artist,1899,42,15,1941
Rebecca Hill,['Seychelles'],Military personnel,1889,48,73,1937
Rhonda Matthews,"['Rwanda', 'Nigeria']",Artist,1913,34,6,1947
Max Hernandez,"['Swaziland', 'Papua New Guinea']",Weightlifter,1905,27,22,1932
Paul Soto,"['Lesotho', 'Jamaica']",Politician,1889,62,25,1951
David Blevins,['Italy'],Artist,1919,66,49,1985
Debra Montgomery,['Saint Pierre and Miquelon'],Artist,1884,40,12,1924
Tina Daniels MD,"['Comoros', 'Somalia']",Artist,1882,32,47,1914
Bryan Webster,"['Switzerland', 'Gambia']",Politician,1906,53,78,1959
Jeffery Valdez,['Bermuda'],Athlete,1910,85,61,1995
Samantha Carpenter,"['Central African Republic', 'Puerto Rico']",Artist,1887,81,10,1968
Raymond Abbott,"['Grenada', 'Cambodia']",Athlete,1909,53,62,1962
Joseph Livingston,['Austria'],Researcher,1896,82,3,1978
Ashley Pena,"['Micronesia', 'Sierra Leone']",Artist,1873,59,47,1932
Mark Ramos,"['Burundi', 'Colombia']",Artist,1894,76,37,1970
Haley House,['Falkland Islands (Malvinas)'],Artist,1882,12,26,1894
James Fisher,['Madagascar'],Artist,1915,12,37,1927
Kayla Brown,['Congo'],Psychiatrist; psychoanalyst,1871,37,75,1908
Joseph Phillips,['Macao'],Politician,1918,48,43,1966
Joel Moreno,"['Seychelles', 'Romania']",Artist,1886,61,85,1947
Brianna Snow,['Guinea'],Military personnel,1910,75,64,1985
Jacob Bean,['Togo'],Researcher,1918,25,35,1943
Dr. Michael Rasmussen,"['Bulgaria', 'Jersey']",Artist,1892,52,64,1944
Jeffrey White,"['Romania', 'Afghanistan']",Athlete,1891,61,21,1952
Danielle Bates,"['New Zealand', 'Luxembourg']",Assessor,1918,62,54,1980
Matthew Barber,['Slovakia (Slovak Republic)'],Artist,1922,15,74,1937
Kristina Bennett,['Sierra Leone'],Artist,1908,70,44,1978
Felicia Ware,"['Peru', 'Wallis and Futuna']",Military personnel,1885,14,50,1899
Jeffrey Marshall,['Wallis and Futuna'],Politician,1905,83,68,1988
Brianna Gomez,"['Sweden', 'Slovakia (Slovak Republic)']",Engineer,1903,57,69,1960
Victoria Williams,"['Reunion', 'Philippines']",Artist,1887,24,46,1911
Carmen Martin,['New Caledonia'],Politician,1879,61,5,1940
Jerry Wright,"['Denmark', 'South Georgia and the South Sandwich Islands']",Artist,1892,24,66,1916
Brian Herrera,"['Italy', 'Saint Barthelemy']",Artist,1894,0,9,1894
Emily Jacobs,"['Albania', 'Malaysia']",Politician,1913,50,60,1963
Martin Perez,"['Somalia', 'El Salvador']",Artist,1912,21,79,1933
Rebecca Cooper,['Ecuador'],Politician,1924,69,26,1993
Casey Pierce,"['Heard Island and McDonald Islands', 'Rwanda']",Artist,1881,34,87,1915
Stephanie Saunders,['Swaziland'],Artist,1896,84,8,1980
Matthew Pitts,"['Sweden', 'Norway']",Artist,1917,6,14,1923
Tina Odonnell,['Taiwan'],Artist,1905,52,0,1957
Andrew Moore,['Taiwan'],Amateur wrestler,1882,8,55,1890
Daniel French,"['Tuvalu', 'Central African Republic']",Athlete,1886,83,81,1969
Kathy Watson,['Slovenia'],Artist,1904,60,13,1964
Anthony Mayer,"['Mozambique', 'Eritrea']",Journalist,1873,56,33,1929
Nicole Nielsen,"['Vietnam', 'Syrian Arab Republic']",Military personnel,1901,15,57,1916
Jason Wheeler,['Nigeria'],Artist,1895,49,51,1944
John Blackwell,['Andorra'],Artist,1877,54,49,1931
Ronald Suarez,['Bahrain'],Athlete,1892,62,60,1954
Erik Swanson,['Kiribati'],Journalist,1906,88,12,1994
David Rivera,"['Japan', 'Samoa']",Military personnel,1878,26,33,1904
Kimberly Chaney,['Kenya'],Scenographer,1874,45,66,1919
Kenneth Martin,"['Kenya', 'Seychelles']",Researcher,1898,44,52,1942
Caleb Gillespie,['Montenegro'],Artist,1912,87,61,1999
Suzanne Underwood,['Azerbaijan'],Artist,1923,67,0,1990
Erica Bowers,['Turks and Caicos Islands'],Athlete,1912,52,35,1964
Jessica Stafford,"['Paraguay', 'Switzerland']",Regent,1884,23,40,1907
Ashley Joyce,"['Montserrat', 'Turks and Caicos Islands']",Artist,1888,37,46,1925
Mrs. Cynthia Peterson,"['Bahamas', 'Oman']",Artist,1887,6,41,1893
Gregory Reid,"['Montserrat', 'Poland']",Artist,1907,82,85,1989
Veronica Cortez,['Holy See (Vatican City State)'],Military personnel,1884,32,48,1916
Elizabeth Mathis,['Reunion'],Businessperson,1920,88,71,2008
Dorothy Brown,"['Iraq', 'Turkey']",Artist,1878,46,54,1924
Jessica Jackson,['Azerbaijan'],Artist,1901,17,68,1918
Crystal Cook,"['Nicaragua', ""Lao People's Democratic Republic""]",Artist,1908,56,64,1964
Rose Hays,"['Latvia', 'Belgium']",Artist,1910,18,57,1928
Stephanie Evans,['Bouvet Island (Bouvetoya)'],Politician,1870,4,87,1874
Patricia Watkins,"['Iraq', 'Korea']",Disc jockey,1879,88,55,1967
Robert Moore,"['Lithuania', 'Venezuela']",Artist,1870,12,27,1882
Barbara Jackson PhD,"['Liechtenstein', 'Namibia']",Politician,1888,31,88,1919
Nancy Travis,"['Fiji', 'Tonga']",Politician,1888,20,10,1908
Tiffany Young,['Lesotho'],Serial killer,1916,30,7,1946
John Hanson,['Greece'],Politician,1879,13,76,1892
Kristen Cain,"['Algeria', 'Qatar']",Artist,1899,89,74,1988
Erica Bridges,"['Taiwan', 'Iraq']",Politician,1886,24,16,1910
Johnathan Mack,['Haiti'],Engineer,1908,48,37,1956
Jason Patrick,['Cayman Islands'],Politician,1895,62,19,1957
Michelle Jones,['Eritrea'],Businessperson,1904,11,42,1915
Kathleen Jackson,['Belgium'],Artist,1894,45,12,1939
Teresa Reyes,['French Guiana'],Politician,1895,7,71,1902
Roger Rivera,['Cuba'],Artist,1886,49,42,1935
Angela Schwartz,['Antigua and Barbuda'],Politician,1906,12,26,1918
Kimberly Espinoza,['Yemen'],Artist,1913,29,15,1942
Tonya Tucker,['France'],Artist,1879,20,74,1899
Sherry Hoffman,['Tunisia'],Researcher,1922,66,30,1988
Mark Brooks,"['Puerto Rico', 'Korea']",Artist,1884,32,65,1916
Jessica Wise,"['Czech Republic', 'Sri Lanka']",Artist,1912,24,3,1936
Sarah Jones,"['Seychelles', 'Kiribati']",Military personnel,1901,48,43,1949
Megan Pittman,['Reunion'],Artist,1914,50,1,1964
Elizabeth Harvey,"['Bahamas', 'Saint Lucia']",Artist,1894,63,42,1957
Nicholas Hall,"['Palestinian Territory', 'Bahamas']",Artist,1916,14,37,1930
Andrew Galvan,['South Georgia and the South Sandwich Islands'],Artist,1899,13,49,1912
Stephen Wagner,"['Latvia', 'Paraguay']",Entrepreneur,1882,75,28,1957
Bradley Campos,['Reunion'],Artist,1879,29,69,1908
Latoya Krause,"['Liberia', 'Turkmenistan']",Artist,1903,85,1,1988
Daniel Lopez,"['Papua New Guinea', 'Netherlands Antilles']",Military personnel,1895,10,43,1905
Joshua Garcia,['Comoros'],Artist,1879,89,72,1968
Tiffany Becker,['Kenya'],Military personnel,1907,23,46,1930
Jesse Mendoza,['Dominican Republic'],Artist,1899,43,29,1942
Jacob Sullivan,"['Mauritius', 'Fiji']",Artist,1906,20,66,1926
David Jackson,"['Philippines', 'Reunion']",Artist,1875,49,37,1924
Lisa Mathis,"['Norfolk Island', 'Kenya']",Artist,1916,63,21,1979
Jamie Rivera,"['Lithuania', 'Western Sahara']",Artist,1920,23,10,1943
Maxwell Avila,['Finland'],Artist,1911,51,77,1962
Melissa Frederick,['Falkland Islands (Malvinas)'],Politician,1915,42,86,1957
Robert Jones,['Sao Tome and Principe'],Politician,1875,60,9,1935
Michael Brown,"['Dominican Republic', 'Kenya']",Artist,1876,54,75,1930
Debra Pope,"['Latvia', 'Georgia']",Sovereign,1915,55,58,1970
Kenneth Nelson,"['Mozambique', 'Tanzania']",Politician,1915,89,26,2004
Melissa Santana,"['Tonga', 'Tuvalu']",Athlete,1912,89,70,2001
Ryan Shields,"['Vanuatu', 'Zambia']",Politician,1873,16,54,1889
Christopher Schroeder,"['Bermuda', 'Brazil']",Artist,1901,69,19,1970
Rose Rodriguez,"['Lesotho', 'Bosnia and Herzegovina']",Artist,1877,41,53,1918
Erica Thompson,['Venezuela'],Researcher,1898,18,43,1916
Kimberly Finley,['Puerto Rico'],Artist,1912,13,4,1925
Anthony Wright,['Grenada'],Researcher,1880,82,59,1962
Megan Wilkins,['Greenland'],Athlete,1911,56,87,1967
Kevin Shaw,['Cayman Islands'],Parson,1891,19,5,1910
Victoria Lee,"['Trinidad and Tobago', 'Wallis and Futuna']",Athlete,1897,78,71,1975
Jeffrey Harris,"['Fiji', 'Argentina']",Artist,1872,13,89,1885
Elizabeth Tyler,['Nepal'],Artist,1876,32,45,1908
Vanessa Hill,"['Gabon', 'Thailand']",Politician,1923,82,40,2005
Monica Miller,"['Denmark', 'Sweden']",Politician,1922,3,79,1925
Benjamin Singh,"['Afghanistan', 'Malaysia']",Costume designer; fashion designer,1875,57,4,1932
Jerry French,['Croatia'],Artist,1919,23,84,1942
Robert Rogers,"['Cyprus', 'Uruguay']",Artist,1901,60,41,1961
Marie Weiss,"['Antigua and Barbuda', 'Switzerland']",Researcher,1908,5,40,1913
David Cross,"['Dominican Republic', 'Seychelles']",Politician,1882,71,31,1953
Erin Vasquez,['Israel'],Artist,1924,24,78,1948
Stephanie Roberts,"['Botswana', 'Montserrat']",Artist,1914,5,34,1919
Amanda Rose,['French Guiana'],Researcher,1905,4,55,1909
Alexis Nichols,"['Niger', 'India']",Military personnel,1890,20,84,1910
Amanda Lambert,"['Russian Federation', 'United States Minor Outlying Islands']",Religious figure,1886,53,43,1939
James Palmer,"['Saint Vincent and the Grenadines', 'Zambia']",Artist,1896,51,14,1947
Aaron Hamilton,['Syrian Arab Republic'],Artist,1893,51,88,1944
Krystal Gibson,['Russian Federation'],Physician,1876,63,34,1939
Tyrone Campbell,"['Monaco', 'Nepal']",Military personnel,1894,35,14,1929
Michael Lee,['Nepal'],Researcher,1917,47,28,1964
Corey Reeves,"['United Kingdom', 'Panama']",Politician,1922,3,74,1925
Jessica Lopez,['Azerbaijan'],Athlete,1919,38,11,1957
Ashley Scott,['China'],Politician,1898,65,5,1963
Jennifer Caldwell,['Cambodia'],Artist,1906,1,13,1907
John Spencer,['Morocco'],Artist,1902,77,5,1979
Stephanie Mueller,['Taiwan'],Artist,1878,82,55,1960
Tonya Jones,"['Madagascar', 'United States Minor Outlying Islands']",Politician,1894,79,33,1973
Dawn Stuart,['Dominican Republic'],Artist,1921,14,2,1935
Stacey Gregory,['Tanzania'],Guitarist,1875,26,51,1901
Haley Crawford,"[""Cote d'Ivoire"", 'Germany']",Artist,1886,54,19,1940
Cynthia Ball,"['Czech Republic', 'Hungary']",Artist,1885,21,50,1906
Danielle Ortiz,"['Zambia', 'Holy See (Vatican City State)']",Artist,1892,4,18,1896
Vanessa Scott,['Syrian Arab Republic'],Artist,1902,18,73,1920
Barbara Hurst,['Austria'],Artist,1913,30,22,1943
Michael Mueller,['Germany'],Military personnel,1884,56,54,1940
Lori Rojas,['British Virgin Islands'],Artist,1873,10,70,1883
Brandon Chavez,"['San Marino', 'United States of America']",Military personnel,1885,78,70,1963
James Schultz,"['Bermuda', 'Bahrain']",Politician,1923,70,61,1993
Victor Vazquez,['Mongolia'],Artist,1921,87,14,2008
Daniel Spencer,"['Djibouti', 'Maldives']",Artist,1872,42,89,1914
Heather Martinez,"['Canada', 'Ukraine']",Artist,1900,48,50,1948
Tyler Dean,['Cayman Islands'],Artist,1906,59,80,1965
Carmen Welch,"['Guadeloupe', 'Mali']",Artist,1882,2,27,1884
John Garcia,['Serbia'],Artist,1903,47,31,1950
Meredith Rocha,['Egypt'],Samurai,1890,2,47,1892
Mandy White,['Jersey'],Serial killer; criminal,1924,40,82,1964
Jonathan Skinner,"['Liberia', 'Tonga']",Researcher,1880,32,76,1912
Angela Rojas,"['Saint Helena', 'Kiribati']",Artist,1911,61,79,1972
Samantha Pennington,"['Kuwait', 'Philippines']",Artist,1873,70,9,1943
Brian Smith,['Italy'],Entrepreneur,1910,20,36,1930
Miss Crystal Bell MD,"['Italy', 'Monaco']",Military personnel,1892,63,9,1955
Taylor Howard,['Uzbekistan'],Artist,1922,7,88,1929
Steven Duran,['Aruba'],Athlete,1901,52,0,1953
Anthony Robertson,"['Gabon', 'Norway']",Military personnel,1902,44,77,1946
Yvette George,"['United States Virgin Islands', 'Finland']",Politician,1870,83,57,1953
William Smith,['Guadeloupe'],Politician,1919,13,47,1932
Kelsey Hunt,['Liberia'],Artist,1894,12,70,1906
Michael Nguyen,['Svalbard & Jan Mayen Islands'],Military personnel,1874,46,52,1920
Stacie Bennett,['Saudi Arabia'],Artist,1902,3,76,1905
Johnny Davies,"['Andorra', 'Zimbabwe']",Sovereign,1920,46,31,1966
Megan Barry,['Korea'],Politician,1895,87,80,1982
Sean Caldwell,['Liberia'],Athlete,1918,38,18,1956
Angela Reed,"['Angola', 'Malaysia']",Artist,1899,1,73,1900
Nathan Johnson,"['Serbia', 'Benin']",Athlete,1914,83,29,1997
James Wise,"['British Virgin Islands', 'Nepal']",Researcher,1891,68,52,1959
Dr. Sharon Neal,['Andorra'],Artist,1895,82,89,1977
Amber Hill,['Ethiopia'],Entrepreneur,1870,24,57,1894
Keith Miller,['India'],Weightlifter,1918,89,46,2007
Brent Gray,"['Syrian Arab Republic', 'Tuvalu']",Artist,1901,70,37,1971
Sara Bailey,['Pitcairn Islands'],Revolutionary,1883,24,66,1907
Alexis Washington,['Malawi'],Politician,1897,52,24,1949
Whitney Woodard,['Estonia'],Artist,1909,48,5,1957
Joshua Yoder,['Luxembourg'],Artist,1883,85,41,1968
Karla Hill,['Sao Tome and Principe'],Artist,1886,68,28,1954
Aaron Norris,"['Canada', 'Ukraine']",Athlete,1895,61,63,1956
Kristy Perry,['Madagascar'],Researcher,1895,29,51,1924
Heidi Snyder,"['Grenada', 'Trinidad and Tobago']",Artist,1887,32,57,1919
Joseph Whitaker,['Mauritania'],Politician,1894,28,50,1922
Charlotte Martinez,"['Lesotho', 'Cayman Islands']",Artist,1882,26,17,1908
Matthew Strong,"['French Southern Territories', 'Timor-Leste']",Researcher,1891,61,40,1952
Alexander Rosales,['Serbia'],Businessperson,1909,60,4,1969
Jessica Torres,"['French Guiana', 'Kuwait']",Conductor; choir director,1916,77,8,1993
Steven Mitchell,"['Slovenia', 'Isle of Man']",Artist,1909,79,34,1988
Lisa Jimenez,['Turks and Caicos Islands'],Artist,1899,84,1,1983
Troy Moore,['United States Virgin Islands'],Politician,1874,77,41,1951
April Matthews,['Norway'],Artist,1899,5,27,1904
Mrs. Kristi Wyatt,"['Kiribati', 'Qatar']",Artist,1886,71,14,1957
Bryan Miller,['Seychelles'],Philosopher,1874,46,61,1920
Jose Carroll,"['Swaziland', 'Isle of Man']",Mountaineer,1911,3,7,1914
Pamela Anderson,"['Burundi', 'Kiribati']",Politician,1902,84,88,1986
Manuel Smith,"['Kyrgyz Republic', 'Saint Kitts and Nevis']",Athlete,1897,7,75,1904
Colin Cruz,"['Nicaragua', 'Japan']",Psychiatrist; neurologist,1910,54,39,1964
Nicholas Jones,"['New Caledonia', 'Aruba']",Artist,1872,4,71,1876
Erika Levy,"['Antigua and Barbuda', 'Marshall Islands']",Politician,1888,39,23,1927
Alexandria Cervantes,['Uganda'],Politician,1887,45,8,1932
Heidi Barron,"['Bermuda', 'Malawi']",Artist,1909,23,84,1932
Zachary Davis,"['Honduras', 'Paraguay']",Engineer,1912,78,62,1990
Antonio Rowe,"['Italy', 'San Marino']",Artist,1893,52,32,1945
Joseph Chavez,['Congo'],Researcher,1887,81,85,1968
Michelle Schultz,"['Faroe Islands', 'Kyrgyz Republic']",Cinematographer,1895,55,36,1950
Stephen Daniels,['Chad'],Politician,1876,84,88,1960
Diana Brown,['Azerbaijan'],Designer; car designer,1883,34,73,1917
Erin Townsend,['Nigeria'],Politician,1907,3,68,1910
James Harris,['Angola'],Sociologist,1908,57,2,1965
Marvin Carpenter,['Tonga'],Artist,1915,51,5,1966
Victoria Ryan MD,['Heard Island and McDonald Islands'],Military personnel,1889,72,50,1961
Monica Mcintosh,"['Georgia', 'Hong Kong']",Artist,1874,46,73,1920
Shane Jensen,"['Mali', 'Kyrgyz Republic']",Artist,1917,27,58,1944
Lisa Santiago,['Yemen'],Politician,1901,35,32,1936
Amanda Carter,['Tokelau'],Politician,1894,36,66,1930
Joshua Norton,['Timor-Leste'],Athlete,1879,64,75,1943
Jordan Green,"['Bermuda', 'Philippines']",Religious figure,1914,0,47,1914
John Morrison,['Burkina Faso'],Teacher,1880,31,9,1911
Marvin Steele,"['Cocos (Keeling) Islands', 'Uzbekistan']",Artist,1875,44,7,1919
Daisy Price,"['Bangladesh', 'Romania']",Artist,1874,82,59,1956
Terrence Williams,['Mozambique'],Politician,1874,15,4,1889
Molly Gomez,['Paraguay'],Artist,1892,63,79,1955
John Padilla,['United States Minor Outlying Islands'],Physician,1890,74,21,1964
Nicole Graham,"['Heard Island and McDonald Islands', 'Sri Lanka']",Artist,1915,57,63,1972
Melissa Mclaughlin,"['Saint Pierre and Miquelon', 'Isle of Man']",Politician,1921,22,80,1943
Haley Kennedy MD,['Montserrat'],Artist,1921,39,52,1960
Sarah Thomas,['Nepal'],Athlete,1871,60,85,1931
Jeffrey Sanchez,"['Cambodia', 'Syrian Arab Republic']",Artist,1884,57,75,1941
Jose Patterson,"['Fiji', 'Nauru']",Politician,1881,70,52,1951
Martin Wagner,['Netherlands'],Artist,1885,77,23,1962
Sheila Schroeder MD,"['Bouvet Island (Bouvetoya)', 'New Zealand']",Military personnel,1899,65,66,1964
Jessica Barajas,"['Guam', 'Lebanon']",Artist,1880,50,6,1930
Mary Mueller,"['Saint Barthelemy', 'Guadeloupe']",Artist,1922,14,25,1936
Kaitlin Buck,"[""Lao People's Democratic Republic"", 'Spain']",Artist,1918,53,45,1971
Allison Roman,"['Wallis and Futuna', 'Gambia']",Athlete,1876,13,80,1889
Barry Moore,"['Israel', 'United States Minor Outlying Islands']",Artist,1912,10,12,1922
Anne Smith,['French Polynesia'],Artist,1896,36,47,1932
Miguel Herrera,['Benin'],Artist,1883,38,86,1921
Carlos Barton,['Philippines'],Military personnel,1878,68,43,1946
Lee Cobb,"['Turkmenistan', 'Monaco']",Serial killer,1896,58,22,1954
Amber Diaz,"['Reunion', 'Albania']",Artist,1918,4,76,1922
James Dixon,"['Belgium', 'Sao Tome and Principe']",Politician,1913,72,59,1985
Michael Mendoza,"['Japan', 'Norway']",Religious figure,1914,23,43,1937
Brent Turner,['Zimbabwe'],Artist,1891,31,80,1922
Robert Huerta,['Uganda'],Religious figure,1874,47,44,1921
Benjamin Gutierrez,"['Algeria', 'Western Sahara']",Artist,1902,54,24,1956
Jessica Evans,"['United States Minor Outlying Islands', 'French Polynesia']",Artist,1909,36,18,1945
Patrick Hunt,"['Singapore', 'Palestinian Territory']",Military personnel,1874,63,28,1937
Paula Montoya,['Nicaragua'],Artist,1893,35,23,1928
Patricia Fisher,['Saint Pierre and Miquelon'],Artist,1873,53,82,1926
Cheryl Hall,"['Togo', 'Turkmenistan']",Politician,1923,76,38,1999
Justin Reynolds,['Belize'],Executioner,1901,53,33,1954
Mr. Joel Brady,"['Portugal', 'Niue']",Assessor,1885,70,40,1955
Jason Jones,['Gibraltar'],Artist,1902,13,83,1915
James Morrison,['Guyana'],Monarch,1895,37,47,1932
Lucas Mccullough,"['Norway', 'Equatorial Guinea']",Serial killer,1913,61,39,1974
Michael Chaney,"['Slovakia (Slovak Republic)', 'Cook Islands']",Politician,1921,15,23,1936
Linda Murphy,['Guinea-Bissau'],Artist,1911,73,24,1984
Kenneth Henderson,"['Cook Islands', 'Slovakia (Slovak Republic)']",Artist,1877,61,49,1938
Kimberly Sullivan,['Costa Rica'],Businessperson,1892,82,66,1974
Amanda Howard,"['Barbados', 'Guinea']",Researcher,1908,59,59,1967
James Cook,['Austria'],Criminal,1874,88,70,1962
Kevin Banks,['Costa Rica'],Artist,1922,79,8,2001
Thomas Gallagher,['Tanzania'],Politician,1889,35,11,1924
Ivan Dunn,"['Netherlands Antilles', 'Gibraltar']",Artist,1876,3,27,1879
Jessica Lewis,"['San Marino', 'Cocos (Keeling) Islands']",Politician,1876,49,41,1925
Dan Rojas,"['Niue', 'Somalia']",Politician,1876,27,16,1903
Ashlee Lin,['Eritrea'],Homekeeper,1891,15,61,1906
Aaron Stevens,"['South Georgia and the South Sandwich Islands', 'Slovakia (Slovak Republic)']",Artist,1873,26,32,1899
Donna Ryan,"['Saint Vincent and the Grenadines', 'Gambia']",Politician,1915,37,39,1952
Jeffery Kaiser,['Lebanon'],Artist,1889,48,13,1937
Kayla Sanchez,"['Holy See (Vatican City State)', 'Algeria']",Politician,1916,81,89,1997
Lauren Reid,['Belarus'],Artist,1876,88,54,1964
Dennis Barron,['Cape Verde'],Designer; car designer,1880,63,73,1943
Anthony Collins,['New Zealand'],Artist,1890,24,19,1914
Katherine Melendez,"['Swaziland', 'Chad']",Artist,1890,7,24,1897
Carlos Black,"['Niger', 'Bolivia']",Athlete,1897,54,62,1951
Kristen Johnson,"['Libyan Arab Jamahiriya', 'Myanmar']",Artist,1877,62,40,1939
James Sharp,"['Guatemala', 'Solomon Islands']",Athlete,1913,35,31,1948
Elaine Jimenez,['Faroe Islands'],Street vendor,1887,86,84,1973
Larry Cook PhD,"['Venezuela', 'Chile']",Politician,1894,87,10,1981
Amber Greene,['Timor-Leste'],Artist,1884,47,3,1931
James Martinez,"['Barbados', 'North Macedonia']",Politician,1923,18,7,1941
Samuel Wyatt,['Timor-Leste'],Artist,1913,62,2,1975
Jesse Reynolds,['South Georgia and the South Sandwich Islands'],Journalist,1920,68,44,1988
Briana Hawkins,"['Saint Martin', 'Haiti']",Artist,1873,3,5,1876
Michael Wagner,['Peru'],Artist,1898,84,48,1982
Julia Bennett,"['Saint Vincent and the Grenadines', 'Panama']",Military personnel,1870,1,43,1871
Mark Davis,"['Bolivia', 'Bosnia and Herzegovina']",Serial killer; prostitute,1921,4,29,1925
John Robinson,['Heard Island and McDonald Islands'],Researcher,1882,3,59,1885
Leslie Duke,['Central African Republic'],Stockbroker,1916,29,64,1945
Samuel Hensley,['Australia'],Teacher,1924,6,46,1930
Wendy Barrett,['Paraguay'],Politician,1881,54,64,1935
Daniel Evans,['United States Minor Outlying Islands'],Artist,1893,0,2,1893
Erika Church,"['Palau', 'Argentina']",Military personnel,1880,6,49,1886
Danielle Rasmussen,['Gambia'],Artist,1910,0,73,1910
Christine Moore,"['Tokelau', 'North Macedonia']",Religious figure,1887,5,69,1892
Bobby King,['Cambodia'],Artist,1919,40,22,1959
Edward Becker,"['South Georgia and the South Sandwich Islands', 'Qatar']",Artist,1913,5,19,1918
Wendy Meza PhD,"['Azerbaijan', 'French Southern Territories']",Artist,1911,50,50,1961
Brandy Bradley,['Equatorial Guinea'],Athlete,1905,40,72,1945
Julie Stone,"['Luxembourg', 'Hong Kong']",Military personnel,1908,68,54,1976
Karen Long,"['Saudi Arabia', 'Gambia']",Politician,1913,22,63,1935
Bradley Porter,"['Spain', 'Namibia']",Artist,1874,56,56,1930
Brad Robinson,['Holy See (Vatican City State)'],Artist,1897,82,45,1979
Michael Baxter,['Cook Islands'],Artist,1892,21,14,1913
Scott Hale,['Greenland'],Artist,1899,20,69,1919
Laura Oconnor,['British Virgin Islands'],Athlete,1881,65,42,1946
Lindsay Martin,['Switzerland'],Entrepreneur,1906,26,86,1932
Russell Lynn,"['Saint Helena', 'Turks and Caicos Islands']",Politician,1916,21,47,1937
Jared Adams,"['Martinique', 'Colombia']",Athlete,1873,72,83,1945
Dr. Sara Davis,"['Romania', 'China']",Artist,1876,29,72,1905
Robert Shaffer,['Niue'],Artist,1882,36,22,1918
Kenneth Perry,"['Sri Lanka', 'Faroe Islands']",Researcher,1919,28,50,1947
Jennifer Lewis,['Nicaragua'],Artist,1886,68,80,1954
Susan Meyer,['Sao Tome and Principe'],Religious figure,1895,61,69,1956
Timothy Clark,"['Puerto Rico', 'Mauritius']",Cinematographer,1906,67,86,1973
Courtney Nelson,['Nepal'],Athlete,1924,30,62,1954
Spencer Reynolds,['Poland'],Artist,1882,11,28,1893
Tanya Nelson,['Malawi'],Politician,1923,29,50,1952
Ronnie Taylor,"['Norfolk Island', 'Heard Island and McDonald Islands']",Politician,1870,88,17,1958
Kenneth Wright,"['Cook Islands', 'Martinique']",Artist,1908,25,13,1933
Christina Johnson,['Saint Vincent and the Grenadines'],Artist,1889,11,41,1900
Jose Ochoa,"['Svalbard & Jan Mayen Islands', 'Venezuela']",Politician,1888,52,77,1940
Miguel Blackwell,['Israel'],Military personnel,1884,21,74,1905
Robert Bailey,['Kazakhstan'],Military personnel,1884,21,38,1905
Kevin Hickman,['Congo'],Artist,1895,4,42,1899
Emily Simpson,"['Guadeloupe', 'Ghana']",Military personnel,1907,38,8,1945
Tristan Pugh,['Mayotte'],Researcher,1904,41,10,1945
Madison Figueroa,['Croatia'],Military personnel,1911,61,25,1972
Heather Brooks,"['Czech Republic', 'Turkey']",Artist,1903,45,51,1948
Kimberly Brown,"['Faroe Islands', 'Holy See (Vatican City State)']",Researcher,1871,8,4,1879
Kara Miller,['Guinea'],Artist,1879,63,12,1942
Lauren Dawson,"['Austria', 'Czech Republic']",Artist,1916,30,30,1946
Randy Baxter,"['Trinidad and Tobago', 'Cambodia']",Nun,1920,64,22,1984
Isabella Johnson,"['Myanmar', 'Algeria']",Artist,1872,58,12,1930
Richard Gonzalez,['Egypt'],Politician,1887,20,18,1907
Steven Gomez,"['Central African Republic', 'Panama']",Artist,1916,26,33,1942
Robin Edwards,['Singapore'],Military personnel,1904,33,56,1937
Michael Brock,['Wallis and Futuna'],Imam,1900,17,61,1917
Marcus Brown,['Austria'],Artist,1890,18,5,1908
Diane Scott,['Argentina'],Teacher,1900,82,59,1982
Michelle Peterson,['Austria'],Artist,1887,53,27,1940
Tristan Carter,"['India', 'Grenada']",Politician,1904,38,6,1942
Lisa Lawrence,['Kiribati'],Artist,1885,78,49,1963
Lori King DDS,"['Czech Republic', 'Guinea']",Artist,1894,36,13,1930
Samantha Curtis,"['Sao Tome and Principe', 'Western Sahara']",Classical philologist,1915,12,19,1927
Austin Williamson,['Kyrgyz Republic'],Politician,1917,32,50,1949
Laura Johnson,['Holy See (Vatican City State)'],Athlete,1885,22,52,1907
Antonio Bray,"['Benin', 'United States Virgin Islands']",Artist,1887,72,8,1959
Stephanie Robles,['Cape Verde'],Politician,1914,1,67,1915
Alexa Hill,['Saint Helena'],Politician,1896,80,19,1976
Stephanie Stewart,['Niger'],Artist,1912,75,63,1987
Jessica Morales,['Saint Vincent and the Grenadines'],Artist,1878,34,88,1912
Roberta Rose,"['Palestinian Territory', 'Seychelles']",Artist,1913,5,1,1918
Michelle Morgan,['Holy See (Vatican City State)'],Artist,1907,7,82,1914
Sandra Swanson,['Niue'],Artist,1900,17,15,1917
Stephanie Morrow,['Botswana'],Artist,1887,45,87,1932
Ashley Mathis,"['United Arab Emirates', 'Libyan Arab Jamahiriya']",Politician,1896,68,21,1964
Sue Martinez,"['Japan', 'French Guiana']",Politician,1901,11,68,1912
Jonathon Mcguire,"['Syrian Arab Republic', ""Lao People's Democratic Republic""]",Military personnel,1880,50,89,1930
Amanda Barr,"['Croatia', 'Sudan']",Artist,1879,50,40,1929
James Fitzgerald,"['Kuwait', 'Guinea']",Artist,1888,66,54,1954
Erik Hale,['Turks and Caicos Islands'],Military personnel,1881,65,29,1946
Jeffrey Lewis,"['Georgia', 'Guadeloupe']",Monarch,1912,59,76,1971
Katie Brown,['Brunei Darussalam'],Military personnel,1914,76,46,1990
Laura Howe,"['Italy', 'Zimbabwe']",Politician,1921,76,71,1997
Mrs. Tamara Walker,['Papua New Guinea'],Politician,1894,61,63,1955
Thomas Carlson,"['Namibia', 'Rwanda']",Artist,1896,85,9,1981
Justin Diaz,"['Uzbekistan', 'Burundi']",Artist,1888,65,56,1953
Joel Holmes,['Pitcairn Islands'],Record producer; personal assistant; talent manager; business executive; road manager,1870,71,34,1941
Chad Johnson,"['Congo', 'Saint Pierre and Miquelon']",Military personnel,1889,8,27,1897
Tom Patterson,"['Andorra', 'Saint Lucia']",Official,1886,77,46,1963
Chad Reese,['Norway'],Politician,1874,3,2,1877
Cheryl Wheeler,"['United States of America', 'Kiribati']",Researcher,1907,56,3,1963
Cody Bauer,['Gambia'],Artist,1916,11,19,1927
Clarence Baker,"['Seychelles', 'Guatemala']",Religious figure,1916,51,33,1967
Manuel Smith,"['Kuwait', 'Switzerland']",Artist,1881,35,81,1916
Katie Jones,['Somalia'],Athlete,1898,32,0,1930
Joshua Thompson,"['Monaco', 'Saudi Arabia']",Artist,1900,80,22,1980
Audrey Campbell,"['Bhutan', 'Rwanda']",Artist,1916,52,17,1968
Stacy Rivera,['Burundi'],Athlete,1919,59,47,1978
Zachary Howell,['Guinea-Bissau'],Artist,1911,1,20,1912
Pamela Hernandez,['Zimbabwe'],Politician,1901,30,6,1931
Randall Barnes,"['Niger', 'Kuwait']",Military personnel,1876,72,48,1948
Benjamin Howell,['Mongolia'],Artist,1873,15,56,1888
Sherry Baker,"['Czech Republic', 'Guernsey']",Athlete,1913,37,66,1950
Jennifer Ford,"['Korea', 'Poland']",Politician,1923,77,49,2000
Anthony Duran,['United States Virgin Islands'],Explorer,1873,32,14,1905
Robert Burns,['Lithuania'],Artist,1907,64,82,1971
Jennifer Mclaughlin,['Thailand'],Artist,1923,11,59,1934
Maurice Nguyen,['Macao'],Artist,1889,86,48,1975
Eric Lopez,"['Japan', 'Serbia']",Engineer,1907,36,84,1943
Laura Stone,"['Liechtenstein', 'Rwanda']",Researcher,1921,15,52,1936
Ronnie Allen,['Malta'],Artist,1889,41,9,1930
Curtis Banks,['France'],Politician,1873,11,8,1884
Christopher Miller,"['Italy', 'Puerto Rico']",Artist,1921,19,8,1940
Nicholas Williams,['Saint Helena'],Go professional,1896,62,6,1958
Tamara Wallace,"['Grenada', 'France']",Artist,1919,9,44,1928
Kenneth Reed,['Saint Pierre and Miquelon'],Artist,1911,50,25,1961
Rachel Cooper,['United States of America'],Politician,1894,86,72,1980
Amanda Allen,['Bahrain'],Artist,1884,19,76,1903
Lisa Jensen,['Tunisia'],Military personnel,1896,25,65,1921
Samuel Mckay,['Norfolk Island'],Politician,1920,85,72,2005
Shawn Jones,"['Reunion', 'Tokelau']",Politician,1881,23,68,1904
Jacob Shields,['Moldova'],Politician,1878,79,75,1957
Carol Dougherty,"['Morocco', 'Australia']",Torturer; concentration camp guard,1870,49,58,1919
Melissa Powers,"['Vietnam', 'Honduras']",Artist,1906,62,75,1968
Kevin Wright,['Kuwait'],Artist,1887,10,40,1897
David Schultz,"['Comoros', 'Montenegro']",Researcher,1924,41,50,1965
Victor Oconnell,"['Switzerland', 'Anguilla']",Artist,1913,79,12,1992
Jeremy Vega,"['Micronesia', 'Svalbard & Jan Mayen Islands']",Explorer,1907,23,63,1930
Paul Berry,"['Namibia', 'Anguilla']",Artist,1882,53,35,1935
John Adams,"['Mauritius', 'Northern Mariana Islands']",Athlete,1891,72,67,1963
David Jones,"['Greenland', 'Belize']",Military personnel,1879,39,87,1918
Dr. Nancy Martinez,['Bhutan'],Long-distance runner; middle-distance runner,1890,56,58,1946
David Rivera,"['Senegal', 'Botswana']",Politician,1894,21,14,1915
Danny Smith,"['Bolivia', 'South Georgia and the South Sandwich Islands']",Amateur wrestler,1880,22,56,1902
Dakota Murillo,"['Poland', 'Slovenia']",Artist,1916,16,12,1932
Leslie Osborne,"['Antarctica (the territory South of 60 deg S)', 'Norway']",Artist,1879,42,48,1921
Kara Long,['Lebanon'],Researcher,1893,65,57,1958
Lori Abbott,['American Samoa'],Artist,1872,67,51,1939
Kenneth Harrison,['United States of America'],Weightlifter,1887,62,61,1949
Pamela Compton,['French Guiana'],Artist,1892,47,87,1939
Ronald Yu,"['Uruguay', 'Lesotho']",Artist,1880,55,27,1935
John Hahn,"['Belgium', 'Kenya']",Artist,1924,60,79,1984
Erik Luna,['Italy'],Aristocrat,1877,37,67,1914
Christina Stevenson,"['Western Sahara', 'Jamaica']",Explorer,1877,71,79,1948
Mary Ortega,['Turkey'],Artist,1906,55,9,1961
Kathy Leon,"['Austria', 'Congo']",Artist,1898,70,30,1968
Anthony Larson,['Cyprus'],Artist,1906,11,80,1917
Jennifer Snow,['Guernsey'],Artist,1914,18,28,1932
John Cooley,['Zimbabwe'],Politician,1914,7,2,1921
Ronald Ponce,['Cyprus'],Artist,1890,44,73,1934
Zachary Wyatt,"['Uganda', 'Uganda']",Artist,1903,47,7,1950
Miss Lisa Cowan,['Croatia'],Researcher,1900,63,25,1963
Cynthia Doyle,"['Mongolia', 'Togo']",Artist,1918,54,19,1972
Carl Martin,"['Slovenia', 'Liberia']",Artist,1914,50,3,1964
Brandon Washington,['Pakistan'],Disc jockey,1891,60,2,1951
Jordan Berry,['Tuvalu'],Artist,1924,30,62,1954
Lee Jordan,"['Heard Island and McDonald Islands', 'Fiji']",Politician,1896,28,33,1924
Michael Williams,"['Iraq', 'Guinea-Bissau']",Researcher,1889,88,28,1977
Kevin Morris,"['Georgia', 'Lithuania']",Artist,1875,2,72,1877
Chase Gonzalez,['Germany'],Artist,1895,17,3,1912
Melinda Gonzalez,"['Suriname', 'Bermuda']",Artist,1903,77,27,1980
Pamela Stanton,"['Belarus', 'Martinique']",Researcher,1876,51,37,1927
Ryan Prince,"[""Cote d'Ivoire""]",Politician,1897,63,73,1960
Amanda Lopez,"['Bangladesh', 'Brunei Darussalam']",Politician,1921,19,63,1940
Cindy Thornton,['Colombia'],Artist,1894,53,21,1947
Elizabeth Mercado,"['Micronesia', 'Panama']",Politician,1921,16,7,1937
William Summers Jr.,['Eritrea'],Artist,1871,86,35,1957
Joshua Chapman,['Bermuda'],Artist,1872,85,44,1957
Cynthia Lewis,['Netherlands'],Artist,1924,83,20,2007
Nathaniel Reeves,['Hungary'],Psychiatrist; psychoanalyst,1915,43,41,1958
Christopher Meyer,['Sierra Leone'],Artist,1918,74,17,1992
Danny Lawson,"['Slovakia (Slovak Republic)', 'Reunion']",Religious figure,1896,18,81,1914
John Torres,"['Uzbekistan', 'Brazil']",Athlete,1888,4,56,1892
Michael Hudson,"['Sierra Leone', 'Monaco']",Politician,1919,35,60,1954
Lisa Gill,['Sri Lanka'],Artist,1888,17,1,1905
Tyler Richmond,"['Bolivia', 'Malta']",Artist,1903,18,27,1921
Peter Watson,"['Andorra', 'Slovakia (Slovak Republic)']",Engineer,1922,62,66,1984
Daniel Brown,['Barbados'],Artist,1916,4,81,1920
Rebecca Palmer,"['Egypt', 'Sao Tome and Principe']",Researcher,1900,23,10,1923
Paul Figueroa,['Falkland Islands (Malvinas)'],Artist,1877,88,61,1965
Nicholas Walker,['Benin'],Businessperson,1889,88,58,1977
Amy Reynolds,"['Suriname', 'Dominica']",Artist,1882,0,86,1882
Michael Keller,['Qatar'],Politician,1918,45,72,1963
Stephen Navarro,['Russian Federation'],Weightlifter,1886,84,62,1970
Mark Garza,"['Bouvet Island (Bouvetoya)', 'Philippines']",Artist,1909,34,65,1943
Gregory Brandt,['Brunei Darussalam'],Sovereign,1912,52,39,1964
Steven Manning,"['Estonia', 'Heard Island and McDonald Islands']",Journalist,1911,85,86,1996
Melissa Jenkins,['Niue'],Engineer,1914,35,48,1949
Gregory Park,"['Western Sahara', 'Turkmenistan']",Maid,1895,80,73,1975
Melissa Reynolds,['Haiti'],Professional wrestler,1893,50,71,1943
Randy Tucker,"['Saint Kitts and Nevis', 'Brazil']",Artist,1897,20,21,1917
Mark Watson,['Djibouti'],Athlete,1911,55,59,1966
Claire Evans,"['Tonga', 'Canada']",Artist,1920,0,31,1920
Alisha Price,['Ethiopia'],Samurai,1900,49,86,1949
David Perez,['Zimbabwe'],Military personnel,1887,67,80,1954
Karen Brown,['India'],Sprinter,1884,79,72,1963
Brenda Obrien,['Bulgaria'],Artist,1898,44,80,1942
Mrs. Ruth West,['Cape Verde'],Researcher,1924,18,34,1942
Nicole Bell,['Spain'],Politician,1881,56,44,1937
Kathryn Grant,"['Georgia', 'Tonga']",Politician,1909,60,77,1969
Benjamin Ross,['Poland'],Journalist,1910,42,82,1952
Eric Lewis,"['Burundi', 'North Macedonia']",Politician,1876,82,86,1958
Amanda Casey,"['Sao Tome and Principe', 'Tanzania']",Artist,1871,27,6,1898
Jay Bell,"['Paraguay', 'Colombia']",Artist,1898,81,44,1979
Sandra Vargas,['Singapore'],Artist,1885,72,14,1957
Elizabeth Schmidt,"['Guam', 'Nigeria']",Artist,1903,79,71,1982
Melissa Barr,['Estonia'],Artist,1875,71,54,1946
Stephen Contreras,"['Georgia', 'Guinea-Bissau']",Artist,1881,25,74,1906
Nancy Gray,['Solomon Islands'],Military personnel,1913,6,80,1919
Theresa Murray,"['Saint Vincent and the Grenadines', 'Morocco']",Artist,1922,2,45,1924
Lauren Rodriguez,['Australia'],Artist,1899,49,55,1948
Jacqueline Gilbert,"['Mayotte', 'Serbia']",Military personnel,1914,22,29,1936
Michael Mcdaniel,['Uruguay'],Artist,1888,86,41,1974
Charles Brown DVM,['Benin'],Politician,1896,34,70,1930
Crystal Johnson,"['Spain', 'British Virgin Islands']",Artist,1888,16,63,1904
Seth Davis,['Chad'],Politician,1915,40,33,1955
Kathryn Stewart,"['Ghana', 'Ecuador']",Politician,1874,8,22,1882
Joseph Montgomery,"['Timor-Leste', 'Gambia']",Politician,1898,89,78,1987
Victoria Robinson,['Serbia'],Artist,1902,36,1,1938
Denise Thomas,"['Canada', 'Bahamas']",Pasha,1923,44,52,1967
Jeffrey Rodriguez,['Barbados'],Artist,1878,31,77,1909
Nancy Wright,['Barbados'],Serial killer; criminal,1919,23,27,1942
Rhonda Lindsey,"['Seychelles', 'Mali']",Artist,1871,20,50,1891
Jesse Sharp,"['Myanmar', 'Poland']",Artist,1908,60,63,1968
Sarah Robinson,['Fiji'],Politician,1886,16,41,1902
Brittany Wilson,"['Mongolia', 'Ireland']",Artist,1912,53,21,1965
Greg Wagner,"['Eritrea', 'Tokelau']",Politician,1883,40,16,1923
Robert Jones,['Morocco'],Artist,1916,66,30,1982
Taylor Morgan,['Sierra Leone'],Artist,1891,26,5,1917
Peter Carr,['Chile'],Entrepreneur,1920,44,11,1964
Noah Love,"['Norway', 'Nauru']",Politician,1883,27,7,1910
Luke Jones,"['Sao Tome and Principe', 'Pakistan']",Artist,1877,77,28,1954
Brenda Gomez,['Tajikistan'],Politician,1894,53,8,1947
John Mcgee,['Switzerland'],Researcher,1899,61,1,1960
Adam Hart,['Saint Martin'],Artist,1897,24,82,1921
Sharon Cain,"['Macao', 'Lesotho']",Military personnel,1881,73,80,1954
Darin Jensen,['Estonia'],Researcher,1901,3,87,1904
Samuel Kelly,"['Mongolia', 'Niger']",Racing automobile driver; formula one driver,1885,73,49,1958
Andrew Williams,['Mauritius'],Artist,1886,49,47,1935
Charles Davis,['Wallis and Futuna'],Politician,1902,46,37,1948
Frank Horton,['Barbados'],Athlete,1920,50,86,1970
Tommy Steele,"['Somalia', 'Iran']",Businessperson,1887,28,85,1915
Pamela Taylor,"['Micronesia', 'Lithuania']",Athlete,1900,32,10,1932
Jesse Elliott,"['Svalbard & Jan Mayen Islands', 'Indonesia']",Athlete,1882,85,44,1967
Richard Morales,['Nicaragua'],Shogun,1920,37,11,1957
Theresa Quinn DDS,['Brazil'],Artist,1874,51,27,1925
Stephanie Evans,"['Ecuador', 'Taiwan']",Jurist,1896,69,74,1965
Katelyn Parker,['Dominican Republic'],Politician,1915,64,13,1979
Jennifer White,"['France', 'Bulgaria']",Politician,1888,42,46,1930
Christopher Alvarado,['Faroe Islands'],Monarch,1876,84,79,1960
Sara Lee,"['Ireland', 'Sierra Leone']",Artist,1916,35,87,1951
Jason Allen,['Saudi Arabia'],Politician,1919,38,5,1957
Lacey Thompson,['Jamaica'],Artist,1884,32,60,1916
David Harris,"['Uzbekistan', 'Antigua and Barbuda']",Artist,1923,22,3,1945
Stephen Norman,"['Colombia', 'Kyrgyz Republic']",Artist,1877,28,58,1905
Alexis Martinez,['Yemen'],Politician,1905,1,85,1906
Michael Campbell,['Turkmenistan'],Artist,1894,59,61,1953
Kelly Rice,"['Indonesia', 'French Guiana']",Artist,1881,12,42,1893
Stephanie Cook,"['Bouvet Island (Bouvetoya)', 'Senegal']",Artist,1915,59,77,1974
Sara Stephens,['Tuvalu'],Artist,1873,17,56,1890
Amy Holmes,['Senegal'],Athlete,1910,85,19,1995
Sean Kelly,"['Falkland Islands (Malvinas)', 'Bolivia']",Artist,1901,65,18,1966
Vincent Bailey,['Norway'],Aristocrat,1904,72,54,1976
Stephanie Greene,"['Liberia', 'Rwanda']",Athlete,1880,81,6,1961
Molly Ramirez,"['Egypt', 'Bolivia']",Athlete,1914,37,35,1951
Daniel Harrison,['Somalia'],Military personnel,1878,44,10,1922
Holly Ramirez,['Senegal'],Athlete,1892,80,30,1972
Lance Gonzalez,['Northern Mariana Islands'],Artist,1912,14,34,1926
Mallory Johnson,"['Mexico', 'United States Virgin Islands']",Artist,1899,32,69,1931
Natasha Brooks,"['Dominican Republic', 'Netherlands Antilles']",Artist,1904,1,2,1905
Jane Torres,['Gibraltar'],Politician,1871,24,73,1895
Michael Campbell,['Solomon Islands'],Artist,1881,62,58,1943
Dr. Daniel Davis,"['Saint Lucia', 'Lesotho']",Artist,1921,28,23,1949
Adam Hudson,['Thailand'],Researcher,1887,87,19,1974
Steven Leach,['San Marino'],Artist,1909,5,15,1914
Eric Lindsey,['British Virgin Islands'],Artist,1877,18,82,1895
Richard Harrington,['Guinea-Bissau'],Artist,1915,37,70,1952
Cassandra Atkins,['Lebanon'],Ruler,1877,41,28,1918
Dwayne Montes,"['Trinidad and Tobago', ""Lao People's Democratic Republic""]",Nun; social worker,1892,72,42,1964
Sarah Stewart,['Marshall Islands'],Magician,1884,1,3,1885
Jodi Alexander,['Albania'],Politician,1877,52,88,1929
Chris Brown,"['Serbia', 'Saudi Arabia']",Gangster; serial killer; criminal,1884,24,80,1908
Stephanie Higgins,"['Congo', 'New Caledonia']",Artist,1885,70,37,1955
Mark Estrada,"[""Lao People's Democratic Republic"", 'Gibraltar']",Athlete,1922,77,42,1999
Luke Pittman,['Djibouti'],Explorer,1874,53,32,1927
Cynthia Rodriguez,['Trinidad and Tobago'],Politician,1873,56,73,1929
James Powell,"['Niue', 'Hong Kong']",Artist,1905,89,23,1994
Laura Hampton,"['British Indian Ocean Territory (Chagos Archipelago)', 'Jordan']",Politician,1892,23,49,1915
Jeffrey Montoya,['Grenada'],Military personnel,1912,25,39,1937
Brenda Gonzalez,['Thailand'],Artist,1884,30,14,1914
Daniel Brown,['Liberia'],Politician,1904,0,4,1904
Christopher Richardson,['Seychelles'],Artist,1899,24,24,1923
Gregory Nguyen,"['Faroe Islands', 'Dominican Republic']",Politician,1875,86,78,1961
Patricia Graham,['Saint Martin'],Politician,1923,0,63,1923
Michael Evans,['Antarctica (the territory South of 60 deg S)'],Nun,1909,64,3,1973
Gerald Luna,"['Brunei Darussalam', 'Mayotte']",Artist,1876,8,89,1884
John Ramirez,['Aruba'],Politician,1890,20,43,1910
Denise Wright,['Yemen'],Athlete,1914,69,87,1983
Michael James,['Marshall Islands'],Artist,1884,76,42,1960
Emily Becker,['Greenland'],Aristocrat,1886,56,87,1942
Michael Tapia,"['Thailand', 'United States of America']",Artist,1874,14,63,1888
Nathan Gray,['Uganda'],Politician,1877,42,37,1919
Amber Donaldson,['Malta'],Artist,1900,30,81,1930
Samantha Jensen DDS,"['Djibouti', 'Belize']",Artist,1885,74,20,1959
Colleen Hoffman,"['Grenada', 'Cayman Islands']",Politician,1902,61,43,1963
Jeremy Moore,"['Falkland Islands (Malvinas)', 'Cuba']",Artist,1886,84,1,1970
Stacy Wang,['Antarctica (the territory South of 60 deg S)'],Politician,1907,14,77,1921
Jonathan Taylor,"['Gambia', 'American Samoa']",Businessperson,1890,67,73,1957
Roy Owens,['Poland'],Researcher,1879,88,56,1967
Debra Johnson,['Nepal'],Artist,1907,45,60,1952
Tiffany Flores,['Slovenia'],Cellist,1921,67,88,1988
David Harrington,['Andorra'],Athlete,1888,59,51,1947
Mary Cole,['United States Minor Outlying Islands'],Military personnel,1879,46,31,1925
Paige Johnson,['Antarctica (the territory South of 60 deg S)'],Athlete,1894,16,68,1910
Donna Shaw,"['Poland', 'Armenia']",Artist,1911,11,28,1922
Jason Duran,['Ukraine'],Police officer,1885,3,59,1888
Michael Cowan,['Sao Tome and Principe'],Athlete,1890,62,33,1952
Aaron Schneider,['Central African Republic'],Artist,1920,72,59,1992
Steven Perez,['Madagascar'],Artist,1916,12,25,1928
Andrea Munoz,['United States Virgin Islands'],Artist,1882,16,50,1898
Heather Bradshaw,['Central African Republic'],Physician,1884,66,75,1950
Brianna Richards,"['Bulgaria', 'Bolivia']",Politician,1906,22,74,1928
Michael Waters,"['Pakistan', 'Hungary']",Military personnel,1881,64,83,1945
Andrew Sellers,['Guinea-Bissau'],Businessperson,1873,75,68,1948
Regina Sanchez,"['Comoros', 'Bulgaria']",Politician,1886,54,49,1940
Michele Bailey,"['Portugal', 'Anguilla']",Artist,1901,3,80,1904
Brenda Williams,['Rwanda'],Artist,1923,13,70,1936
Maria Morrison,['Switzerland'],Politician,1919,42,64,1961
Susan Sanchez,['British Indian Ocean Territory (Chagos Archipelago)'],Judge,1905,25,18,1930
Carol Wright,['Togo'],Athlete,1901,17,17,1918
Sarah Bush,['Niger'],Artist,1902,49,12,1951
Marissa Chavez,['Madagascar'],Athlete,1901,63,73,1964
Pamela Rojas,"['French Polynesia', 'Marshall Islands']",Religious figure,1898,47,72,1945
Pamela Johnson,['Liechtenstein'],Artist,1912,78,87,1990
Kevin Buchanan,"['Burkina Faso', 'Guam']",Artist,1923,30,1,1953
Kathryn Hansen,['Micronesia'],Politician,1901,36,18,1937
Danielle Brown,"['Saint Lucia', 'Iraq']",Politician,1890,8,36,1898
Amy Weeks,"['Cambodia', 'Switzerland']",Artist,1920,72,13,1992
Zachary Wright,['Ecuador'],Politician,1912,6,16,1918
Deborah Ferguson,['Morocco'],Artist,1879,32,6,1911
Rebecca Holmes,['Benin'],Politician,1888,74,40,1962
Brett Moses,"['United Kingdom', 'Cameroon']",Researcher,1918,9,83,1927
Robert Leon PhD,"['Malawi', 'United Kingdom']",Artist,1915,26,50,1941
Steven Gordon,"['Nicaragua', 'Kyrgyz Republic']",Researcher,1909,14,33,1923
Chloe Flores,['Mauritania'],Politician,1909,52,23,1961
Nicholas Harrison,"['Czech Republic', 'Norway']",Athlete,1904,16,11,1920
Ricardo Steele,"['Uruguay', 'New Caledonia']",Politician,1924,68,53,1992
Johnny Stevens,"['Nicaragua', 'Cayman Islands']",Politician,1871,29,48,1900
Gary Wilson,['Myanmar'],Aristocrat,1896,85,66,1981
James Kennedy,['Aruba'],Military personnel,1924,6,42,1930
Timothy Turner,"['India', 'Cambodia']",Artist,1916,42,28,1958
Dale Stewart,"['Italy', 'Oman']",Artist,1879,56,76,1935
Shannon Cruz,['North Macedonia'],Politician,1907,40,19,1947
Kathryn Miller,"['Philippines', 'Turks and Caicos Islands']",Military personnel,1917,72,60,1989
Russell Dickerson,['Mongolia'],Artist,1900,9,43,1909
Sharon Graham,"['Ireland', 'United States of America']",Artist,1920,15,84,1935
Jesse Madden,['Palau'],Military personnel,1903,48,12,1951
Rachel Anderson,"['Kenya', 'Korea']",Artist,1904,52,51,1956
Marcus Valencia,"['France', 'Andorra']",Artist,1896,7,58,1903
April Clark,['Togo'],Aristocrat,1878,64,75,1942
Steven Webb PhD,"['Ukraine', 'Korea']",Canoeist; kayaker,1919,0,67,1919
Spencer Collins,['Congo'],Artist,1898,6,40,1904
Joshua Bates,['British Indian Ocean Territory (Chagos Archipelago)'],Politician,1889,10,24,1899
Julie Ward,['Bhutan'],Artist,1922,77,56,1999
Kristen Hunter,['Latvia'],Artist,1919,72,0,1991
Crystal Wright,"['Paraguay', 'Falkland Islands (Malvinas)']",Athlete,1890,62,13,1952
Rebecca Rodriguez,['Somalia'],Artist,1918,25,12,1943
Lindsay Gardner,"['Moldova', 'Vanuatu']",Artist,1898,36,78,1934
Paul Sellers,['Germany'],Artist,1896,66,58,1962
Melissa Mendoza,['Yemen'],Politician,1892,39,85,1931
Kathy Rodriguez,"['Bulgaria', 'Greece']",Artist,1895,13,43,1908
Kelly Guerra,"['Malta', 'South Georgia and the South Sandwich Islands']",Alpine skier,1892,89,65,1981
Jordan Dean,"['Cuba', 'Latvia']",Politician,1916,39,75,1955
Miranda Fitzgerald,"['Tonga', 'Guernsey']",Politician,1887,34,63,1921
Andrew Mercer,['Maldives'],Researcher,1905,76,27,1981
Ryan Goodwin,['Central African Republic'],Artist,1877,85,56,1962
Hector Carr,"['Nicaragua', 'Argentina']",Researcher,1872,25,40,1897
Charles Barrett,['Montenegro'],Businessperson,1891,71,50,1962
Richard Kelley,"['Holy See (Vatican City State)', 'Sudan']",Politician,1872,76,70,1948
Alexander Arias,['Belize'],Religious figure,1887,60,4,1947
Earl Larsen,"['Saint Kitts and Nevis', 'Palestinian Territory']",Artist,1888,35,59,1923
John Sanders,"['Bosnia and Herzegovina', 'Anguilla']",Artist,1915,40,3,1955
Alyssa Schultz,"['Fiji', 'Sierra Leone']",Athlete,1918,10,56,1928
Andrew Hall,"['Nicaragua', 'Italy']",Artist,1886,38,66,1924
Kimberly Heath,"['Peru', 'British Indian Ocean Territory (Chagos Archipelago)']",Artist,1891,60,64,1951
Audrey Hudson,"['Ireland', 'Ethiopia']",Journalist,1895,43,41,1938
Alyssa Cole,['Tokelau'],Engineer,1881,1,57,1882
Meghan Anthony,"['Nepal', 'Estonia']",Artist,1902,44,68,1946
Nathan Stewart,"['Northern Mariana Islands', 'Mozambique']",Artist,1901,13,2,1914
Joseph White,"['Moldova', 'Benin']",Religious figure,1919,3,79,1922
Peter Evans,"['Honduras', 'Bulgaria']",Military personnel,1911,57,51,1968
Alexander Davenport,"['Netherlands', 'Saint Barthelemy']",Politician,1900,22,53,1922
Holly Serrano,"['Hungary', 'Nepal']",Artist,1873,69,24,1942
Daniel Jones,['Mexico'],Researcher,1873,44,49,1917
Corey Gray,"['Tanzania', 'Gabon']",Researcher,1886,33,17,1919
David Jackson,"['Moldova', 'Pakistan']",Athlete,1878,5,37,1883
Amanda Owens,['Falkland Islands (Malvinas)'],Artist,1914,41,79,1955
Christina Nelson,['Uruguay'],Aristocrat,1913,2,78,1915
Timothy Miller,['Taiwan'],Researcher,1910,26,38,1936
Julia Sawyer,"['Cayman Islands', 'Isle of Man']",Researcher,1899,3,42,1902
Rebecca Richard,"['Cape Verde', 'Singapore']",Politician,1895,48,20,1943
Jennifer Davis,"['Guernsey', 'Albania']",Artist,1875,2,44,1877
Michael Garcia,"['Vietnam', 'Grenada']",Artist,1918,39,40,1957
Deborah Neal,"['Mauritania', 'Armenia']",Athlete,1897,45,83,1942
Jessica Jones,"['Gambia', 'Lesotho']",Statesperson,1913,67,5,1980
Cameron Price,['Paraguay'],Drug trafficker,1887,76,20,1963
Sergio Johnson,"['Isle of Man', 'Norfolk Island']",Politician,1874,52,20,1926
Brian Fox,"['Eritrea', 'Tanzania']",Artist,1904,75,3,1979
William Decker,['Antarctica (the territory South of 60 deg S)'],Teacher,1902,53,68,1955
Justin Dodson,['Macao'],Aristocrat,1884,37,79,1921
Jessica Alexander,['Brazil'],Athlete,1877,68,68,1945
Taylor Johnson,['Bangladesh'],Researcher,1884,76,41,1960
Casey Steele,"['Christmas Island', 'Reunion']",Artist,1924,43,80,1967
Adam Gonzalez,['Wallis and Futuna'],Artist,1918,86,49,2004
Stephanie King,"['Austria', 'Belgium']",Artist,1893,37,46,1930
Ashley Miller,"['Costa Rica', 'United States of America']",Artist,1875,48,77,1923
Zachary Peck,"['Antarctica (the territory South of 60 deg S)', 'Turks and Caicos Islands']",Artist,1897,86,83,1983
Jordan Gutierrez,['Saudi Arabia'],Cook; restaurateur,1892,27,59,1919
Ronald Simpson,"['Isle of Man', 'Svalbard & Jan Mayen Islands']",Artist,1915,40,50,1955
Alan Hansen,"['Nauru', 'Grenada']",Researcher,1877,57,64,1934
Darren Foster,['Bulgaria'],Politician,1924,43,33,1967
Henry Miller,['Sweden'],Esperantist,1898,73,34,1971
Kaylee Young,"['New Caledonia', 'Czech Republic']",Athlete,1899,44,71,1943
Emily Sanders,['Guyana'],Politician,1882,35,12,1917
Amy Smith,"['British Indian Ocean Territory (Chagos Archipelago)', 'Cyprus']",Athlete,1877,0,45,1877
David House,['Malta'],Artist,1917,30,69,1947
Linda Brown,['Syrian Arab Republic'],Serial killer; spree killer; criminal; prostitute,1914,13,57,1927
Megan Ochoa,"['Mayotte', 'Georgia']",Artist,1872,85,81,1957
Michael Smith,"['Guernsey', 'Brunei Darussalam']",Athlete,1896,42,50,1938
Calvin Collier,"['Guernsey', 'Zimbabwe']",Artist,1893,46,29,1939
Joseph Figueroa,['Guam'],Politician,1875,50,18,1925
Michael Richardson,"['Antigua and Barbuda', 'Congo']",Artist,1908,36,77,1944
Christina Lopez,['Iceland'],Religious figure,1875,42,56,1917
Melissa Williams,['Martinique'],Artist,1896,88,67,1984
Kiara Mosley,['Estonia'],Athlete,1898,80,5,1978
Glenda Elliott,['Monaco'],Artist,1882,83,13,1965
Luis Hicks,"['Netherlands', 'Latvia']",Military personnel,1874,37,75,1911
Kyle Hernandez,['Kiribati'],Artist,1900,2,13,1902
Scott Williams,"['Palestinian Territory', 'Australia']",Athlete,1901,34,12,1935
Megan Payne,"['Oman', 'Libyan Arab Jamahiriya']",Researcher,1887,8,49,1895
Meagan Haas,"['Martinique', 'Philippines']",Artist,1914,25,63,1939
Barry Hernandez,"['Barbados', 'Angola']",Artist,1871,6,75,1877
Diana Lopez,['Estonia'],Researcher,1910,73,70,1983
Timothy Willis,"['Mongolia', 'Cuba']",Artist,1908,78,27,1986
Sean Hanson,"['San Marino', 'Jamaica']",Artist,1877,76,8,1953
Kimberly Gill,['Albania'],Artist,1898,78,14,1976
Cynthia Jackson,['Heard Island and McDonald Islands'],Politician,1891,6,23,1897
Dr. Brian Woodard,['Gambia'],Sovereign,1896,52,43,1948
Thomas Daniel PhD,"['Dominica', 'Svalbard & Jan Mayen Islands']",Politician,1903,32,31,1935
Dr. Paul Nelson,['Equatorial Guinea'],Journalist,1881,88,78,1969
Eddie Fitzgerald,['Liberia'],Athlete,1880,52,44,1932
Cameron Hamilton,"['Seychelles', 'Paraguay']",Artist,1907,22,47,1929
Anita Serrano,['Indonesia'],Politician,1900,63,29,1963
Amanda Mack,"['Kiribati', 'Vanuatu']",Artist,1902,39,76,1941
Justin Ramirez,['Gambia'],Mountaineer,1902,35,70,1937
Kimberly Huynh,"[""Cote d'Ivoire""]",Athlete,1875,38,28,1913
Debra Sawyer,"['Chile', 'Turks and Caicos Islands']",Artist,1921,76,48,1997
Jerry Garza,"['Qatar', 'Tonga']",Artist,1917,89,83,2006
Brandi Aguirre,['Poland'],Teacher,1889,15,11,1904
Thomas Lopez,['Turkey'],Researcher,1889,19,22,1908
Travis Torres,"['Peru', 'Nauru']",Politician,1920,35,6,1955
Dr. Adrian Durham,"['Saint Martin', 'Falkland Islands (Malvinas)']",Artist,1914,84,30,1998
Kenneth Thomas,['Nauru'],Artist,1921,82,58,2003
Michael Hart,['Chile'],Artist,1898,89,21,1987
Douglas Williams,"['Egypt', 'Albania']",Religious figure,1885,5,79,1890
Ashley Lopez,['Martinique'],Artist,1872,80,3,1952
Anna Hernandez,"['Niger', 'Ghana']",Artist,1896,7,82,1903
Tammy Gonzales,['Svalbard & Jan Mayen Islands'],Military personnel,1878,66,66,1944
Jodi Wright,['Bolivia'],Teacher,1896,79,64,1975
Donald May,"['Afghanistan', 'Latvia']",Artist,1910,82,36,1992
Carla Avila,['Kenya'],Politician,1922,89,45,2011
Cindy Ramirez,['Canada'],Artist,1876,75,1,1951
Tamara Vega,['Mozambique'],Politician,1915,28,46,1943
Audrey Vega,['Ecuador'],Researcher,1875,69,17,1944
Deborah Hoffman,"['Barbados', 'Korea']",Aristocrat,1904,44,21,1948
Jessica Davis,"['Kazakhstan', 'Kiribati']",Artist,1922,80,23,2002
Emily Bender,"['Czech Republic', 'Thailand']",Politician,1901,38,59,1939
Jeremy Koch,"['Comoros', 'Belgium']",Military personnel,1875,22,36,1897
Rhonda Simmons,"['Falkland Islands (Malvinas)', 'French Guiana']",Artist,1870,67,82,1937
Daniel Torres,"['United States Virgin Islands', 'Zambia']",Athlete,1875,26,52,1901
Nathan Cameron,['Hungary'],Teacher,1884,34,32,1918
Devin Johnson,"['Botswana', 'Lesotho']",Artist,1888,69,87,1957
Megan Ford,['Montenegro'],Artist,1881,49,29,1930
Kimberly Chase,"['Maldives', 'Botswana']",Military personnel,1914,79,51,1993
Janice Glover,['Suriname'],Athlete,1899,20,70,1919
Michael Hatfield,"['Kiribati', 'Syrian Arab Republic']",Researcher,1912,83,27,1995
Michelle Durham,['Andorra'],Artist,1914,73,35,1987
Martha Frank,"['Timor-Leste', 'Nigeria']",Artist,1900,30,47,1930
Samantha Black,['Turkey'],Politician,1875,23,86,1898
Melissa Aguilar,"['Bouvet Island (Bouvetoya)', 'Haiti']",Artist,1886,83,70,1969
Lauren Adams,"['Thailand', 'Saint Lucia']",Athlete,1908,52,50,1960
Marissa Wilson,['Algeria'],Artist,1877,43,53,1920
Carrie Burns,['Aruba'],Journalist,1870,6,55,1876
Tonya Robinson,['Saint Kitts and Nevis'],Artist,1878,39,29,1917
Thomas Olson,['Mali'],Artist,1911,8,44,1919
Jordan Cook,"['Cyprus', 'Romania']",Politician,1883,77,11,1960
Brian Wiley,['Belgium'],Outlaw,1921,29,32,1950
Angela Sloan,"['Libyan Arab Jamahiriya', 'Ukraine']",Military personnel,1910,62,39,1972
Phyllis Daniel,['Equatorial Guinea'],Politician,1881,25,86,1906
Edwin Freeman,['Peru'],Entrepreneur,1903,6,52,1909
Alexis Ford,"['Belgium', 'Armenia']",Artist,1892,47,77,1939
Dustin Mcclure,"['Cyprus', 'Nauru']",Researcher,1894,82,67,1976
Kerry Hernandez,"['Albania', 'Cape Verde']",Researcher,1901,33,68,1934
Tony Blake,['Saint Barthelemy'],Conductor,1892,26,14,1918
Alison Howard,"['Malaysia', 'Finland']",Politician,1870,74,17,1944
Heather Barnes,"['Sweden', 'Netherlands']",Artist,1914,67,88,1981
Harold Carter,"[""Lao People's Democratic Republic"", 'United States of America']",Pastor,1915,70,9,1985
Michael Wilson,['Gibraltar'],Artist,1878,33,18,1911
Terri Lee,"['Western Sahara', 'Egypt']",Explorer,1879,9,28,1888
Amy Perez,"['United States Virgin Islands', 'French Southern Territories']",Politician,1898,63,73,1961
Monica Hodge,['Slovakia (Slovak Republic)'],Artist,1887,45,64,1932
Christopher Ford,['Gibraltar'],Artist,1880,39,83,1919
Gregory Parker,"['Chile', 'Comoros']",Engineer,1874,66,33,1940
Jeremy Washington,['Solomon Islands'],Artist,1882,27,37,1909
Mitchell Williams,"['Liechtenstein', 'Malaysia']",Artist,1912,41,59,1953
Patricia Joyce,"['Germany', 'Anguilla']",Artist,1886,48,26,1934
Steven Mendoza,"['Senegal', 'Congo']",Researcher,1878,88,84,1966
Steven Jones,"['Malta', 'Myanmar']",Artist,1871,40,0,1911
Lindsay Hooper,['Tunisia'],Artist,1884,73,79,1957
Michael Leach,"['Guinea', 'Sudan']",Artist,1910,88,78,1998
Chelsea Brown,"['Palau', 'Holy See (Vatican City State)']",Artist,1874,2,18,1876
George Myers,['South Georgia and the South Sandwich Islands'],Teacher,1922,3,87,1925
Jordan Moore,"['Latvia', 'Turkey']",Artist,1895,74,63,1969
Kelly Smith,['Philippines'],Artist,1877,5,46,1882
Teresa Walter,['British Indian Ocean Territory (Chagos Archipelago)'],Artist,1880,7,71,1887
Anthony Price,['Guam'],Researcher,1899,65,30,1964
Nicholas Wood,"['Chad', 'North Macedonia']",Politician,1880,15,89,1895
Gregory Gonzalez,"['Iceland', 'Iceland']",Artist,1917,9,3,1926
Seth Allen,"['Tajikistan', 'Azerbaijan']",Artist,1897,52,14,1949
Jeffrey Brooks,"['Netherlands Antilles', 'Israel']",Politician,1892,5,79,1897
Dawn Stein,"['Mali', 'Bangladesh']",Domestic worker; prostitute,1921,8,56,1929
Shelley May,['Anguilla'],Entrepreneur,1903,29,66,1932
Lucas Vargas,"['Portugal', 'Rwanda']",Alpine skier,1904,23,81,1927
James Shaw,"['Guernsey', 'Tajikistan']",Researcher,1921,54,58,1975
Kathleen Powers,['Micronesia'],Businessperson,1879,69,47,1948
Kathleen Flores,['Solomon Islands'],Artist,1887,84,51,1971
Allison Wells,"['Uganda', 'Saint Vincent and the Grenadines']",Researcher,1891,30,87,1921
Jermaine Smith,"['Canada', 'Marshall Islands']",Researcher,1889,42,79,1931
Logan Adams,"['Solomon Islands', 'Colombia']",Aristocrat,1875,16,81,1891
Stanley Bennett,"['Tunisia', 'Rwanda']",Nurse,1894,2,64,1896
Kimberly Joseph,['Mauritania'],Politician,1899,72,53,1971
Jennifer Wallace,['Germany'],Religious figure,1890,56,73,1946
Whitney Jimenez,['Bermuda'],Aristocrat,1906,50,68,1956
Christy Nguyen,"['Albania', 'Papua New Guinea']",Athlete,1915,19,51,1934
Rhonda Goodman,['Palestinian Territory'],Artist,1895,36,53,1931
Maria Turner,"[""Cote d'Ivoire""]",Artist,1898,67,86,1965
Beth Robertson,['Philippines'],Researcher,1888,27,46,1915
Becky Rasmussen,"['Trinidad and Tobago', 'Estonia']",Researcher,1905,66,11,1971
Brian Turner,"['Malawi', 'Cyprus']",Artist,1891,62,80,1953
Tamara Brown,['Norfolk Island'],Entrepreneur,1914,84,37,1998
Jacob Sanchez,['Pitcairn Islands'],Military personnel,1907,77,36,1984
Jennifer Hill,"['Senegal', 'Netherlands']",Military personnel,1886,78,69,1964
Laura Reeves,"['New Caledonia', 'Kiribati']",Artist,1916,69,48,1985
Kimberly Stevens,['Somalia'],Religious figure,1898,64,57,1962
Diane Mcfarland,['United Kingdom'],Politician,1885,84,33,1969
Brett Rose,"['El Salvador', 'Sri Lanka']",Sailor,1888,79,62,1967
Shaun Williams,['Yemen'],Athlete,1901,82,55,1983
Veronica Alvarado,"['Palestinian Territory', 'Puerto Rico']",Artist,1885,52,62,1937
Monica Livingston,"['Brunei Darussalam', 'Gabon']",Mountaineer,1880,75,66,1955
Ross Hamilton,['Christmas Island'],Politician,1885,53,25,1938
Christine Smith,['Germany'],Researcher,1903,51,45,1954
Stephen Hawkins,"[""Lao People's Democratic Republic""]",Artist,1881,3,64,1884
Robert Miller,['Turks and Caicos Islands'],Artist,1912,29,69,1941
Vanessa Phillips,['Sweden'],Researcher,1886,4,49,1890
Charles Monroe,['Nicaragua'],Politician,1886,76,82,1962
Sierra Mccall,"['Guadeloupe', 'Tajikistan']",Artist,1913,71,14,1984
Hannah Moore,['Argentina'],Researcher,1903,86,44,1989
Sarah Davis,['Albania'],Artist,1918,54,46,1972
Susan Anderson,['Cambodia'],Artist,1892,60,29,1952
Patricia Brown,"['Madagascar', 'Saint Helena']",Athlete,1888,31,37,1919
Erin Young,['Moldova'],Artist,1900,65,9,1965
Jason Reyes MD,"['Gibraltar', 'Angola']",Military personnel,1904,9,14,1913
John Crane,"['Romania', 'Saudi Arabia']",Military personnel,1870,0,4,1870
Christine Wheeler,"['Bosnia and Herzegovina', 'Italy']",Artist,1913,13,64,1926
Kayla Ward,"['Senegal', 'Mozambique']",Politician,1884,88,27,1972
Tanner Edwards,"['Antarctica (the territory South of 60 deg S)', 'Spain']",Researcher,1874,21,59,1895
Lisa Thompson,"['Greece', 'French Southern Territories']",Athlete,1884,56,84,1940
Tricia Warner,['Israel'],Artist,1903,3,6,1906
Bethany Stephens,"['Hong Kong', 'Brazil']",Artist,1894,41,45,1935
Sarah Arias,['Poland'],Military personnel,1913,68,25,1981
Christine Rogers,['Antigua and Barbuda'],Nun,1905,64,78,1969
Dennis Crawford,"['Palestinian Territory', 'Ecuador']",Rhythmic gymnast,1893,4,58,1897
Donald Gray,['Iran'],Religious figure,1905,36,2,1941
Jaime Hanson,['Australia'],Physician,1888,43,53,1931
Michael Carr,"['Papua New Guinea', 'Kazakhstan']",Artist,1894,51,19,1945
Kelly Escobar,['Faroe Islands'],Athlete,1908,82,40,1990
Richard Mejia,"['Burundi', 'Brunei Darussalam']",Politician,1920,23,56,1943
Jeffrey Green,"['Kiribati', 'Madagascar']",Researcher,1912,6,6,1918
Kevin Salinas,"['Guadeloupe', ""Cote d'Ivoire""]",Artist,1908,26,89,1934
Daniel Wallace,"['New Zealand', 'British Virgin Islands']",Artist,1890,83,52,1973
Linda Nichols,['Dominican Republic'],Politician,1874,2,88,1876
Dr. Alan Newton DDS,"['Ireland', 'Nicaragua']",Artist,1876,27,85,1903
David Martin,"['Rwanda', 'India']",Politician,1916,28,49,1944
Bonnie Rangel,['Anguilla'],Architect,1908,12,65,1920
Angela Phillips,['Dominican Republic'],Artist,1890,41,47,1931
Antonio Wallace,['Bhutan'],Politician,1884,49,66,1933
Lisa Johns,['Korea'],Politician,1920,86,55,2006
Steven Watts,"['Cocos (Keeling) Islands', 'Jamaica']",Artist,1922,21,14,1943
Bonnie Russell,"['Hungary', 'Iraq']",Politician,1871,32,35,1903
April Edwards,['Kiribati'],Artist,1899,22,4,1921
Kristin Bailey,['Afghanistan'],Researcher,1873,20,80,1893
Kristen Sanchez,"['United States Virgin Islands', 'Venezuela']",Researcher,1894,78,54,1972
Tyler Ross,"['Comoros', 'Guatemala']",Politician,1882,31,39,1913
Luis Green,"['Pakistan', 'Panama']",Politician,1911,36,87,1947
Sarah Williams,['Barbados'],Artist,1898,37,42,1935
Joel Romero,"['South Africa', 'Lithuania']",Artist,1878,4,30,1882
Tammie Monroe,"['Anguilla', 'Mali']",Artist,1873,18,8,1891
James Rojas,"['Australia', 'Taiwan']",Religious figure,1885,14,67,1899
David Watson,"['Syrian Arab Republic', 'Antarctica (the territory South of 60 deg S)']",Researcher,1886,87,66,1973
Jacob Cox,['Saint Kitts and Nevis'],Researcher,1911,43,66,1954
William James,"['Cyprus', 'Venezuela']",Artist,1887,18,50,1905
Zachary Smith,['Moldova'],Researcher,1873,44,39,1917
Elizabeth Le,"['Netherlands Antilles', 'Saint Barthelemy']",Researcher,1891,53,83,1944
Valerie Morgan,"['Korea', 'Madagascar']",Artist,1912,13,68,1925
Natalie Fuller,['Djibouti'],Researcher,1891,0,59,1891
Casey Gonzales,"['Dominica', 'Lithuania']",Military personnel,1872,73,16,1945
Tanya Smith,['Palestinian Territory'],Researcher,1870,85,25,1955
Christopher Anderson,['Niue'],Politician,1921,71,66,1992
Derrick Stout,"['Slovenia', 'Senegal']",Artist,1882,75,17,1957
Rebecca Miller,"['Suriname', 'Canada']",Politician,1904,65,24,1969
Laura Johnson,"['American Samoa', 'Mali']",Politician,1877,61,34,1938
Bridget Matthews,['Wallis and Futuna'],Athlete,1896,39,50,1935
Christine Aguilar,['Iraq'],Artist,1871,24,8,1895
Joseph Woods,"['Turks and Caicos Islands', 'Equatorial Guinea']",Politician,1881,85,42,1966
Christina Brown,['Kenya'],Artist,1918,69,47,1987
Shawn Garcia,"['Iceland', 'Mauritius']",Artist,1923,21,71,1944
Bradley Reese,"[""Cote d'Ivoire"", 'Senegal']",Military personnel,1889,89,39,1978
Corey Johnson,"['Eritrea', 'Bouvet Island (Bouvetoya)']",Athlete,1896,44,47,1940
Kristen Collins,"['Italy', 'Ecuador']",Politician,1884,12,16,1896
Cindy Potter,['Singapore'],Politician,1897,8,40,1905
Eric Flores,['Saint Barthelemy'],Artist,1920,67,40,1987
Marcus Mason,['Cape Verde'],Researcher,1880,24,26,1904
Karen Vaughan,['Syrian Arab Republic'],Artist,1920,46,83,1966
Lance Hayes,"['Brazil', 'Mauritius']",Politician,1919,82,85,2001
Marissa Jensen,"['Vietnam', 'Egypt']",Artist,1880,44,68,1924
Philip Carpenter,"['Papua New Guinea', 'Western Sahara']",Teacher,1885,13,48,1898
Kyle Holmes,['Senegal'],Businessperson,1877,27,25,1904
Brenda Rivers,"['Kyrgyz Republic', 'Iraq']",Artist,1912,35,12,1947
Deanna Lopez,"['Micronesia', 'Timor-Leste']",Artist,1907,68,51,1975
Brian West,['United States Minor Outlying Islands'],Artist,1897,83,28,1980
Danielle Thomas,['Japan'],Artist,1921,18,56,1939
Lacey Lane,['Samoa'],Artist,1923,82,70,2005
Jessica Sanchez,"['Azerbaijan', 'Kyrgyz Republic']",Researcher,1893,9,45,1902
Margaret Brady,['Western Sahara'],Artist,1893,65,59,1958
Charles Navarro,['Lebanon'],Artist,1899,56,86,1955
Dylan Christian,['Grenada'],Artist,1870,7,41,1877
Molly Beard,['Myanmar'],Artist,1881,33,41,1914
Elizabeth Serrano,"['Cuba', 'Brazil']",Artist,1902,56,15,1958
Cassandra Bolton,['Tuvalu'],Aristocrat,1892,10,78,1902
William Hopkins,['Peru'],Politician,1923,26,55,1949
Julie Williams,"['Guinea', 'Albania']",Artist,1898,55,4,1953
Pamela Torres,"['Micronesia', 'Holy See (Vatican City State)']",Artist,1902,57,89,1959
Andrew Macias,"['Malawi', 'Sri Lanka']",Politician,1894,47,49,1941
Pamela Hernandez,['Afghanistan'],Politician,1889,89,40,1978
Robert Alexander,['Turkmenistan'],Artist,1897,23,8,1920
Sarah Gould,['Chile'],Athlete,1880,19,14,1899
Christopher Roberson,"['Malta', 'Nepal']",Politician,1882,79,56,1961
Jerry Nelson,['Argentina'],Artist,1890,79,73,1969
David Turner,"['Cape Verde', 'Mauritius']",Artist,1873,74,8,1947
Jacob Long,"['Sudan', 'Ukraine']",Military personnel,1882,59,81,1941
Robert Todd,"['Comoros', 'Vietnam']",Artist,1918,73,18,1991
Lisa Schroeder,['Svalbard & Jan Mayen Islands'],Artist,1896,54,63,1950
Christopher Romero,"['Morocco', 'Kuwait']",Military personnel,1874,0,67,1874
Phillip Bryant,['Colombia'],Politician,1899,0,80,1899
David Reynolds,"['Poland', 'Togo']",Artist,1920,20,40,1940
Jake Spencer,"['Belize', ""Lao People's Democratic Republic""]",Politician,1880,20,14,1900
Thomas Wright Jr.,"['Lebanon', 'Saint Pierre and Miquelon']",Artist,1907,57,64,1964
Stephen Moyer,"['Belgium', 'Madagascar']",Athlete,1884,3,65,1887
Charles Thompson,"['Uruguay', 'Guatemala']",Artist,1896,58,56,1954
Tami Carpenter,"['Sierra Leone', 'Libyan Arab Jamahiriya']",Athlete,1902,57,72,1959
John Miller,['Iraq'],Explorer; seafarer,1878,75,34,1953
Diane Kane,['Saint Barthelemy'],Artist,1879,22,37,1901
Jared Escobar,['Taiwan'],Artist,1884,18,67,1902
Thomas Mcdonald,"['Czech Republic', 'Estonia']",Politician,1898,2,22,1900
Jason Prince,['Ethiopia'],Criminal,1875,41,89,1916
Jessica Kelly,"['Faroe Islands', 'Jordan']",Artist,1921,64,45,1985
Timothy Lopez,['Singapore'],Athlete,1892,73,72,1965
Ryan Delgado,"['Cameroon', 'Western Sahara']",Bullfighter,1898,36,35,1934
James Fields,"['Cayman Islands', 'Tajikistan']",Military personnel,1886,33,35,1919
Monica Edwards,"['Guatemala', ""Cote d'Ivoire""]",Artist,1913,53,49,1966
Grace Reyes,['Svalbard & Jan Mayen Islands'],Religious figure,1885,11,74,1896
Candice Barrett,"['Samoa', 'Cape Verde']",Politician,1913,57,78,1970
Brenda Lewis,['Venezuela'],Artist,1894,51,60,1945
Cynthia Jimenez,['Malaysia'],Artist,1902,40,85,1942
James Coffey,"['Luxembourg', 'Czech Republic']",Military personnel,1920,18,6,1938
Angela Wilson,['Bolivia'],Artist,1876,31,71,1907
Scott Colon,['Mayotte'],Artist,1918,55,84,1973
Amy Hawkins,"['Namibia', 'Angola']",Artist,1903,11,17,1914
Kristin Holder,['French Guiana'],Artist,1909,31,4,1940
Kevin Downs,"['Vanuatu', 'Belarus']",Artist,1892,38,57,1930
Andrew Williams,['Sierra Leone'],Cook; restaurateur,1903,15,43,1918
Lori Cameron,"['Dominican Republic', 'Honduras']",Artist,1908,88,67,1996
Michael Todd,"['Sri Lanka', 'Belize']",Artist,1874,70,67,1944
Mr. William Santos,['Malaysia'],Artist,1893,3,39,1896
Tammy Hoffman,['Jordan'],Luger,1922,70,56,1992
Stephen Hopkins,"['El Salvador', 'Colombia']",Artist,1922,58,67,1980
Tracy Garcia,"['Saudi Arabia', 'Guadeloupe']",Artist,1892,18,49,1910
Emily Thomas,"['Saint Barthelemy', 'United States Minor Outlying Islands']",Artist,1919,42,43,1961
Victor Newman,['United States Minor Outlying Islands'],Teacher,1879,63,59,1942
Michelle Monroe,"['Brazil', 'Hungary']",Serial killer; criminal,1898,66,52,1964
Laura Ramirez,['French Polynesia'],Artist,1905,67,46,1972
David Gardner,"['Niger', 'Brunei Darussalam']",Entrepreneur,1921,83,47,2004
Steven Russell,"['United Arab Emirates', 'Grenada']",Artist,1884,82,61,1966
Brenda Brown,['Japan'],Politician,1880,28,81,1908
David Cordova,['Nauru'],Artist,1913,30,51,1943
Megan Wilson,['Reunion'],Criminal,1919,69,48,1988
Erin Hill,['Gambia'],Politician,1906,33,24,1939
Amy Hughes,"['Qatar', 'El Salvador']",Military personnel,1893,75,39,1968
Sherri Nicholson,"['United States Minor Outlying Islands', 'Wallis and Futuna']",Artist,1896,29,72,1925
Calvin Johnson,['Singapore'],Artist,1898,52,52,1950
Terry Wang,['Liechtenstein'],Athlete,1888,66,87,1954
Daniel Peterson,['Papua New Guinea'],Executioner,1885,61,34,1946
Crystal Branch,"['Gambia', 'United States Virgin Islands']",Artist,1906,48,14,1954
Kevin Andrews,['Bouvet Island (Bouvetoya)'],Researcher,1905,57,4,1962
Omar Bonilla,"['Lithuania', 'Romania']",Artist,1909,30,12,1939
Olivia Lee,"['Portugal', 'Sri Lanka']",Politician,1896,58,59,1954
Kathryn Gray,"['United States of America', 'New Zealand']",Artist,1916,8,44,1924
Renee Hancock,"['Sao Tome and Principe', 'Cameroon']",Religious figure,1914,42,10,1956
Madeline Rice,['Palau'],Artist,1878,79,80,1957
Katelyn Davidson,"['Kazakhstan', 'Costa Rica']",Politician,1921,48,15,1969
Christopher Young,"['Faroe Islands', 'Guyana']",Politician,1905,19,81,1924
Keith Wong,['Poland'],Artist,1920,37,35,1957
Phillip Suarez,['Mayotte'],Politician,1920,17,73,1937
Veronica Fischer,"['Maldives', 'Uruguay']",Politician,1887,15,23,1902
Nicole Brown,['Afghanistan'],Researcher,1876,16,54,1892
Chad Lawrence,"['Sao Tome and Principe', 'Rwanda']",Researcher,1896,13,61,1909
Jamie Crane,['United States of America'],Artist,1903,17,15,1920
Nicole Martinez,"['Kiribati', 'Tunisia']",Politician,1880,41,16,1921
Jesse Jones,['Brunei Darussalam'],Artist,1896,89,32,1985
Nicole Rodriguez,['American Samoa'],Artist,1886,32,78,1918
Rachel Hampton,['Cameroon'],Researcher,1904,84,39,1988
Taylor Callahan,"['Cayman Islands', 'Chile']",Serial killer; employee of printing,1885,3,66,1888
Lori Monroe,"['Bolivia', 'Mauritius']",Athlete,1892,43,83,1935
Wendy Craig,"['Czech Republic', 'Palau']",Artist,1919,56,77,1975
Stephanie Wright,"['Anguilla', 'Togo']",Politician,1890,41,29,1931
Steven Nguyen,['Austria'],Artist,1887,55,51,1942
Roberto Hogan,['Guinea-Bissau'],Scenographer; film producer,1882,80,44,1962
Lisa Hodge,['Cook Islands'],Politician,1899,61,4,1960
Tyler Diaz,['Ireland'],Artist,1875,8,28,1883
Kimberly Webb,"['Isle of Man', ""Lao People's Democratic Republic""]",Researcher,1889,69,61,1958
Ryan Ferguson,['Tokelau'],Artist,1909,58,69,1967
Isabel Parsons,['Tajikistan'],Artist,1883,52,71,1935
Michael Elliott,"['Belarus', 'Norfolk Island']",Athlete,1893,7,66,1900
Claudia Nielsen,['Eritrea'],Athlete,1880,71,41,1951
Debbie Simpson,['Svalbard & Jan Mayen Islands'],Submariner; naval officer,1916,36,60,1952
Shelby Luna,"['Fiji', 'Kenya']",Politician,1909,3,43,1912
Brittany Mclaughlin,"['Bahamas', 'Ethiopia']",Artist,1922,0,30,1922
Robert Smith,"['Costa Rica', 'Korea']",Artist,1885,19,17,1904
Victoria Johnson,['Italy'],Artist,1873,69,2,1942
Victor Graham,"['Vietnam', 'Saint Lucia']",Artist,1918,30,66,1948
Sonya Turner,['Saint Lucia'],Artist,1897,25,44,1922
Amy Rivera,"['Colombia', 'Finland']",Religious figure,1873,0,38,1873
Kathleen Burton,"['Sierra Leone', 'Lesotho']",Athlete,1915,2,71,1917
Debra Carr,['Papua New Guinea'],Artist,1915,67,17,1982
Jonathan Nichols,"['Puerto Rico', 'French Southern Territories']",Researcher,1910,81,43,1991
Tracy Gregory,['Slovakia (Slovak Republic)'],Artist,1896,67,11,1963
Henry Johnson,"['Turkmenistan', 'Latvia']",Military personnel,1921,52,66,1973
Traci Rogers,"['Hong Kong', 'Bosnia and Herzegovina']",Athlete,1872,10,42,1882
Eric Terry,['United States of America'],Thief,1880,27,43,1907
George Johnson,"['Morocco', 'United Kingdom']",Military personnel,1878,12,35,1890
Nancy Hill,"['American Samoa', 'Finland']",Artist,1911,9,74,1920
Sharon Martinez,['United Arab Emirates'],Artist,1918,85,18,2003
Alicia Clark,['Czech Republic'],Circus performer,1871,71,13,1942
Jennifer Romero,['Bahamas'],Artist,1895,82,50,1977
Erin Mccarty,['Sweden'],Artist,1923,85,4,2008
Kristi Sullivan,"['China', 'Ireland']",Politician,1887,65,41,1952
Wendy Stevens,['Uzbekistan'],Politician,1888,14,10,1902
Sabrina King,['Angola'],Artist,1875,54,52,1929
Diamond Carter,"['Bulgaria', 'Trinidad and Tobago']",Artist,1890,31,31,1921
Miranda Jenkins,"['Sweden', 'Montserrat']",Samurai,1873,39,25,1912
Jean Rose,"['Yemen', 'Tanzania']",Artist,1922,29,31,1951
Steven Barnes,"['Mozambique', 'British Indian Ocean Territory (Chagos Archipelago)']",Researcher,1890,22,57,1912
Monica Simon,"['Belarus', 'Moldova']",Athlete,1902,34,38,1936
Jeremy Peterson,"['Qatar', 'Norway']",Politician,1875,51,38,1926
Kathleen Lopez,"['Mexico', 'Thailand']",Artist,1905,25,84,1930
Nicholas Reid,"['Cocos (Keeling) Islands', 'Iceland']",Politician,1909,57,38,1966
Lori Harris,['Spain'],Politician,1898,34,50,1932
Christopher Knight,"['Mauritius', 'Svalbard & Jan Mayen Islands']",Serial killer,1919,84,83,2003
Steven Best,['Madagascar'],Artist,1923,70,68,1993
Stacey Cole,['Belize'],Artist,1917,59,63,1976
Joshua Martinez Jr.,"['Russian Federation', 'Guyana']",Artist,1882,60,10,1942
Carol Griffith,"[""Lao People's Democratic Republic"", 'Turkmenistan']",Aristocrat,1873,21,6,1894
Walter Jefferson,['Jordan'],Athlete,1910,53,80,1963
Philip Owen,['Kyrgyz Republic'],Artist,1914,7,34,1921
Madison Larson,"['Sao Tome and Principe', 'Rwanda']",Politician,1898,21,48,1919
Karen Carson,"['Solomon Islands', 'Belgium']",Military personnel,1889,21,22,1910
Jason Bell,"['Mozambique', 'American Samoa']",Motorcycle racer; racing automobile driver,1885,11,8,1896
John Nielsen,"['Madagascar', 'Latvia']",Athlete,1908,57,23,1965
Lisa Little,"['Myanmar', 'Sierra Leone']",Artist,1873,22,88,1895
Brandon Brown,"['Russian Federation', 'Ukraine']",Researcher,1898,39,59,1937
Jennifer White,"['Liberia', 'Somalia']",Artist,1893,57,85,1950
Jason Bennett,"['Iraq', 'Croatia']",Artist,1909,53,72,1962
Nicole Meyer,"['Aruba', 'Pakistan']",Artist,1880,32,66,1912
Rachel Richards,['Cocos (Keeling) Islands'],Artist,1877,46,62,1923
Lori Williams,['Central African Republic'],Politician,1912,84,61,1996
Steven Allen,['Ecuador'],Researcher,1902,68,3,1970
Anthony Foley,['Egypt'],Artist,1871,21,14,1892
Dalton Barton,['South Africa'],Artist,1913,82,43,1995
Angela Lynn,"['Micronesia', 'Guatemala']",Religious figure,1885,44,75,1929
Chad Bennett,"[""Lao People's Democratic Republic""]",Politician,1914,20,5,1934
Wayne Collins,"['Syrian Arab Republic', 'Seychelles']",Athlete,1907,83,74,1990
Lisa Cummings,['Belarus'],Military personnel,1907,37,58,1944
Elizabeth Riggs,['Faroe Islands'],Politician,1877,67,33,1944
Timothy Shaw,"['Cook Islands', 'Iran']",Politician,1873,25,15,1898
Frederick Santos,['Niger'],Artist,1910,45,14,1955
Jasmine Morgan,['Faroe Islands'],Journalist,1898,77,48,1975
Joseph Taylor,"['Bolivia', 'Turkmenistan']",Monarch,1871,9,71,1880
Kathryn Shepard,"['Trinidad and Tobago', 'Christmas Island']",Military personnel,1902,73,83,1975
Andrea Hoffman,['Liberia'],Racing automobile driver,1916,51,66,1967
Colin Gray,"['Antarctica (the territory South of 60 deg S)', 'Zimbabwe']",Artist,1903,29,13,1932
Karen Cisneros,['Turkmenistan'],Artist,1899,26,77,1925
Nicholas Barry,"['Mozambique', 'Solomon Islands']",Politician,1882,45,56,1927
Kimberly Thomas,['Korea'],Politician,1917,39,82,1956
Joshua Jimenez,['Haiti'],Artist,1903,14,10,1917
Alicia Barry,"['Libyan Arab Jamahiriya', 'Palestinian Territory']",Judge,1887,31,52,1918
Jamie Duncan,"['Cape Verde', 'China']",Artist,1906,83,74,1989
Monica Morrison,['Belize'],Artist,1888,67,22,1955
Matthew Morgan,['Egypt'],Artist,1898,79,38,1977
Kathryn Vargas,"['Turks and Caicos Islands', 'Seychelles']",Gangster,1889,75,84,1964
Elizabeth Hayes,"['Antigua and Barbuda', 'Niger']",Artist,1875,22,73,1897
Tiffany Brown,['Qatar'],Teacher,1924,74,15,1998
Karen Mejia,['North Macedonia'],Politician,1886,11,74,1897
Traci Kaufman,['Kyrgyz Republic'],Researcher,1879,46,39,1925
David Cobb,"['Jordan', 'Chad']",Politician,1909,54,60,1963
Michael Orr,['Armenia'],Artist,1916,24,16,1940
Elizabeth Esparza,"['Japan', 'Turks and Caicos Islands']",Artist,1881,7,14,1888
Ashley Johns,['Zimbabwe'],Artist,1915,17,66,1932
Misty Parker,['Ukraine'],Politician,1904,75,31,1979
Ryan Martinez,"['Tajikistan', 'Philippines']",Artist,1879,10,2,1889
Joseph Silva,['Bulgaria'],Artist,1895,88,50,1983
Adam Scott,"['Guadeloupe', 'Bahamas']",Athlete,1884,45,24,1929
Samuel Michael,['Honduras'],Military personnel,1921,12,28,1933
Ryan Morrison DDS,"['Cape Verde', 'Croatia']",Artist,1893,71,51,1964
Melinda Patterson,"['Mongolia', 'Angola']",Athlete,1916,4,20,1920
Sergio Marshall,"['Bangladesh', 'Maldives']",Military personnel,1880,70,10,1950
Amy Evans,['New Caledonia'],Military personnel,1888,19,1,1907
Allen Dixon,['Papua New Guinea'],Artist,1891,60,0,1951
James Roberts,['Latvia'],Politician,1920,58,27,1978
Brandy Foster,"['Seychelles', 'Anguilla']",Artist,1883,16,53,1899
Penny Adams,"['Puerto Rico', 'Netherlands']",Artist,1917,22,55,1939
Angela Robinson,['Canada'],Artist,1879,63,51,1942
Michelle Gilbert,"['Ireland', 'Thailand']",Preacher,1922,89,48,2011
Cody Nelson,"['Bahamas', 'Syrian Arab Republic']",Athlete,1904,5,79,1909
Megan Sloan,"['Serbia', 'Niger']",Artist,1883,34,30,1917
Tamara Graham,"['Bulgaria', 'Saint Lucia']",Politician,1909,53,69,1962
Louis Wilson,"['Solomon Islands', 'Saint Martin']",Politician,1916,89,2,2005
Jillian Casey,"['Belize', 'Comoros']",Politician,1879,56,0,1935
Ryan Martinez,['Wallis and Futuna'],Athlete,1905,61,12,1966
Victoria Hubbard MD,['San Marino'],Artist,1886,31,20,1917
Jeffrey Rivera,['Germany'],Artist,1911,73,47,1984
Mr. Kyle Turner,['Israel'],Artist,1903,45,45,1948
Misty Horton,"['French Southern Territories', 'Moldova']",Racing automobile driver; formula one driver,1903,32,16,1935
John Farmer,['Liechtenstein'],Artist,1870,37,86,1907
Douglas Flores,['Estonia'],Artist,1892,20,6,1912
John Wilson,"['Egypt', 'Botswana']",Artist,1903,7,73,1910
Brian Brewer,"['Tuvalu', 'Northern Mariana Islands']",Researcher,1923,47,52,1970
Hannah Rose,['Netherlands'],Journalist,1882,42,45,1924
Jennifer Jones,"['Saint Martin', 'Bhutan']",Aristocrat,1870,65,48,1935
Seth Villanueva,['Netherlands'],Artist,1923,62,35,1985
Donna Cooke,['Albania'],Artist,1908,85,52,1993
Margaret Wagner,['Cyprus'],Artist,1899,43,35,1942
Deborah Tapia,"['Mauritius', 'Afghanistan']",Artist,1888,17,77,1905
Travis White,"['Equatorial Guinea', 'Venezuela']",Politician,1893,19,21,1912
Cheryl Fletcher,['Finland'],Politician,1905,50,7,1955
Mario Parsons,['French Guiana'],Military personnel,1896,64,17,1960
Eric Huerta,"['Guam', 'Latvia']",Politician,1888,33,19,1921
Stephanie Green,"['Saint Barthelemy', 'Swaziland']",Artist,1898,70,44,1968
Adam Williams,['Haiti'],Artist,1924,77,79,2001
Sharon Cox,"['Angola', 'Gambia']",Politician,1895,1,52,1896
Diana Miller,"['Palau', 'Panama']",Astronomer,1882,24,62,1906
Troy Perez,['El Salvador'],Artist,1895,30,37,1925
Christina Morgan,['United Kingdom'],Artist,1903,25,29,1928
Kevin Love,"['Micronesia', 'Ukraine']",Researcher,1920,19,78,1939
Robert Burton,['Nepal'],Journalist,1896,3,77,1899
Stephanie Clark,"['Norfolk Island', 'Cape Verde']",Researcher,1880,34,42,1914
Dylan Holmes,"['Guadeloupe', 'Martinique']",Artist,1877,60,9,1937
Daniel Holder,['Palestinian Territory'],Artist,1871,0,43,1871
Christopher Mason,['Saint Kitts and Nevis'],Artist,1886,10,24,1896
Ricardo Compton,['Togo'],Consort,1871,12,32,1883
Debbie Cole,['Netherlands'],Researcher,1872,62,19,1934
Elizabeth Goodman,"['Canada', 'Morocco']",Athlete,1881,11,52,1892
Leah Davis,['Finland'],Politician,1897,73,19,1970
Mr. Joshua Bailey,['South Africa'],Artist,1914,48,53,1962
Rickey Lewis,['Costa Rica'],Military personnel,1872,62,30,1934
Yvonne Johnson,"['Nepal', 'Netherlands Antilles']",Politician,1872,11,63,1883
Karen Sanford,['Sao Tome and Principe'],Religious figure,1873,86,2,1959
Johnny Good,"['Mongolia', 'Nauru']",Journalist,1918,89,6,2007
Brendan Williams,"['Azerbaijan', 'Colombia']",Artist,1883,79,3,1962
James Martinez,['Jordan'],Professional wrestler,1872,21,35,1893
John Rocha,"['Pitcairn Islands', 'Cyprus']",Researcher,1921,71,85,1992
Diana Johnston,['Saint Barthelemy'],Artist,1922,17,34,1939
Shane Parrish,"['Guam', 'British Virgin Islands']",Politician,1900,42,83,1942
William James,['El Salvador'],Artist,1881,85,36,1966
Colton Morrison,"['Burkina Faso', 'France']",Artist,1872,38,40,1910
Valerie Arnold,"['Israel', 'Australia']",Artist,1875,24,15,1899
Sara Moody,['Qatar'],Politician,1912,10,53,1922
Brian Marshall Jr.,"['French Southern Territories', 'Guinea']",Bobsledder,1886,58,63,1944
Patrick Shea,['Lebanon'],Politician,1888,47,32,1935
Wyatt Small,['Bahamas'],Athlete,1884,80,6,1964
Ashley Snyder,['Saint Lucia'],Politician,1883,66,62,1949
Darius Mullen,['Jordan'],Athlete,1873,18,4,1891
Danny Spence,['Ethiopia'],Artist,1898,72,72,1970
Jessica Chase,"['Madagascar', 'Iraq']",Politician,1922,58,2,1980
Deborah Martin,"['Kyrgyz Republic', 'Cameroon']",Athlete,1901,19,20,1920
Gina Mccarthy,"['Guinea', 'Niger']",Athlete,1887,82,77,1969
Michelle Miles,"['Kuwait', 'Portugal']",Artist,1922,49,87,1971
Christine Evans,['French Southern Territories'],Athlete,1904,23,32,1927
Travis Williams,"['India', 'New Zealand']",Artist,1894,54,35,1948
Paul Ali,"['Gambia', 'Palau']",Politician,1898,78,35,1976
Paula Ross,"['Nepal', 'Nicaragua']",Artist,1889,52,71,1941
Juan Mckinney,['Bulgaria'],Artist,1922,46,89,1968
Dr. Jennifer Villegas,['British Virgin Islands'],Religious figure,1896,80,39,1976
Christopher Carey,"['Antarctica (the territory South of 60 deg S)', 'United Arab Emirates']",Military personnel,1905,75,43,1980
Ariel Rose,"['Guyana', 'Namibia']",Military personnel,1875,43,59,1918
Kayla Johnson,"['Trinidad and Tobago', 'Palau']",Artist,1919,77,35,1996
Breanna Burns,"['Reunion', 'Bolivia']",Artist,1915,4,25,1919
Steven Casey,"['Croatia', 'Zambia']",Serial killer,1892,24,20,1916
Eric Davis,['Armenia'],Artist,1885,5,22,1890
Michael Watson,['Tajikistan'],Artist,1886,16,15,1902
Kevin Andrews,['Switzerland'],Artist,1918,74,15,1992
George Gutierrez,"['Svalbard & Jan Mayen Islands', 'Sierra Leone']",Gangster,1922,22,74,1944
Katherine Thomas,"['Jordan', 'British Indian Ocean Territory (Chagos Archipelago)']",Artist,1898,43,37,1941
Brian Vasquez,"['Antigua and Barbuda', 'Faroe Islands']",Artist,1901,77,4,1978
Jennifer Conley,['Thailand'],Politician,1904,55,14,1959
Michael Mclaughlin,"['Georgia', 'Korea']",Artist,1924,23,0,1947
Brian Stewart,['Switzerland'],Artist,1898,50,33,1948
Brittany Ellis,"['Georgia', 'Solomon Islands']",Athlete,1908,73,54,1981
Albert Martin,"['Argentina', 'Paraguay']",Artist,1906,65,78,1971
Joseph Garcia,['Italy'],Researcher,1875,40,78,1915
Amber Diaz,"['Mauritius', 'Saint Kitts and Nevis']",Teacher,1914,66,28,1980
Jennifer Young PhD,"['Pitcairn Islands', 'Belgium']",Military personnel,1920,47,67,1967
Logan Nelson,"['Nauru', 'Qatar']",Politician,1888,20,23,1908
Thomas Thomas,['Peru'],Artist,1887,16,68,1903
Hunter Collins II,"['Kazakhstan', 'Netherlands']",Nun,1881,54,37,1935
Vincent Holder,"['Namibia', 'Cambodia']",Artist,1889,27,83,1916
Nicholas Ramos,"['Trinidad and Tobago', 'Greece']",Researcher,1922,70,27,1992
Nathan Dudley,['Palestinian Territory'],Artist,1913,15,26,1928
Amanda West,"['Korea', 'South Africa']",Researcher,1907,81,39,1988
Matthew Allen,"['Singapore', 'Israel']",Researcher,1876,13,56,1889
Ethan Brewer,"['Ethiopia', 'Norfolk Island']",Artist,1876,3,38,1879
Angelica Tucker,['Antarctica (the territory South of 60 deg S)'],Artist,1873,84,71,1957
James Short,['Bouvet Island (Bouvetoya)'],Artist,1894,51,0,1945
Hector Hartman,"['Cambodia', 'Dominican Republic']",Artist,1922,57,8,1979
Terry Moore,['Egypt'],Researcher,1884,57,29,1941
Kaitlin Townsend,['Estonia'],Artist,1884,88,69,1972
Kathleen Perez,['Madagascar'],Politician,1894,40,57,1934
Elizabeth Wallace,['Ghana'],Racing driver; racing automobile driver,1893,7,78,1900
Stephanie Perez,"['Peru', 'Bhutan']",Artist,1918,41,72,1959
Tyler Ramirez,['Lesotho'],Politician,1887,38,59,1925
Angelica Anderson,['China'],Politician,1894,49,88,1943
Yolanda White,['Venezuela'],Politician,1904,13,11,1917
Amanda Tyler,['Venezuela'],Politician,1897,68,3,1965
Dr. Meredith Cameron,['Myanmar'],Cosmetologist,1895,59,56,1954
Sharon Kennedy,['Honduras'],Politician,1875,46,42,1921
Allison Bradley,['Mali'],Military personnel,1871,46,43,1917
Alexis Martinez,"['Montenegro', 'Wallis and Futuna']",Artist,1895,42,44,1937
Rick Harrison,['Mozambique'],Artist,1882,32,33,1914
Andre Johnson,['Taiwan'],Artist,1894,42,25,1936
Michelle Khan,"['Philippines', 'New Caledonia']",Artist,1908,82,53,1990
Anna Jackson,['Israel'],Artist,1882,50,21,1932
Crystal Morris,['France'],Religious figure,1912,40,3,1952
Aaron Davis,['Somalia'],Athlete,1892,19,75,1911
Richard Andrews,['Trinidad and Tobago'],Artist,1873,73,13,1946
Samantha Blake,['Central African Republic'],Artist,1880,62,76,1942
David Reed,['Kiribati'],Artist,1919,10,80,1929
Vanessa Cross,['Germany'],Researcher,1918,38,43,1956
David Gray,"['Ireland', 'South Africa']",Artist,1893,31,84,1924
Melissa Arellano,"['Turkey', 'Bolivia']",Researcher,1921,18,42,1939
Tommy Kent,['Aruba'],Teacher,1903,72,49,1975
Kimberly West,['Honduras'],Artist,1870,86,63,1956
Karen Norton,"['Congo', 'Bolivia']",Artist,1894,1,2,1895
Jonathan Richards,['Bhutan'],Politician,1912,22,4,1934
Mr. Scott Morgan,['Peru'],Athlete,1896,64,33,1960
Michelle Banks,"['Lithuania', 'Armenia']",Artist,1879,85,51,1964
Mr. John Martinez,"['Saint Barthelemy', 'Niger']",Researcher,1921,22,7,1943
Juan Hines,"['Sweden', 'United Arab Emirates']",Artist,1885,82,18,1967
Monique Johnson,"['Guam', 'Isle of Man']",Artist,1872,45,83,1917
Sara Smith,['Uzbekistan'],Artist,1881,34,80,1915
Jacqueline Hughes,['Uzbekistan'],Athlete,1919,31,79,1950
Angela Richardson,"['Norfolk Island', 'Azerbaijan']",Artist,1910,25,26,1935
Samuel Hahn,['Nauru'],Engineer,1886,16,75,1902
Kristopher Farley,['Cambodia'],Presbyter,1896,88,2,1984
William Foster,"['United States Virgin Islands', 'Moldova']",Artist,1895,53,74,1948
Nancy Floyd,['Western Sahara'],Artist,1872,0,9,1872
Andrew Hart,"['Belarus', 'Mongolia']",Artist,1904,32,19,1936
Lacey Porter,['Ghana'],Researcher,1906,66,72,1972
Ronald Rivera,['Saint Vincent and the Grenadines'],Athlete,1913,82,39,1995
Collin Waller,"['Tokelau', 'Guinea']",Cinematographer,1917,7,24,1924
Julie Clark,['Guam'],Architect,1910,77,29,1987
Jason Santiago,['Venezuela'],Pathologist; forensic pathologist,1915,83,24,1998
Jessica Allen,['Barbados'],Politician,1923,10,61,1933
Audrey Chapman,"['Yemen', 'Ireland']",Artist,1871,18,33,1889
Kenneth Pena,"['Cambodia', 'Kuwait']",Politician,1870,26,6,1896
Katie Singleton,['Heard Island and McDonald Islands'],Artist,1898,39,11,1937
Thomas Fuller,"['France', 'French Polynesia']",Religious figure,1880,30,20,1910
Chad Edwards,"['Tuvalu', 'Tokelau']",Artist,1910,75,70,1985
Lisa Watson,['Malawi'],Artist,1871,30,19,1901
Maureen Brown,"['Nauru', 'Cambodia']",Artist,1879,76,7,1955
Julia Clark,"['Isle of Man', 'Thailand']",Architect,1871,35,55,1906
Joseph Hernandez,"['Taiwan', 'Azerbaijan']",Politician,1904,9,37,1913
Ashley Brown,['United States Virgin Islands'],Athlete,1920,40,89,1960
Jerry Lowe,"['Niue', 'Malaysia']",Artist,1918,78,27,1996
Tina Becker,"['Argentina', 'Japan']",Artist,1902,43,23,1945
Mary Morton,"['Cape Verde', 'Togo']",Artist,1898,70,68,1968
Terry Hernandez,['Hungary'],Artist,1920,81,88,2001
Bonnie Harris,"['Sweden', 'Panama']",Flying ace,1920,25,79,1945
Connor Meyer,['Bahrain'],Politician,1879,35,56,1914
Megan Davis,['Korea'],Dentist,1871,37,85,1908
Corey Contreras,"['Christmas Island', 'Mozambique']",Athlete,1878,45,46,1923
Patrick Weeks,['Tonga'],Researcher,1886,47,21,1933
Claudia Osborne,"['Iceland', 'Taiwan']",Politician,1891,4,56,1895
Emily Phillips,"['Northern Mariana Islands', 'Norfolk Island']",Artist,1886,14,41,1900
Christopher Clarke,"['Algeria', 'Zambia']",Artist,1908,36,12,1944
Jennifer Myers DDS,"['Nicaragua', 'Madagascar']",Politician,1890,0,30,1890
Alisha Rodriguez,"['Netherlands', 'Moldova']",Artist,1884,38,58,1922
Rachel Valencia,"['United States Virgin Islands', 'Brunei Darussalam']",Psychologist; psychoanalyst,1913,46,84,1959
Cindy Nguyen,"['Heard Island and McDonald Islands', 'Portugal']",Spy,1905,56,19,1961
Melanie Brown,['Burundi'],Aristocrat; art collector,1878,33,84,1911
Charles Payne,['Cameroon'],Politician,1870,24,18,1894
Nicole Myers,['Belize'],Artist,1901,39,16,1940
Cheryl Jones,"['Portugal', 'Finland']",Politician,1890,13,58,1903
Connor Aguilar,['France'],Military personnel,1880,41,9,1921
Jessica Mcdonald,['Russian Federation'],Artist,1904,11,14,1915
Amy Richards,['United States of America'],Physician,1913,25,16,1938
Bobby Henderson,['Czech Republic'],Artist,1890,11,88,1901
Lynn Campbell,['India'],Artist,1886,77,12,1963
Teresa Villarreal,['Guatemala'],Politician,1899,70,47,1969
Hunter Gonzalez,"['Benin', 'Seychelles']",Artist,1874,72,29,1946
Michael Wilson,['Taiwan'],Researcher,1907,68,37,1975
Christopher Nelson,['Venezuela'],Artist,1871,55,49,1926
Felicia Fernandez,"['Russian Federation', 'Hungary']",Politician,1921,1,69,1922
Stacy Schneider,"['Costa Rica', 'French Guiana']",Artist,1919,40,4,1959
Jonathan Hendricks,['Libyan Arab Jamahiriya'],Athlete,1915,2,65,1917
Nancy Anderson,"['Guam', 'El Salvador']",Religious figure,1897,39,10,1936
Susan Green,"['Israel', 'Germany']",Artist,1882,38,79,1920
David Klein,"['Oman', 'Falkland Islands (Malvinas)']",Artist,1884,36,38,1920
Michelle Warren,"['Samoa', 'Brazil']",Artist,1894,33,8,1927
Randy Park,"['Guatemala', 'Guinea']",Artist,1889,85,70,1974
Daniel Russo,['Benin'],Researcher,1882,46,10,1928
Sonia West,['Grenada'],Artist,1899,64,79,1963
Joseph Johnson,['Turks and Caicos Islands'],Politician,1908,66,70,1974
Kristen Sexton,['Lebanon'],Gangster,1897,61,20,1958
Dean Santos,"['Niger', 'Rwanda']",Religious figure,1897,15,41,1912
Dennis Mason,['Bhutan'],Artist,1919,70,11,1989
Gabriel Lewis,"['Serbia', 'Montserrat']",Aristocrat,1903,81,2,1984
James Horn,"[""Lao People's Democratic Republic"", 'Peru']",Politician,1870,61,43,1931
Douglas Adams,['Greenland'],Politician,1885,19,65,1904
Lacey Baker,['Canada'],Religious figure,1900,71,38,1971
Lori Ritter,"['Isle of Man', 'Jersey']",Artist,1881,43,51,1924
Madison Weber,['Saint Barthelemy'],Artist,1907,72,24,1979
Jessica Chaney,"['Liechtenstein', 'Palestinian Territory']",Artist,1916,22,12,1938
Eric Hansen,['Hong Kong'],Artist,1923,73,49,1996
Steven Arroyo,['Azerbaijan'],Politician,1891,9,43,1900
Shawn Adams,"['Zimbabwe', 'Samoa']",Politician,1871,26,52,1897
Samantha Long,"['United States Minor Outlying Islands', 'Moldova']",Artist,1897,60,76,1957
Sarah Ramsey,"['Haiti', 'Mayotte']",Artist,1913,9,38,1922
Kayla Myers,['Vietnam'],Military personnel,1899,14,42,1913
Keith Jennings,"['Guyana', 'Uganda']",Politician,1904,36,58,1940
Jeffrey Alexander,"['Comoros', 'Estonia']",Researcher,1883,61,30,1944
David Harris Jr.,"['Japan', 'Ethiopia']",Sovereign,1922,13,64,1935
Emily Barron,['Singapore'],Artist,1892,19,47,1911
Eric Thomas,"['British Virgin Islands', 'Togo']",Artist,1884,55,12,1939
Patricia Andrews,"['Bhutan', 'New Zealand']",Artist,1870,73,0,1943
John Wang,['Pitcairn Islands'],Artist,1872,9,34,1881
Crystal Newton,['China'],Artist,1878,71,23,1949
Ashley Greene,['Cayman Islands'],Inventor; tailor,1895,56,39,1951
Amy Mcdonald,"['Cambodia', 'Costa Rica']",Artist,1901,44,6,1945
Emily Vaughn,"['Qatar', 'Pitcairn Islands']",Artist,1887,60,72,1947
Roger Hall,['Burundi'],Artist,1911,22,83,1933
Glenn Donaldson,"['Panama', 'Syrian Arab Republic']",Politician,1916,10,52,1926
Kenneth Ramos,['Greece'],Artist,1882,5,70,1887
Kevin Parks,['Saint Kitts and Nevis'],Researcher,1879,35,39,1914
Tiffany Le,['Cape Verde'],Artist,1879,61,36,1940
Juan Bell,"['Brazil', 'Equatorial Guinea']",Artist,1878,13,19,1891
David Norris,['Yemen'],Artist,1890,86,41,1976
Joan Carr,"['Cameroon', 'Gambia']",Researcher,1898,7,17,1905
Rachel Reynolds,['Liechtenstein'],Head of state,1898,5,85,1903
Troy Smith,['Tonga'],Artist,1887,76,19,1963
Betty Koch,['Malta'],Artist,1886,18,66,1904
Tyler Ho MD,"['Georgia', 'Guatemala']",Artist,1899,51,53,1950
Brandon Horton,"['Nigeria', 'Uruguay']",Artist,1898,81,60,1979
Angela Leach,"['Costa Rica', 'Mexico']",Artist,1890,60,19,1950
Gary Wood,['Liechtenstein'],Artist,1883,20,73,1903
Michael Kemp,"['Zimbabwe', 'Ukraine']",Politician,1870,66,88,1936
Jacob Osborn,"['Mexico', 'Taiwan']",Artist,1889,75,21,1964
Shelley Yoder,['Saint Pierre and Miquelon'],Journalist,1916,26,70,1942
Alison Ramirez,"['Portugal', 'Germany']",Politician,1922,48,51,1970
Johnny Roberts,['Cambodia'],Artist,1905,79,65,1984
Andre Davis,['Montserrat'],Artist,1879,75,30,1954
Jonathan Schmidt,['Swaziland'],Artist,1922,20,60,1942
Timothy Henderson,['Iceland'],Politician,1882,28,84,1910
Tyler Thompson,['Uganda'],Politician,1876,84,25,1960
Lisa Miller,"['Switzerland', 'Latvia']",Motorcycle racer; racing automobile driver; formula one driver,1877,14,80,1891
Russell Willis,['Taiwan'],Artist,1908,71,55,1979
Molly Davis,['Moldova'],Businessperson,1903,50,78,1953
Rebecca Haas,['Comoros'],Weightlifter,1894,9,10,1903
Rebecca Wilson,['Chad'],Regent,1880,22,18,1902
Zoe Smith,['Lesotho'],Artist,1913,63,24,1976
Judy Martinez,['Dominican Republic'],Artist,1922,35,68,1957
Kelly Moyer,"['Russian Federation', 'Mauritius']",Politician,1918,87,2,2005
Christopher Hull,['Ecuador'],Artist,1884,47,14,1931
Beverly Foster,['Ireland'],Researcher,1916,20,87,1936
Matthew Welch,['Montenegro'],Researcher,1910,7,24,1917
Nicole Caldwell,['Botswana'],Researcher,1914,12,10,1926
Melody Miller,"['Bahamas', 'Botswana']",Athlete,1896,87,16,1983
Shaun Austin,['Kenya'],Artist,1886,20,78,1906
Bernard Short,['Peru'],Researcher,1874,45,3,1919
Ian Smith,"['Jordan', 'Samoa']",Aristocrat,1871,19,43,1890
Yolanda Williams,"['Slovenia', 'Paraguay']",Artist,1879,80,71,1959
Terry Warren,['Sudan'],Artist,1922,27,86,1949
Brian Snow,"['New Zealand', 'Holy See (Vatican City State)']",Politician,1879,71,20,1950
Brittany Gibson,['Benin'],Politician,1898,86,80,1984
Erika Wu,['Vanuatu'],Artist,1884,51,83,1935
Megan Mccullough,['Trinidad and Tobago'],Artist,1889,56,61,1945
Michael Turner,"['Korea', 'Sudan']",Artist,1906,62,42,1968
Christopher Morgan,['Saint Vincent and the Grenadines'],Artist,1896,10,54,1906
Mrs. Chloe Jimenez DVM,['Maldives'],Artist,1873,36,85,1909
Desiree Sanchez,['Serbia'],Serial killer; male prostitution,1904,24,16,1928
Ronald Mcdaniel,['United States Virgin Islands'],Artist,1871,31,59,1902
Tracey Stewart,"['Serbia', 'Argentina']",Researcher,1872,27,55,1899
Vanessa Meadows,['Gabon'],Religious figure,1913,2,8,1915
Shawn Perez,['Indonesia'],Artist,1908,36,28,1944
Emily Morris,['Germany'],Artist,1904,18,62,1922
Scott Booker,"['Japan', 'Slovenia']",Conductor,1917,84,56,2001
Beverly Elliott,"['Bolivia', 'Cambodia']",Artist,1911,88,86,1999
Kimberly Baldwin,['Luxembourg'],Artist,1889,85,88,1974
Lauren Reynolds,"['Svalbard & Jan Mayen Islands', 'Albania']",Entrepreneur,1912,13,47,1925
Karen Suarez,"['Bermuda', 'Poland']",Artist,1885,49,1,1934
Kimberly Hardy,"['Tokelau', 'Saint Helena']",Artist,1897,50,39,1947
Katherine Smith,['Mongolia'],Religious figure,1898,7,65,1905
Thomas Smith,['Indonesia'],Artist,1871,80,70,1951
Laura James,['Iraq'],Politician,1898,38,47,1936
John Pratt,['United States Virgin Islands'],Artist,1917,21,47,1938
John Moore,['Sweden'],Artist,1922,12,65,1934
Matthew Hernandez,['Falkland Islands (Malvinas)'],Politician,1870,78,56,1948
Karen Steele,"['Central African Republic', 'Uruguay']",Politician,1892,39,85,1931
Lisa Webb,"['Uzbekistan', 'Netherlands']",First lady,1895,15,53,1910
Tommy Stone,"['Malta', 'Niger']",Athlete,1880,8,28,1888
Lucas Shannon,['French Polynesia'],Politician,1877,35,14,1912
Kevin Bryant,['Guadeloupe'],Artist,1890,56,34,1946
Michael Cobb PhD,['Mauritania'],Artist,1918,40,74,1958
Brenda Aguirre,['Bermuda'],Researcher,1899,49,89,1948
Thomas Booker,"['Tuvalu', 'Uruguay']",Athlete,1913,63,26,1976
Gabrielle Wallace,"['Kazakhstan', 'Libyan Arab Jamahiriya']",Researcher,1908,85,47,1993
Denise Schneider,"['Guatemala', 'Barbados']",Artist,1871,47,83,1918
Michael Miller,['Poland'],Politician,1876,80,2,1956
Nicholas Avila,"['Uzbekistan', 'Jordan']",Artist,1904,68,21,1972
Christopher Pham,"['Palau', 'Cayman Islands']",Athlete,1919,43,44,1962
Caleb Bryant,['Cape Verde'],Artist,1922,36,30,1958
Kenneth Roach,"['Hong Kong', 'Costa Rica']",Athlete,1893,0,6,1893
Jessica Walton,"['Saint Martin', 'Burkina Faso']",Artist,1895,33,59,1928
Tammy Chavez,['Saint Lucia'],Military personnel,1916,84,3,2000
Randy Martinez,['Chad'],Politician,1889,39,5,1928
Marvin Sandoval,"['Bermuda', 'Trinidad and Tobago']",Artist,1880,77,25,1957
Stephen Crawford,"['Gabon', 'Cape Verde']",Artist,1905,71,34,1976
Christopher West,"['Yemen', 'Luxembourg']",Artist,1897,11,65,1908
Shelly Johnson,"['Central African Republic', 'Ecuador']",Artist,1907,79,33,1986
Micheal Morgan,"['Honduras', 'Bosnia and Herzegovina']",Politician,1883,54,72,1937
Bryan Robinson,"['Lesotho', 'Iceland']",Artist,1905,62,39,1967
Victoria Roberts,['Holy See (Vatican City State)'],Politician,1898,74,21,1972
Victor Parks,['Turkmenistan'],Researcher,1883,66,28,1949
Gregory Wilson,"['Belarus', 'Bhutan']",Cowboy; serial killer; gambler; ranch hand,1905,86,86,1991
Kristen Lopez,"['Saint Lucia', 'Antarctica (the territory South of 60 deg S)']",Ballet dancer; choreographer; dancer,1918,29,89,1947
Joseph Nguyen,"['Ghana', 'Guam']",Artist,1892,78,86,1970
Anita Orozco,"['Burundi', 'Latvia']",Artist,1919,33,44,1952
Brett Noble,"['Grenada', 'Dominica']",Researcher,1912,40,24,1952
Wendy Singh,['Guinea'],Artist,1908,17,40,1925
Brittany Hill,['Jamaica'],Administrator of the government,1912,77,32,1989
Shane Moody,"['United Arab Emirates', 'Senegal']",Artist,1874,6,16,1880
Tara Hunter,['Russian Federation'],Artist,1910,45,64,1955
Richard Taylor,"['Benin', 'Suriname']",Politician,1892,83,86,1975
Antonio Harris,['Russian Federation'],Torturer; concentration camp guard,1894,58,31,1952
Carlos Olson,['Central African Republic'],Politician,1888,56,58,1944
Karina Acosta,['Heard Island and McDonald Islands'],Artist,1887,47,2,1934
Carlos Arnold MD,"['Guam', 'Qatar']",Artist,1885,82,84,1967
Kimberly Davidson,"['Brunei Darussalam', 'Somalia']",Athlete,1910,48,4,1958
Mark Bryan PhD,"['New Caledonia', 'Slovenia']",Politician,1870,87,33,1957
Randy Vaughn,['Seychelles'],Artist,1896,10,71,1906
Kelli Franco,"['Aruba', 'Falkland Islands (Malvinas)']",Politician,1914,79,54,1993
Melissa Osborne,['Russian Federation'],Artist,1890,7,6,1897
Emily Smith,['Lithuania'],Artist,1914,78,63,1992
Brian Thompson,"['Bhutan', 'Norway']",Artist,1915,1,12,1916
Henry King,"['North Macedonia', 'Rwanda']",Teacher,1892,44,42,1936
Matthew Silva,['Panama'],Researcher,1885,57,42,1942
Dan Schaefer,['Oman'],Artist,1905,26,65,1931
Michael Norris,"[""Lao People's Democratic Republic"", 'Honduras']",Researcher,1912,55,53,1967
Jessica Harvey,"['Benin', 'Mali']",Judge,1902,34,0,1936
Margaret Pham,['Christmas Island'],Researcher,1902,42,19,1944
Steven Hubbard,"['Belarus', 'Georgia']",Researcher,1872,24,4,1896
Sonya Garcia,['Dominican Republic'],Military personnel,1910,68,55,1978
Kelly Mcclure,['Macao'],Artist,1917,78,80,1995
Lisa Hancock,['Saint Kitts and Nevis'],Politician,1921,6,63,1927
Theresa Dean,"['Timor-Leste', 'Norfolk Island']",Astronomer,1870,82,78,1952
Meagan Morgan,"['Gibraltar', 'Pitcairn Islands']",Artist,1891,0,49,1891
Stacey Johnson,['Cambodia'],Artist,1917,65,68,1982
Nathan Hutchinson,['Solomon Islands'],Researcher,1890,85,59,1975
Jennifer Smith,"['Antigua and Barbuda', 'Moldova']",Politician,1906,78,21,1984
Nicole Bennett,"['Suriname', 'Ukraine']",Artist,1916,23,4,1939
Ashley Chen,"['Antigua and Barbuda', 'Isle of Man']",Customs officer; beekeeper,1882,47,22,1929
Edwin Diaz,"['Kenya', 'Canada']",Researcher,1889,73,35,1962
Michael Wood,"['Monaco', 'Bosnia and Herzegovina']",Artist,1892,56,18,1948
Julie Ware,['North Macedonia'],Artist,1909,43,7,1952
Henry Mayo,['Saint Vincent and the Grenadines'],Politician,1893,77,65,1970
Frederick Donaldson,"['Belize', 'Saint Lucia']",Artist,1870,85,55,1955
Eric Conner,['French Guiana'],Artist,1883,13,58,1896
Rebecca Flores,"['New Caledonia', 'Albania']",Politician,1871,87,22,1958
Nathan Morton,['El Salvador'],Artist,1882,12,68,1894
Daniel Roth,['Australia'],Artist,1908,88,64,1996
Laura Miller,['Singapore'],Artist,1902,25,66,1927
Kathy Irwin,['Switzerland'],Artist,1922,26,7,1948
Sean Stuart,['Madagascar'],Artist,1902,14,56,1916
Brandy Evans,"['Greenland', 'Sudan']",Politician,1873,52,38,1925
Amy Graves,"['Guam', 'Togo']",Artist,1921,13,0,1934
Kelly Johnson,"['Mali', 'Eritrea']",Politician,1896,6,86,1902
Jessica Campbell,['Netherlands'],Artist,1878,50,5,1928
Jennifer Hinton,['Angola'],Engineer,1874,53,66,1927
Karen Wade,['Solomon Islands'],Politician,1913,32,78,1945
Robert Charles,['Burkina Faso'],Researcher,1906,62,74,1968
Anthony Johnson,['Australia'],Artist,1923,45,65,1968
Sarah Christian,"['Mexico', 'Malawi']",Politician,1889,73,9,1962
Michael Jackson,"['Gambia', 'Seychelles']",Criminal,1920,66,13,1986
Daniel Mercado,['Congo'],Artist,1917,47,25,1964
Michael Thomas,"['Holy See (Vatican City State)', 'Martinique']",Artist,1894,13,61,1907
Karen Fisher,"['Congo', 'Iraq']",Politician,1892,31,54,1923
Megan Farrell,"['San Marino', 'Guam']",Artist,1874,73,45,1947
Patricia Garza,['French Southern Territories'],Artist,1878,28,10,1906
Theresa Gray,"['Sweden', 'Saint Kitts and Nevis']",Artist,1921,39,59,1960
Jacqueline Blackburn,"['Kazakhstan', 'Latvia']",Politician,1871,57,43,1928
Diane Weber,['Switzerland'],Artist,1876,71,86,1947
Steven Simpson Jr.,"['Portugal', 'Fiji']",Athlete,1917,89,49,2006
Michelle Hamilton,"['Norfolk Island', 'Fiji']",Aristocrat,1904,65,20,1969
James Mccoy,['Gambia'],Artist,1894,13,32,1907
Richard Gamble,['Chile'],Artist,1876,18,76,1894
Katelyn Daniel,"['Korea', 'Portugal']",Artist,1891,9,79,1900
Donna Hodges,['Belgium'],Aristocrat,1895,1,42,1896
Robert Guerra,"[""Lao People's Democratic Republic"", 'Madagascar']",Racing automobile driver,1913,47,84,1960
Sarah Garcia,"['Brazil', 'French Polynesia']",Politician,1875,25,15,1900
Raymond Paul,"['Uganda', 'Colombia']",Artist,1918,87,46,2005
Larry Buckley,"['Gambia', 'Norway']",Artist,1884,41,35,1925
Angela Hensley,['Armenia'],Artist,1899,67,18,1966
Pamela Guerrero,"['Turkey', 'Greece']",Artist,1898,55,7,1953
Rebecca Deleon,['Angola'],Artist,1893,21,78,1914
Leah Diaz,"['Vanuatu', 'United States Minor Outlying Islands']",Artist,1895,30,60,1925
Juan Hoffman,['Spain'],Nurse,1912,16,80,1928
Michelle Powell,"['France', 'Svalbard & Jan Mayen Islands']",Athlete,1871,46,22,1917
Deborah Gonzalez,['Tajikistan'],Politician,1892,13,66,1905
Jean Huerta,['Samoa'],Politician,1893,63,75,1956
Jacqueline Griffin,['Sao Tome and Principe'],Artist,1889,58,27,1947
Crystal Moody,['North Macedonia'],Researcher,1922,18,47,1940
Thomas Griffin,"['Senegal', 'Yemen']",Artist,1878,3,68,1881
Brian Ryan,['Slovenia'],Artist,1884,44,72,1928
Jeffrey Graves,"['Japan', 'Andorra']",Religious figure,1901,57,45,1958
Christopher Wagner,['Aruba'],Athlete,1890,2,34,1892
Russell Boyer,"['Ecuador', 'Singapore']",Artist,1907,29,50,1936
Adam Barnes,"['Kyrgyz Republic', 'Argentina']",Physician,1907,7,53,1914
Veronica Walters,"['Antarctica (the territory South of 60 deg S)', 'Wallis and Futuna']",Teacher,1897,1,11,1898
Jacob Rowe,['Central African Republic'],Advocate; resistance fighter,1902,60,20,1962
Jason Meadows,"['Oman', 'Bulgaria']",Politician,1918,78,52,1996
Anthony Strong,['Mayotte'],Artist,1914,19,30,1933
Lauren Collins,"['Ghana', 'Nepal']",Artist,1872,68,2,1940
Crystal Parks,"['Macao', 'Saint Kitts and Nevis']",Architect,1891,57,40,1948
Julia Hardin,['Guam'],Politician,1889,12,78,1901
April Ruiz,"['Cambodia', 'Equatorial Guinea']",Politician,1914,78,49,1992
Charles Williams,['Guinea-Bissau'],Researcher,1899,14,48,1913
Jennifer Carter MD,"['Poland', 'Vanuatu']",Researcher,1913,32,30,1945
Rodney Erickson,"['Guyana', 'Latvia']",Researcher,1920,53,40,1973
Brittany Smith,['Barbados'],Artist,1898,25,86,1923
Stephanie Simon,['Sao Tome and Principe'],Artist,1882,37,29,1919
Daniel Clayton,"['Antarctica (the territory South of 60 deg S)', 'Macao']",Politician,1878,39,85,1917
Heather Higgins,['Niger'],Researcher,1873,82,3,1955
David Crawford,['El Salvador'],Researcher,1878,49,44,1927
Leslie Branch,"['Reunion', 'Maldives']",Athlete,1890,17,18,1907
Carrie Jackson,['Saint Pierre and Miquelon'],Artist,1923,48,77,1971
Cody Nguyen,"['Mexico', 'Guam']",Artist,1871,51,33,1922
Raven Lynch,['Guatemala'],Artist,1886,6,16,1892
Victor Blair,"['Australia', 'Israel']",Artist,1902,83,62,1985
Aaron Wilson,"['France', 'San Marino']",Athlete,1920,46,89,1966
Michelle Green,"['Iraq', 'Cyprus']",Military personnel,1899,83,1,1982
Michael Sellers,['Saudi Arabia'],Artist,1914,35,86,1949
Tracy Beasley,"['Albania', 'New Caledonia']",Military personnel,1923,7,30,1930
Michael Phillips,['Namibia'],Artist,1892,46,14,1938
Christina Carter,"['Belize', 'French Guiana']",Artist,1877,11,36,1888
Linda Thomas,['Chile'],Artist,1915,23,31,1938
Robin Frederick,"['Bahamas', 'Indonesia']",Socialite,1874,70,65,1944
Beth Lawrence,"['Kuwait', 'Ecuador']",Artist,1918,33,73,1951
Mary Hanson,"['Brazil', 'Saint Kitts and Nevis']",Athlete,1881,87,41,1968
Robert Foley,['Bangladesh'],Athlete,1885,21,47,1906
Zachary Sanford,['Burundi'],Revolutionary; terrorist,1917,34,11,1951
Dean Patterson,['Gabon'],Artist,1880,50,81,1930
Antonio Chan,"['Macao', 'Monaco']",Politician,1891,86,23,1977
Dr. Riley Miller,['Ethiopia'],Artist,1913,83,16,1996
Lauren Nelson,['South Africa'],Artist,1896,36,42,1932
April Jones,"['Botswana', 'Holy See (Vatican City State)']",Athlete,1903,54,22,1957
Connie Shields,['Sierra Leone'],Artist,1905,80,21,1985
Rebecca Henderson,"['Syrian Arab Republic', 'Eritrea']",Hajduk; abadÅ¾ija; revolutionary,1912,17,60,1929
Tracy Butler,"['French Guiana', 'Guinea']",Artist,1915,63,54,1978
Rose Coleman,['Belgium'],Religious figure,1920,24,19,1944
Thomas Mueller,"['Burkina Faso', 'Dominica']",Artist,1878,34,78,1912
Bobby Kim,['Australia'],Artist,1891,75,80,1966
Christina Pratt,['Cayman Islands'],Politician,1871,71,12,1942
Amber Ford,"['Malta', 'Bhutan']",Artist,1911,35,59,1946
Christopher Ibarra,['Burundi'],Athlete,1902,0,30,1902
Stephanie Martinez,['Papua New Guinea'],Police officer,1872,2,51,1874
Brian Williams,"['Brunei Darussalam', 'Nigeria']",Artist,1896,45,64,1941
Meghan Porter,['Senegal'],Military personnel,1870,12,89,1882
William Johnson,['Papua New Guinea'],Ballet dancer,1884,70,74,1954
Jennifer Cortez,['Pitcairn Islands'],Politician,1879,56,66,1935
John Waller,"['Belize', 'Latvia']",Artist,1922,39,66,1961
Anthony Sanders,"['Senegal', 'Jamaica']",Athlete,1902,9,88,1911
Carlos Berry,['Tunisia'],Military personnel,1907,72,25,1979
Kerry Blanchard,"['Guatemala', 'Paraguay']",Artist,1872,77,43,1949
Steven Stewart,['Iceland'],Artist,1902,10,42,1912
Adam Myers,"['Christmas Island', 'Oman']",Researcher,1911,2,29,1913
Leslie Rich,"['Micronesia', 'Luxembourg']",Athlete,1905,14,50,1919
Mike Horn,['Netherlands'],Politician,1887,76,10,1963
Jonathan House,"['Vanuatu', 'Iraq']",Artist,1921,45,62,1966
Terrence Carroll,['Rwanda'],Artist,1906,33,32,1939
Dylan Wiggins,['Palau'],Athlete,1879,16,7,1895
Roy Vaughn,"['Equatorial Guinea', 'Iraq']",Politician,1911,52,0,1963
Jerry Jones,"['Saint Vincent and the Grenadines', 'Kuwait']",Politician,1890,71,87,1961
Wendy Pearson,['New Zealand'],Artist,1871,27,78,1898
Timothy Fuller,"['Equatorial Guinea', 'Martinique']",Athlete,1902,56,46,1958
Andrea Cooper,"['Guinea-Bissau', 'Paraguay']",Politician,1889,61,46,1950
Krista Smith,"['Fiji', 'Venezuela']",Artist,1882,45,21,1927
Richard Buckley,"['Libyan Arab Jamahiriya', 'Mayotte']",Artist,1906,27,50,1933
James Boyd,"['Pitcairn Islands', 'Montserrat']",Artist,1902,53,45,1955
Debra Anderson,['Libyan Arab Jamahiriya'],Politician,1890,76,9,1966
Edward Gonzalez,"['Puerto Rico', 'Libyan Arab Jamahiriya']",Artist,1884,72,23,1956
Kent Marks,"['Djibouti', 'Iceland']",Military personnel,1887,45,68,1932
Laura Walsh,['Falkland Islands (Malvinas)'],Politician,1917,50,19,1967
Katrina Ritter,"['Armenia', 'Greenland']",Artist,1913,56,87,1969
Lisa Santos,['Aruba'],Politician,1886,17,55,1903
Brittany Shaw,"['Papua New Guinea', 'Spain']",Politician,1924,73,53,1997
James Mckenzie,"['Sudan', 'Tokelau']",Artist,1915,32,73,1947
Daniel Trevino,['Palau'],Artist,1922,39,7,1961
Beth Marshall,"['Svalbard & Jan Mayen Islands', 'New Zealand']",Researcher,1909,59,86,1968
Tina Chen,['Paraguay'],Researcher,1910,38,57,1948
Regina Pineda,"['British Virgin Islands', 'Bouvet Island (Bouvetoya)']",Artist,1907,73,63,1980
Mary Lopez,"['Sri Lanka', 'San Marino']",Politician,1905,63,14,1968
Thomas Kim,"['Guadeloupe', 'United States of America']",Heilpraktiker,1877,3,63,1880
Juan Clark,['Luxembourg'],Artist,1879,33,58,1912
Thomas Henderson,['Dominica'],Bobsledder,1907,45,6,1952
Adam Hodges,"['Georgia', 'Kuwait']",Military personnel,1924,77,9,2001
Charles Freeman,['Bhutan'],Artist,1918,81,84,1999
Kristen Bell,['Uzbekistan'],Artist,1904,86,23,1990
Trevor Gilbert,"['Latvia', 'Cocos (Keeling) Islands']",Religious figure,1920,88,53,2008
Connie Navarro,"['Ghana', 'Australia']",Artist,1921,65,4,1986
David James,"['Greenland', 'Marshall Islands']",Athlete,1888,50,2,1938
Suzanne Martin,"['Antarctica (the territory South of 60 deg S)', 'Italy']",Military personnel,1905,17,78,1922
Jonathan Grant,['Saint Lucia'],Entrepreneur,1906,38,3,1944
Shirley Swanson,['Argentina'],Artist,1879,37,55,1916
Mark Patrick,"['Bosnia and Herzegovina', 'Gabon']",Religious figure,1918,53,30,1971
Jennifer Clark MD,"['Malaysia', 'Congo']",Politician,1876,70,28,1946
Julia Watson,['Gibraltar'],Female guards in nazi concentration camps; concentration camp guard,1906,8,59,1914
Adam Wright,"['Swaziland', 'Macao']",Artist,1873,39,59,1912
Veronica Griffin,['Tuvalu'],Artist,1910,88,52,1998
Austin Barnes,['Kyrgyz Republic'],Military personnel,1903,25,48,1928
Charles Miller,['Greenland'],Artist,1907,7,69,1914
Edward Morgan,"['Svalbard & Jan Mayen Islands', 'Cook Islands']",Artist,1872,55,70,1927
Jennifer Garcia,"['Reunion', 'Trinidad and Tobago']",Ruler,1916,34,35,1950
Stephanie Taylor,"['Spain', 'Portugal']",Politician,1893,66,27,1959
Stacy Brennan,"['Haiti', 'Jamaica']",Monk; ascetic,1873,40,7,1913
Brad Hayes,"['Ethiopia', 'New Caledonia']",Artist,1885,45,6,1930
Lauren Cruz,['Seychelles'],Artist,1887,29,17,1916
Charles Todd,['Kenya'],Artist,1913,66,44,1979
Justin Pitts,"['Chad', 'Latvia']",Athlete,1889,15,10,1904
Harold Adams,"['Cyprus', 'Turks and Caicos Islands']",Athlete,1874,5,79,1879
Aaron Raymond,['Tunisia'],Clarinetist,1901,44,71,1945
Amy Guerrero,"['Guatemala', 'Falkland Islands (Malvinas)']",Military personnel,1888,34,67,1922
Lisa Washington,"['Greenland', 'Saudi Arabia']",Lady-in-waiting,1920,44,80,1964
Adrian Hoover,['Faroe Islands'],Artist,1871,30,8,1901
Gary Clark,['Egypt'],Artist,1892,79,49,1971
Kimberly Williams,"['Liberia', 'New Zealand']",Artist,1897,64,0,1961
Taylor Boyd,"['Guyana', 'Chile']",Artist,1885,86,72,1971
Laura Rivers,['Gambia'],Artist,1879,27,82,1906
Gerald Smith,"['United States Minor Outlying Islands', 'Tanzania']",Cinematographer,1918,81,38,1999
Julian Smith,"['Gambia', 'Grenada']",Artist,1908,33,49,1941
Spencer Erickson,['Bulgaria'],Artist,1879,13,73,1892
Jonathan Carpenter,"['Netherlands Antilles', 'Czech Republic']",Artist,1893,52,72,1945
Margaret Smith,"['Mayotte', 'Niger']",Military personnel,1917,26,9,1943
Holly Bell,['Northern Mariana Islands'],Artist,1874,22,67,1896
Corey Hall,['Norfolk Island'],Artist,1872,11,88,1883
Mrs. Kaylee Curry,"['Tonga', 'Samoa']",Physician,1881,79,60,1960
Monica Jones,['French Guiana'],Inventor,1903,64,1,1967
Rebecca Adams,['Netherlands Antilles'],Politician,1907,63,27,1970
Paul Foster,"['Ethiopia', 'British Indian Ocean Territory (Chagos Archipelago)']",Politician,1913,0,57,1913
Sarah Johnson,['Swaziland'],Artist,1900,37,79,1937
Maxwell Aguilar,"['Syrian Arab Republic', 'Philippines']",Artist,1921,32,43,1953
Susan Fernandez,"['Slovakia (Slovak Republic)', 'Peru']",Athlete,1888,62,71,1950
Jason Mckinney,"['Kyrgyz Republic', 'Saint Pierre and Miquelon']",Artist,1898,47,14,1945
Ellen Adams,"['Cyprus', 'Nauru']",Politician,1890,38,87,1928
Miss Ashley Gray,['Sudan'],Artist,1890,87,27,1977
Ronald Maddox,['Macao'],Artist,1885,69,73,1954
Wendy Barnett,['Nauru'],Artist,1918,50,40,1968
Christopher Hall,['Qatar'],Artist,1880,12,18,1892
Matthew Lynch,['Philippines'],Artist,1918,56,85,1974
Frank Johnson,['Montenegro'],Artist,1878,13,82,1891
Bradley Cruz,"['Belize', 'Sudan']",Athlete,1913,15,29,1928
Charles Torres,['United States Minor Outlying Islands'],Artist,1882,5,2,1887
Catherine Wilson,['United States Virgin Islands'],Athlete,1879,11,42,1890
Diane Robertson,['Algeria'],Politician,1911,6,64,1917
Ricardo Charles,"['Bermuda', 'Saint Lucia']",Rower,1909,80,18,1989
Carol Lam,"['Korea', 'Mexico']",Artist,1908,66,73,1974
Kyle Rivera,['Sierra Leone'],Businessperson,1875,8,15,1883
Christopher Galvan,['Canada'],Artist,1888,37,56,1925
Patrick Day,['South Africa'],Politician,1896,12,20,1908
Darlene Crawford,['Palau'],Athlete,1870,36,55,1906
Natalie Turner,['Tajikistan'],Artist,1888,85,63,1973
Nichole Hardy,['Benin'],Artist,1877,72,78,1949
Ann Thomas,['Guatemala'],Artist,1902,56,28,1958
Eric Rasmussen,['Mauritius'],Military personnel,1884,61,63,1945
Cheryl Morgan,"['Andorra', 'New Caledonia']",Artist,1897,52,66,1949
John Hudson,['Jamaica'],Artist,1889,81,29,1970
Kevin Murphy,['Zambia'],Artist,1871,7,47,1878
Danielle Gonzalez,['Falkland Islands (Malvinas)'],Artist,1910,45,30,1955
Tara Patterson MD,['Nigeria'],Athlete,1873,74,80,1947
Jeremy Elliott,"['Libyan Arab Jamahiriya', 'Bhutan']",Artist,1912,9,9,1921
Kimberly Peck,['Togo'],Sovereign,1879,0,25,1879
Christopher Harper,['Yemen'],Politician,1889,5,23,1894
John Williams,['Angola'],Religious figure,1907,20,35,1927
Michael Jenkins,['Yemen'],Politician,1879,3,6,1882
Cathy Harris,"['Guinea', 'Suriname']",Businessperson,1902,41,48,1943
Kristen Branch DDS,['Northern Mariana Islands'],Art collector,1875,46,76,1921
Edward Smith,"['Costa Rica', 'New Caledonia']",Artist,1888,46,36,1934
Ernest White,"['Spain', 'Ecuador']",Artist,1889,78,53,1967
Matthew Singh,['Panama'],Artist,1921,36,14,1957
Bryan Wood,['Saudi Arabia'],Politician,1897,25,45,1922
Ashley Fleming,"['El Salvador', 'Armenia']",Artist,1882,14,31,1896
Robert Scott,"['Korea', 'Cayman Islands']",Politician,1874,75,67,1949
Mr. David Mccormick,"['Canada', 'Egypt']",Athlete,1880,47,10,1927
Donald Nguyen,"['Saint Barthelemy', 'United Kingdom']",Artist,1898,84,65,1982
Susan Mcconnell,"['Honduras', 'Comoros']",Artist,1917,86,34,2003
Donna Woods,"['Grenada', 'Jamaica']",Artist,1875,29,21,1904
Leah Newman MD,"['Iceland', 'Poland']",Artist,1890,29,13,1919
Paul Hoffman,['Cayman Islands'],Rower,1873,29,42,1902
Bruce Martinez,"['China', 'Albania']",Researcher,1870,16,14,1886
Brooke Peterson,['Jordan'],Artist,1879,30,6,1909
Joshua Martin,"['Finland', 'Seychelles']",Politician,1900,83,31,1983
Vicki Roberts,['Macao'],Artist,1883,65,73,1948
Emily Payne,"['Qatar', 'Macao']",Athlete,1906,12,8,1918
Caleb Jones,"['Tanzania', 'Germany']",Artist,1884,28,45,1912
Daniel Baker,"['Switzerland', 'Kuwait']",Politician,1874,21,17,1895
Victoria Ortega,['Guernsey'],Military personnel,1872,54,35,1926
Robert Bowers,['Micronesia'],Artist,1896,68,50,1964
Kelly Richardson,"['Niger', 'Fiji']",Businessperson,1890,63,79,1953
Juan Buckley,['Western Sahara'],Artist,1885,7,54,1892
Emily Parker,['Belgium'],Researcher,1890,33,6,1923
Robin Doyle,"['Equatorial Guinea', 'Bahamas']",Circus performer; amateur wrestler,1874,75,56,1949
Jennifer Mcpherson,"['Burundi', 'Argentina']",Religious figure,1880,79,41,1959
Scott Jones,"['Bulgaria', 'Gambia']",Artist,1913,30,19,1943
Diana Strickland,['Bosnia and Herzegovina'],Motorcycle racer; racing automobile driver,1888,42,85,1930
Martin Harrison,['Dominican Republic'],Researcher,1919,88,16,2007
John Johnson,"['Namibia', 'Hungary']",Businessperson,1918,67,73,1985
Andrew May,['Cook Islands'],Politician,1899,62,24,1961
Allison Shaw,['Italy'],Artist,1877,37,36,1914
Gabriella Sanchez,['Djibouti'],Artist,1901,86,43,1987
Margaret Zimmerman,"['Lesotho', 'Poland']",Athlete,1885,50,69,1935
Laura Love,['Saudi Arabia'],Politician,1905,27,74,1932
Rachel Garza,['Egypt'],Artist,1919,19,71,1938
Michelle Sosa,"['Brunei Darussalam', 'Palau']",Military personnel,1921,85,38,2006
Kathryn Li,"['Uzbekistan', 'Bouvet Island (Bouvetoya)']",Artist,1877,44,0,1921
Mrs. Lori Cervantes,"['Ecuador', 'Cambodia']",Artist,1895,32,67,1927
Diane Kemp,['Gabon'],Lawyer,1875,87,83,1962
Beth Howard,['Puerto Rico'],Artist,1912,48,55,1960
Ms. Wanda Miller,['United States of America'],Researcher,1891,44,84,1935
James Gibson,"['Thailand', 'British Virgin Islands']",Politician,1911,15,78,1926
Julia Jones,['Luxembourg'],Artist,1875,37,44,1912
Amy Martinez,"['Anguilla', 'Timor-Leste']",Cook; restaurateur; chef,1886,86,59,1972
Evelyn Taylor,"['Bahrain', 'Armenia']",Artist,1903,12,49,1915
Donna Frey,['Slovakia (Slovak Republic)'],Aristocrat,1924,78,20,2002
Michael Montgomery,"['El Salvador', 'Paraguay']",Artist,1878,53,14,1931
Hannah Huang,"['Libyan Arab Jamahiriya', 'Haiti']",Athlete,1916,67,10,1983
Michele Gonzalez,"['Tuvalu', 'El Salvador']",Artist,1911,69,28,1980
Thomas Nichols,"['Zambia', 'Togo']",Politician,1878,50,1,1928
Shelly Bailey,"['Estonia', 'Togo']",Military personnel,1913,46,27,1959
Amy Aguilar,"['Guam', 'Norfolk Island']",Politician,1880,15,5,1895
Terry Norris,"['Estonia', 'Saint Vincent and the Grenadines']",Politician,1901,39,6,1940
Victoria Collins,"['Gabon', 'Thailand']",Artist,1906,84,28,1990
Tyler Lam,"['Puerto Rico', 'Ethiopia']",Artist,1899,2,87,1901
Lawrence Gutierrez,['United Kingdom'],Artist,1896,40,2,1936
Melissa Taylor,"['Dominican Republic', 'Canada']",Artist,1911,57,63,1968
Matthew Williams,"['Martinique', 'Uganda']",Artist,1883,5,69,1888
Edward Coffey,['Bouvet Island (Bouvetoya)'],Athlete,1920,14,76,1934
Zachary Sims,['Korea'],Military personnel,1904,87,68,1991
Michele Wolfe,['Saint Vincent and the Grenadines'],Artist,1923,7,28,1930
Troy Blevins,['Liberia'],Athlete,1894,59,37,1953
Alicia Mccormick,['Greenland'],Politician,1907,49,4,1956
Bonnie Rowe,['Mexico'],Artist,1880,77,82,1957
Ariana Howe,"['Gabon', 'Djibouti']",Artist,1893,83,59,1976
Tiffany Fox,['Bosnia and Herzegovina'],Artist,1919,57,55,1976
Carrie Graves,['Madagascar'],Athlete,1918,16,13,1934
Joel Bowen,"['Ghana', 'Timor-Leste']",Artist,1883,3,33,1886
Luke Oconnell,"['Saint Martin', 'Egypt']",Artist,1887,67,63,1954
Randall Davis,"['United Arab Emirates', 'Armenia']",Artist,1914,62,64,1976
Robert Harmon,"['Luxembourg', 'Kyrgyz Republic']",Researcher,1889,26,63,1915
Deborah Macdonald,"['Slovenia', 'Ecuador']",Businessperson,1870,46,22,1916
Abigail Harper,['Luxembourg'],Artist,1922,46,39,1968
Thomas Kane,"['Morocco', 'Burundi']",Researcher,1909,46,15,1955
Thomas Obrien,"['Indonesia', 'French Guiana']",Military personnel,1902,76,2,1978
Christopher Webb,"['Timor-Leste', 'Wallis and Futuna']",Researcher,1902,4,60,1906
Randy Haas,"['Bahrain', 'Tokelau']",Artist,1921,7,15,1928
Heather Sanchez,"['United States of America', 'Mauritius']",Teacher,1883,62,49,1945
Joshua Campbell,['Sri Lanka'],Researcher,1879,78,49,1957
Jessica Fisher,"['Latvia', 'Iraq']",Athlete,1920,59,6,1979
Tyler Zavala,['Nauru'],Artist,1870,19,82,1889
Cheryl White,"['Palau', 'Saint Barthelemy']",Researcher,1922,47,53,1969
Mark Bowen,['Oman'],Researcher,1884,73,61,1957
Michelle Garcia,['San Marino'],Inventor; game author,1922,55,30,1977
Joseph Anderson,['French Guiana'],Artist,1893,89,12,1982
Donald Richardson,['Somalia'],Religious figure,1905,43,50,1948
Margaret Davis,"['American Samoa', 'Sudan']",Artist,1908,61,43,1969
Jill Brown,"['Djibouti', 'French Guiana']",Artist,1889,73,34,1962
Deborah Watson,['Equatorial Guinea'],Artist,1902,81,38,1983
Kara Johnson,"['Bahrain', 'Lesotho']",Model,1890,84,49,1974
Karen Mack,"['Libyan Arab Jamahiriya', 'Hong Kong']",Artist,1918,38,0,1956
David Brewer,['Faroe Islands'],Researcher,1879,62,18,1941
Matthew Taylor,['Ethiopia'],Artist,1870,60,67,1930
Amber Weiss,"['Falkland Islands (Malvinas)', 'Anguilla']",Athlete,1907,40,16,1947
Raymond Richardson,"['India', 'Paraguay']",Artist,1905,21,72,1926
Joshua Crawford,['Faroe Islands'],Artist,1873,62,61,1935
Michael Clark,['Djibouti'],Military personnel,1890,73,85,1963
Dale Boyd,"['Poland', 'Zambia']",Artist,1874,30,81,1904
Jacob Simpson,['Antarctica (the territory South of 60 deg S)'],Artist,1901,55,21,1956
Tamara Garcia,['Aruba'],Art director; production designer,1902,70,67,1972
Todd Hall,['Guatemala'],Artist,1874,15,16,1889
Melissa Smith,['Central African Republic'],Politician,1902,32,75,1934
Kelly Coleman,['Liberia'],Politician,1897,4,19,1901
Jeffrey Houston,"['Nepal', 'Cayman Islands']",Researcher,1905,39,62,1944
Frank Castro,['Uruguay'],Artist,1904,9,66,1913
Lorraine Mccoy,['Aruba'],Criminal,1871,78,17,1949
Joan Brown,"['Tokelau', 'Bosnia and Herzegovina']",Artist,1881,15,25,1896
Jeremy Dennis,"['Lesotho', 'Luxembourg']",Researcher,1890,45,37,1935
Susan Perez,['Tajikistan'],Researcher,1877,84,16,1961
Jesse Stewart,"['Dominican Republic', 'Serbia']",Artist,1887,13,71,1900
Christopher Cline,['Andorra'],Artist,1883,52,89,1935
Barbara Smith,"['Sweden', 'Jordan']",Hydrographer; explorer,1916,62,68,1978
Darren Bowers,"['Malawi', 'Qatar']",Researcher,1896,34,89,1930
Brandon Golden,"['Togo', 'Kenya']",Politician,1912,84,22,1996
Caitlyn Palmer,"['Jersey', 'Holy See (Vatican City State)']",Spy,1889,31,25,1920
Lisa Rogers,['Afghanistan'],Waiter,1919,73,25,1992
Valerie Shaffer,"['Guadeloupe', 'Cayman Islands']",Politician,1908,18,48,1926
Brian Lopez,['Kazakhstan'],Artist,1878,4,76,1882
James Romero,"['United States Virgin Islands', 'Niue']",Researcher,1896,47,87,1943
Alan Jones,['Tajikistan'],Artist,1882,69,84,1951
Jonathan Fleming,['Uzbekistan'],Researcher,1909,26,41,1935
Joseph Nichols,"['Angola', 'Spain']",Politician,1877,36,37,1913
Jeremiah Beck,['Bangladesh'],Artist,1922,41,44,1963
Carol Mills,['Gambia'],Artist,1877,80,63,1957
Todd Henry,['Israel'],Artist,1898,88,87,1986
Wyatt Walker,['Bahamas'],Artist,1906,18,44,1924
Elizabeth Wood,"['Guadeloupe', 'United Kingdom']",Artist,1872,11,36,1883
Amy Stephenson,['Cocos (Keeling) Islands'],Journalist,1883,72,21,1955
Robert Moore,"['Montserrat', 'Kazakhstan']",Artist,1874,74,50,1948
William Mcmillan,['Panama'],Artist,1909,83,0,1992
Mrs. Tiffany Graves DVM,"['Montenegro', 'Argentina']",Businessperson,1913,80,30,1993
Donald Nelson,['Chad'],Politician,1921,44,83,1965
Chris Herman,"['Burkina Faso', 'Wallis and Futuna']",Artist,1908,53,37,1961
Alex Brown,"['Japan', 'Indonesia']",Artist,1873,48,32,1921
Randall Johnson,['Senegal'],Artist,1918,76,13,1994
Cheryl Hays,"['Armenia', 'Nepal']",Military personnel,1910,2,8,1912
Olivia Smith,['Chad'],Artist,1873,70,27,1943
Sandy Ibarra,['Sweden'],Politician,1880,76,22,1956
Jacqueline Edwards,"['Heard Island and McDonald Islands', 'Burkina Faso']",Religious figure,1871,86,5,1957
Michael Powers,"['Kiribati', 'Turkmenistan']",Artist,1890,2,89,1892
Wendy Thomas,['Egypt'],Interpreter,1870,40,49,1910
Gregory Grant,['Bahamas'],Artist,1900,49,56,1949
Jacob Foster,['Guernsey'],Monarch,1923,40,83,1963
Shawn Ayers,['Cyprus'],Artist,1886,14,84,1900
Brandon Sims,"['Seychelles', 'Serbia']",Politician,1872,30,55,1902
Melissa White,['Cyprus'],Sovereign,1892,58,58,1950
Kevin Patterson,"['Western Sahara', 'Pitcairn Islands']",Artist,1906,50,3,1956
Keith Adams,"['Russian Federation', 'Haiti']",Athlete,1912,39,58,1951
Paul Hamilton,['Panama'],Artist,1895,45,68,1940
Scott Hawkins,"['Marshall Islands', 'Bahamas']",Artist,1910,61,32,1971
Kelly Shelton,['Qatar'],Politician,1888,80,5,1968
Nicole Smith,"['Gibraltar', 'Argentina']",Researcher,1911,3,52,1914
Shawna Sherman,['Iceland'],Artist,1896,45,42,1941
Dakota Wilcox,['Guinea-Bissau'],Politician,1916,57,6,1973
Caroline Smith,['Andorra'],Domestic worker; tinsmith,1899,12,24,1911
Samantha Forbes,"['Ethiopia', 'Mali']",Artist,1888,29,72,1917
Michelle Nichols,"['Liechtenstein', 'Switzerland']",Artist,1889,80,14,1969
William Taylor,['Jamaica'],Military personnel,1873,24,26,1897
Jessica Chambers,['Paraguay'],Researcher,1912,80,89,1992
Willie Molina,"['Christmas Island', 'Isle of Man']",Military personnel,1893,20,74,1913
Gregory Casey,['Hungary'],Artist,1901,87,61,1988
Donald Morales,['Djibouti'],Artist,1896,44,19,1940
Donald Barajas,"['Angola', 'Mali']",Artist,1877,38,21,1915
Peter Holder,['Bouvet Island (Bouvetoya)'],Athlete,1923,54,58,1977
Eric Flores,['Christmas Island'],Nurse,1871,64,82,1935
Alexandra Harrison,"['Liechtenstein', 'Suriname']",Researcher,1904,31,18,1935
Terri Fox,['Belarus'],Politician,1914,89,39,2003
Aaron Burgess,['Niue'],Artist,1893,57,69,1950
Brandon West,['French Southern Territories'],Teacher,1912,82,79,1994
Michelle Williamson,['Estonia'],Psychologist; psychoanalyst,1919,84,80,2003
Alyssa Adams,"['Zambia', 'Iraq']",Military personnel,1876,85,9,1961
Thomas Mathis,"['Pitcairn Islands', 'Andorra']",Athlete,1916,74,41,1990
Andrea Cole,"['Belize', 'Syrian Arab Republic']",Motorcycle racer; rally driver,1884,85,56,1969
Sarah Benjamin,"['Netherlands Antilles', 'Yemen']",Athlete,1880,58,27,1938
Kelsey Quinn,['New Caledonia'],Artist,1897,87,4,1984
Joseph Moreno,"['Finland', 'Dominica']",Athlete,1923,69,59,1992
Leslie Jenkins,"['Saint Vincent and the Grenadines', 'Algeria']",Artist,1920,31,18,1951
Carol Robbins,"['Angola', 'Djibouti']",Journalist,1907,50,89,1957
Donna Gilbert,"['Iraq', 'Greenland']",Artist,1911,46,75,1957
Amy Olson,"['Korea', 'Zimbabwe']",Artist,1887,43,21,1930
Lisa Morales,"['Sao Tome and Principe', 'Saint Martin']",Artist,1910,3,62,1913
Cindy Brown,['United States of America'],Politician,1875,10,54,1885
Christopher Solis,"['British Virgin Islands', 'Burundi']",Religious figure,1914,88,21,2002
Brian White,['Gabon'],Politician,1876,8,65,1884
Susan Hernandez DVM,"['Libyan Arab Jamahiriya', 'Mongolia']",Artist,1899,87,30,1986
Lori Mann,['Oman'],Artist,1893,14,73,1907
Charles Fletcher,['Cook Islands'],Artist,1921,39,63,1960
Christine Lee,['Senegal'],Athlete,1874,35,64,1909
Jessica Smith,['Togo'],Athlete,1875,24,50,1899
Jillian Miles,"['Costa Rica', 'New Caledonia']",Artist,1921,69,75,1990
Matthew Murray,"['Swaziland', 'San Marino']",Artist,1900,72,54,1972
Elizabeth Burnett,"['Japan', ""Cote d'Ivoire""]",Politician,1908,6,53,1914
Jessica Nicholson,['United Kingdom'],Military personnel,1913,0,82,1913
Kathryn Wallace,"['Venezuela', 'Uzbekistan']",Artist,1902,18,85,1920
Sarah Choi,"['Paraguay', 'Belgium']",Artist,1882,12,31,1894
Mackenzie Cruz,['Yemen'],Artist,1890,28,63,1918
Brittney Durham,"['Kenya', 'Aruba']",Military personnel,1887,50,64,1937
Jeremy Ayala,['Taiwan'],Artist,1897,0,4,1897
Scott Flynn,"['Estonia', 'North Macedonia']",Artist,1891,44,34,1935
Brian Morris,"['Micronesia', 'Norfolk Island']",Racing automobile driver; formula one driver,1918,78,22,1996
Timothy Gonzalez,"['Chile', 'Paraguay']",Artist,1900,59,33,1959
William Green,"['Gabon', 'Kuwait']",Artist,1876,22,32,1898
Emily Nelson,"['Tunisia', 'Hungary']",Artist,1906,76,67,1982
Annette Anderson,"['Slovakia (Slovak Republic)', 'Burundi']",Artist,1899,56,72,1955
Ashley Mendoza,"['Mongolia', 'Uzbekistan']",Politician,1900,12,16,1912
Benjamin Jones,['Armenia'],Politician,1904,24,20,1928
Paul Wilson,"['Equatorial Guinea', 'Kenya']",Military personnel,1875,57,23,1932
Eric Pearson,['British Virgin Islands'],Artist,1874,4,21,1878
Dylan Garcia,['Maldives'],Military personnel,1877,9,84,1886
Dr. Aaron French,['China'],Politician,1905,64,13,1969
Ryan Bailey,['Gibraltar'],Jurist,1908,47,83,1955
Jeffery Anderson,"['Tokelau', 'Niue']",Artist,1894,80,64,1974
Jason Fisher,"['Cook Islands', 'Andorra']",Artist,1894,88,19,1982
Alexandria Wong,['Hungary'],Athlete,1921,78,15,1999
Deanna Dunn,"['Georgia', 'Spain']",Artist,1877,44,55,1921
Nicholas Holmes,['Peru'],Politician,1901,22,8,1923
Danielle Phillips,"['Georgia', 'Pitcairn Islands']",Artist,1891,12,74,1903
Lauren Johnson,['Chile'],Artist,1870,72,52,1942
David Mcgee,['Vanuatu'],Artist,1894,43,83,1937
Randy Rogers,"['Saint Martin', 'Netherlands Antilles']",Artist,1900,70,13,1970
Mrs. Monica Murray,['Peru'],Artist,1906,23,3,1929
Barbara Liu,"['United States Virgin Islands', 'Netherlands']",Athlete,1902,42,35,1944
Amber Powell,['Australia'],Politician,1893,74,40,1967
Kevin Taylor,['Oman'],Athlete,1902,14,33,1916
Marilyn Stokes,"['British Indian Ocean Territory (Chagos Archipelago)', 'Turkmenistan']",Athlete,1870,67,23,1937
Jennifer Lopez,['Jersey'],Artist,1888,60,68,1948
James Parks,"['Senegal', 'Benin']",Artist,1871,35,64,1906
Cynthia Hudson,"['Egypt', 'Botswana']",Politician,1918,50,19,1968
Edward Collier,"['Tonga', 'Tokelau']",Artist,1920,45,79,1965
Lisa Gardner,['Equatorial Guinea'],Politician,1893,73,52,1966
Sarah Ross,['Moldova'],Artist,1902,61,53,1963
Justin Sanchez,['Nigeria'],Teacher,1910,72,26,1982
Laurie Leonard,['Uruguay'],Artist,1905,18,41,1923
Sara Barrera,['Burkina Faso'],Politician,1910,34,41,1944
James Nolan,"['Kenya', 'Panama']",Politician,1872,7,56,1879
Mary Lozano,"['Haiti', 'Chile']",Artist,1898,71,31,1969
Krystal Carlson,['Namibia'],Potter; ceramist,1881,47,80,1928
Karen Jimenez,"['Montserrat', 'Turks and Caicos Islands']",Artist,1908,10,23,1918
Mary Henderson,"['Libyan Arab Jamahiriya', 'South Africa']",Religious figure,1896,21,32,1917
Maria Barnes,['Montserrat'],Artist,1914,32,50,1946
Jeffrey Cunningham,"['Palestinian Territory', 'Brunei Darussalam']",Researcher,1886,85,83,1971
Heather Miller,['Maldives'],Politician,1919,39,5,1958
Adam Haynes,['Ireland'],Artist,1871,13,59,1884
Heather Gilmore DDS,"['Turkey', 'Guinea-Bissau']",Artist,1901,80,33,1981
Tamara Brandt,['Antigua and Barbuda'],Teacher,1911,19,12,1930
Kathy Ray,"['Cocos (Keeling) Islands', 'South Africa']",Criminal; smuggler,1870,53,81,1923
Russell Jones,['Marshall Islands'],Military personnel,1880,65,69,1945
Michael Gibson,['Malawi'],Artist,1898,1,10,1899
Tiffany Garcia,"['Ecuador', 'Angola']",Religious figure,1875,73,20,1948
Jeffery Dennis,"['South Africa', 'Gabon']",Artist,1885,78,85,1963
Jerry Rowe,['United States Minor Outlying Islands'],Artist,1904,47,32,1951
Larry Werner,['Ethiopia'],Artist,1915,68,11,1983
Kelli Collins,['Bangladesh'],Athlete,1877,78,47,1955
Lisa Schroeder,['Senegal'],Artist,1903,81,8,1984
Brandy Barnes,['Congo'],Merchant,1912,3,13,1915
Jason Wade,['Myanmar'],Activist,1907,80,28,1987
Stacy Weiss,"['Syrian Arab Republic', 'Nicaragua']",Artist,1905,78,45,1983
Stephen Fisher,"['Macao', 'Iraq']",Military personnel,1878,82,35,1960
Tasha Taylor,['Argentina'],Cinematographer,1891,53,70,1944
Jonathan Hayes,['Australia'],Artist,1887,77,14,1964
Debra Estes,"['Jordan', 'Denmark']",Researcher,1907,48,60,1955
Jacqueline Garrett,"['Jamaica', 'Peru']",Artist,1913,41,82,1954
Karen Robinson,"['Japan', 'Kiribati']",Politician,1886,27,11,1913
Danielle Garcia,['Belize'],Artist,1901,19,56,1920
Ashley Parker,['Burundi'],Artist,1906,51,78,1957
Tiffany Ortiz,['British Indian Ocean Territory (Chagos Archipelago)'],Politician,1921,42,20,1963
Timothy Torres,['Norfolk Island'],Artist,1907,26,35,1933
Tina Marshall,['Falkland Islands (Malvinas)'],Artist,1891,29,58,1920
Haley Page,['Luxembourg'],Artist,1905,3,0,1908
Katherine Hopkins,"['Barbados', 'Trinidad and Tobago']",Artist,1921,15,59,1936
Thomas Smith,['Togo'],Artist,1871,44,57,1915
Jonathan Brewer,"['Rwanda', 'Guam']",Artist,1923,6,4,1929
Dennis Calderon,['Slovakia (Slovak Republic)'],Artist,1902,89,53,1991
Angel Wall,"['Uruguay', 'Belgium']",Artist,1899,0,55,1899
Larry Lopez,['Haiti'],Artist,1894,9,57,1903
Angela Brown,"['Mauritius', 'Comoros']",Artist,1879,63,25,1942
Haley Romero,['Tokelau'],Athlete,1873,32,31,1905
Christopher Smith,['Saint Barthelemy'],Physician,1871,10,1,1881
Sean Morrow,['France'],Artist,1909,57,49,1966
Beth Morales,"['Sudan', 'Korea']",Explorer,1907,73,8,1980
Jeffrey Elliott,['Guatemala'],Military personnel,1897,43,32,1940
Wendy Gonzales,['Guadeloupe'],Military personnel,1886,80,14,1966
David Coffey,"['Slovakia (Slovak Republic)', 'Taiwan']",Racing automobile driver; formula one driver,1892,35,8,1927
Thomas Tucker,['Switzerland'],Primate,1909,85,76,1994
Jeffery Brown,['Niue'],Artist,1897,38,49,1935
Pamela Andersen,"['Turkey', 'Tonga']",Researcher,1893,48,68,1941
Tabitha Herrera,"['Nigeria', 'Bahrain']",Politician,1919,62,49,1981
Pamela Lowe,"['Bangladesh', 'Puerto Rico']",Artist,1909,88,23,1997
Elizabeth Stone,"['Comoros', 'Netherlands']",Artist,1915,20,2,1935
Michael Johnson,"['Switzerland', 'United States of America']",Artist,1921,51,50,1972
Marcus Weaver,"['Northern Mariana Islands', 'Palestinian Territory']",Artist,1877,29,82,1906
Amanda Andrews,['Niue'],Artist,1888,25,3,1913
Charles King,"[""Lao People's Democratic Republic""]",Politician,1884,69,34,1953
Stacy Edwards,['Netherlands'],Police officer; serial killer,1872,23,85,1895
Jessica Christensen,"['Turkey', 'Bahrain']",Athlete,1872,78,54,1950
Michael Russell,['Myanmar'],Athlete,1891,22,16,1913
Patrick Hernandez,['Guinea'],Artist,1901,35,65,1936
Jennifer Ellis,"['Dominica', 'Colombia']",Artist,1908,39,22,1947
Jessica Marquez,['Faroe Islands'],Artist,1905,54,22,1959
Crystal Alvarez,"['Tanzania', 'Guinea-Bissau']",Artist,1894,76,89,1970
Jack Brown,['Paraguay'],Artist,1918,74,2,1992
Sharon Brown,"['Palestinian Territory', 'British Indian Ocean Territory (Chagos Archipelago)']",Artist,1907,3,24,1910
Matthew Adams,['French Southern Territories'],Politician,1879,29,28,1908
Aaron Bailey,['Papua New Guinea'],Artist,1895,87,4,1982
Eric Boyd,['San Marino'],Amateur wrestler,1911,77,62,1988
Debra Rosales,"['Tonga', 'Grenada']",Artist,1870,20,77,1890
Caitlin Dominguez,['Morocco'],Athlete,1915,59,44,1974
Randall Jacobs,['Guatemala'],Politician,1888,73,8,1961
Denise Blake,"['Poland', 'Armenia']",Athlete,1892,9,65,1901
Lisa Torres,['Denmark'],Karateka,1880,31,71,1911
Rebecca Martin,['Anguilla'],Athlete,1901,31,47,1932
Catherine Martinez,"['Honduras', 'Jordan']",Artist,1879,21,84,1900
Felicia Walters,['Aruba'],Artist,1889,55,78,1944
Mark Sutton,"['Saudi Arabia', 'Croatia']",Artist,1915,19,44,1934
John Vargas,['Cocos (Keeling) Islands'],Artist,1920,79,61,1999
Andrew Whitaker,"['Canada', 'Guam']",Artist,1909,59,6,1968
Ashley Washington,['Estonia'],Artist,1894,81,50,1975
Vicki Hernandez,"['Cook Islands', 'Kiribati']",Politician,1912,88,84,2000
Tyler Norman,['Ukraine'],Politician,1898,55,30,1953
Joel Brown,"['Belgium', 'Saint Helena']",Politician,1913,35,23,1948
Natalie Davis,"['Samoa', 'Ghana']",Artist,1906,77,72,1983
Judy Williams,"['Saint Pierre and Miquelon', 'Syrian Arab Republic']",Teacher,1879,50,88,1929
Evan Williams,"['Switzerland', 'Burkina Faso']",Artist,1902,68,35,1970
Eric Robertson,"['Russian Federation', 'Azerbaijan']",Politician,1923,55,3,1978
Kayla Alexander,"['Paraguay', 'Iran']",Artist,1883,19,63,1902
Rick Ponce,['Iraq'],Athlete,1906,89,33,1995
Juan Hicks,"['Czech Republic', 'Croatia']",Researcher,1875,48,30,1923
David Frazier,['Latvia'],Artist,1884,27,45,1911
Benjamin Flores,"['Czech Republic', 'Congo']",Artist,1913,45,52,1958
Diane Smith,['Malawi'],Artist,1893,39,13,1932
Benjamin Vasquez DDS,"['Cyprus', 'Paraguay']",Athlete,1878,65,31,1943
Rachel Martinez,"['Fiji', 'Brunei Darussalam']",Artist,1881,73,50,1954
Marvin Long,"['Uganda', 'Kenya']",Politician,1901,46,44,1947
Aaron Green,['Pitcairn Islands'],Researcher,1872,77,10,1949
Brandon Haley,"['Estonia', 'United Arab Emirates']",Artist,1902,12,31,1914
Dawn Smith,"['Austria', 'Uganda']",Athlete,1870,53,72,1923
Timothy Davis,"['Falkland Islands (Malvinas)', 'British Indian Ocean Territory (Chagos Archipelago)']",Artist,1924,68,21,1992
Lori Jackson,"['Dominican Republic', 'Russian Federation']",Artist,1888,57,17,1945
Joshua Wood,"['Monaco', ""Lao People's Democratic Republic""]",Athlete,1874,19,25,1893
Crystal Ochoa,"['United Arab Emirates', 'Guam']",Artist,1916,3,83,1919
Jesus Perry,"['Lebanon', 'Liechtenstein']",Serial killer; prostitute,1915,11,57,1926
Regina Walker,['Niger'],Businessperson,1902,18,64,1920
Monique Garcia,"['Israel', 'Saint Vincent and the Grenadines']",Artist,1891,87,17,1978
Karen Sandoval,['San Marino'],Politician,1907,65,30,1972
Laura Dunlap,['Samoa'],Researcher,1881,60,36,1941
Christina Jones,"['Germany', 'Albania']",Artist,1876,16,51,1892
Rachel Stone,"['Denmark', 'Niger']",Politician,1916,41,4,1957
Sandra Rodriguez,"['Chad', 'Vietnam']",Artist,1882,0,45,1882
Melissa Jacobson,"['Antarctica (the territory South of 60 deg S)', 'Sudan']",Artist,1903,88,21,1991
Jasmine Bradley,['Czech Republic'],Engineer,1901,54,31,1955
Rachel Goodwin,"['Trinidad and Tobago', 'Tanzania']",Athlete,1898,42,46,1940
Jeremy Peterson,['France'],Artist,1908,64,6,1972
Alexander Lang,"['South Georgia and the South Sandwich Islands', 'French Guiana']",Researcher,1876,16,64,1892
Heather Robinson,"['Vietnam', 'Seychelles']",Artist,1874,77,53,1951
Amanda Pollard,"['Mongolia', 'Heard Island and McDonald Islands']",Businessperson,1893,70,79,1963
Amber Mckenzie,"['British Virgin Islands', 'Martinique']",Artist,1872,23,48,1895
Timothy Bailey,['Kyrgyz Republic'],Politician,1891,59,13,1950
Neil Richardson,"['Swaziland', 'Kenya']",Researcher,1873,31,87,1904
David Oneill,"['Montserrat', 'Zambia']",Artist,1917,83,48,2000
Tina Hall,"['Spain', 'Poland']",Chef,1924,61,59,1985
David Bryan,['Malaysia'],Teacher,1910,42,67,1952
Donna Ford,"['Dominican Republic', 'Gambia']",Artist,1900,74,42,1974
Cheyenne Warren,['Falkland Islands (Malvinas)'],Artist,1881,67,89,1948
David Ballard,"['Maldives', 'Central African Republic']",Artist,1889,85,74,1974
Michelle Brown,['Moldova'],Politician,1922,57,61,1979
Andrew Ellis,"['Hong Kong', 'French Polynesia']",Athlete,1894,19,45,1913
Jason Griffin,['Brazil'],Artist,1886,29,86,1915
Natalie Banks,['Austria'],Serial killer,1872,86,44,1958
Amber Wright,"['Bouvet Island (Bouvetoya)', 'El Salvador']",Politician,1885,1,86,1886
Monica Lee,['Slovenia'],Journalist,1916,61,85,1977
Emily Schneider,"['Ireland', 'Brunei Darussalam']",Artist,1921,5,24,1926
Sarah Thompson,['Costa Rica'],Researcher,1893,80,22,1973
Joel Miller,"['Germany', 'Japan']",Politician,1888,80,41,1968
Robert Harvey,['Switzerland'],Artist,1885,17,27,1902
Connie Huerta,['El Salvador'],Artist,1900,6,10,1906
Tiffany Thompson,"['French Southern Territories', 'Iceland']",Artist,1914,70,51,1984
Jeffrey Gonzalez,['Korea'],Politician,1906,17,52,1923
Peter Warren,"['Syrian Arab Republic', 'Central African Republic']",Artist,1897,66,26,1963
Colin Copeland,['France'],Artist,1879,14,38,1893
Heather Lara,['Madagascar'],Researcher,1915,14,42,1929
Kristen Jones,"['United Kingdom', 'Belize']",Athlete,1897,72,76,1969
Stephanie Bowman,['Bulgaria'],Artist,1876,21,43,1897
Chelsea Obrien,['Uganda'],Artist,1917,73,0,1990
Dana Powell,"['Falkland Islands (Malvinas)', 'Latvia']",Artist,1909,62,25,1971
Sarah Levine,"['Serbia', 'France']",Researcher,1906,78,70,1984
Erin Wheeler,"['Thailand', 'China']",Military personnel,1921,70,53,1991
Kyle Martinez,"['France', 'Denmark']",Politician,1908,32,22,1940
Grace Rodriguez,['Israel'],Artist,1894,58,15,1952
Phillip Caldwell Jr.,['Eritrea'],Artist,1885,88,42,1973
Nicole Adams,"['Congo', 'Saint Pierre and Miquelon']",Jurist,1891,5,26,1896
April Hamilton,['Bermuda'],Politician,1913,68,67,1981
Olivia Black,"['Bulgaria', 'Liberia']",Artist,1881,27,53,1908
Kimberly Johnson,"['Tonga', 'Algeria']",Artist,1923,1,5,1924
Dr. Paul Meyer,['El Salvador'],Artist,1898,43,9,1941
Michelle Leon,"['Russian Federation', 'France']",Artist,1872,59,44,1931
Ricky Bryant,['Qatar'],Politician,1885,83,84,1968
William White,['Pitcairn Islands'],Artist,1912,35,79,1947
Tammy Myers,['Brazil'],Politician,1923,13,7,1936
Cody Smith,"['Sierra Leone', 'Mexico']",Researcher,1897,64,78,1961
Brittany Norton,"['Mauritius', 'Cocos (Keeling) Islands']",Laborer,1871,78,34,1949
Rachel Roberts,"['Italy', 'Australia']",Journalist,1870,27,54,1897
Ryan Hawkins,"['French Southern Territories', 'Oman']",Model,1885,72,56,1957
David Delgado,['North Macedonia'],Military personnel,1892,7,19,1899
Julie Vazquez,['North Macedonia'],Serial killer; spree killer; criminal,1878,4,48,1882
Mark Moore,"['Namibia', 'Morocco']",Politician,1908,84,38,1992
Russell Graves,['Russian Federation'],Teacher,1879,65,22,1944
Melinda Chan,['Cook Islands'],Businessperson,1870,55,46,1925
Allen Miranda,['Bulgaria'],Politician,1916,81,86,1997
Christine Young,"['Netherlands Antilles', 'Palestinian Territory']",Artist,1873,41,42,1914
Stephen Gallegos,['Kyrgyz Republic'],Artist,1884,46,21,1930
Nathan Williams,['Egypt'],Politician,1907,75,6,1982
Sherry Baker,['Myanmar'],Artist,1874,27,8,1901
Justin Nelson,['Antigua and Barbuda'],Athlete,1897,69,28,1966
Jose Ryan,"['Korea', 'Trinidad and Tobago']",Artist,1904,18,66,1922
Zachary Powell,"['Iraq', 'Bermuda']",Politician,1879,27,59,1906
Michael Wilkinson,['Marshall Islands'],Politician,1893,34,8,1927
Gregory Mcdonald,['Luxembourg'],Researcher,1892,31,13,1923
Brian Harrison,['French Southern Territories'],Artist,1875,25,85,1900
Courtney Barajas,['Mauritius'],Researcher,1871,25,22,1896
Alexandria Snyder,"['Guadeloupe', 'Russian Federation']",Politician,1917,80,63,1997
Amanda Moore,['Timor-Leste'],Religious figure,1913,25,20,1938
Nicole Thomas,['Maldives'],Politician,1889,70,56,1959
Jessica Davis,['Costa Rica'],Researcher,1902,34,59,1936
Laura Dudley DDS,"['Wallis and Futuna', 'Singapore']",Politician,1915,62,30,1977
Daniel Brown,"['Barbados', 'North Macedonia']",Social work; clinical nurse specialist; social worker; social activist; activist,1915,28,63,1943
Alyssa Gibson,"['India', 'Jordan']",Artist,1888,42,18,1930
Robert Thomas,['Bermuda'],Artist,1873,41,89,1914
Connie Stevens,['Anguilla'],Athlete,1899,84,16,1983
Noah Phillips,"['Saint Kitts and Nevis', 'Syrian Arab Republic']",Artist,1905,35,19,1940
Robert Beard,"['Botswana', 'Saint Pierre and Miquelon']",Athlete,1906,30,1,1936
Mary Lopez,['Greenland'],Athlete,1914,1,15,1915
Angela Jensen,"['Samoa', 'India']",Military personnel,1894,4,37,1898
Michael Davis,['Suriname'],Artist,1906,37,52,1943
Thomas Roberson,['Morocco'],Astronomer,1898,50,52,1948
Kathryn Gonzalez,"['New Zealand', 'Gibraltar']",Athlete,1886,51,78,1937
Laura Yang,['Aruba'],Politician,1895,43,27,1938
Vanessa Hill,"['Northern Mariana Islands', 'Tonga']",Artist,1921,78,85,1999
Daniel Giles,"['Jersey', 'Tunisia']",Lady-in-waiting,1921,26,3,1947
James Rose,['Gabon'],Physician,1887,77,40,1964
Todd Rice,['Suriname'],Politician,1892,60,64,1952
Zachary Reynolds,['United Kingdom'],Politician,1899,40,47,1939
Joseph Beard,['Serbia'],Politician,1890,44,0,1934
Jennifer Montgomery,"['Saudi Arabia', 'Tuvalu']",Artist,1874,58,44,1932
Shawn Miller,"['Ethiopia', 'Liberia']",Artist,1878,43,61,1921
Aimee Skinner,['Mali'],Politician,1909,84,8,1993
Christine Roberson,"['Turkey', 'Bolivia']",Military personnel,1877,4,25,1881
Candice Young,"['Netherlands Antilles', 'Morocco']",Artist,1915,5,42,1920
Devon Robinson,"['Mauritius', 'Micronesia']",Artist,1918,36,48,1954
Christopher Martin,"['Grenada', 'Madagascar']",Politician,1883,55,50,1938
Elijah Martinez,"['Libyan Arab Jamahiriya', 'Cayman Islands']",Researcher,1914,11,65,1925
Theresa Rodriguez,['China'],Politician,1913,58,78,1971
Jessica Smith,['Tajikistan'],Politician,1916,88,88,2004
Chase Cox,['Belarus'],Artist,1880,17,68,1897
Patrick Abbott,['Bulgaria'],Lawyer,1887,55,48,1942
Cathy Garcia,['Germany'],Artist,1901,59,66,1960
Kenneth Lopez,['Swaziland'],Researcher,1905,50,35,1955
Robert Benson,"['Liberia', 'Ukraine']",Artist,1922,10,13,1932
Theresa Williams,['Qatar'],Fighter pilot,1878,54,46,1932
Kimberly Crosby,"['Slovenia', 'Central African Republic']",Military personnel,1917,47,17,1964
Jennifer Ortiz MD,['Isle of Man'],Spree killer,1896,35,49,1931
Jesse Glover,"['Morocco', 'Spain']",Artist,1885,30,68,1915
Sara Gonzales,"['Yemen', 'Hong Kong']",Artist,1898,41,16,1939
Courtney Raymond,['Belgium'],Artist,1893,70,79,1963
John Davis,['Madagascar'],Artist,1898,16,2,1914
Maria Duarte,"['Saint Barthelemy', 'India']",Artist,1922,54,33,1976
Timothy Warner,['Northern Mariana Islands'],Politician,1894,83,77,1977
Jason Donovan,"['Netherlands Antilles', 'Fiji']",Artist,1891,89,72,1980
Amy Klein,['Nepal'],Artist,1896,64,82,1960
Mary Wilson,['Netherlands'],Artist,1881,43,16,1924
Jennifer Davis,['Mexico'],Artist,1916,43,70,1959
Maria Powell,['Mayotte'],Artist,1889,72,14,1961
Thomas Gonzalez,['Argentina'],Physician,1883,58,54,1941
Ronnie Morris,['Jamaica'],Artist,1898,62,69,1960
Derrick King,"['Bahrain', 'Russian Federation']",Artist,1914,22,89,1936
Kristin Riggs,"['Guernsey', 'Nauru']",Concentration camp guard,1872,40,48,1912
Cindy Brown,['Malaysia'],Researcher,1886,13,33,1899
Andrew Rodriguez,"['Belarus', 'Svalbard & Jan Mayen Islands']",Artist,1872,29,63,1901
Terry Thompson,"['Guyana', 'Ghana']",Artist,1886,62,18,1948
Mary Cordova,"['Luxembourg', 'Norway']",Politician,1914,86,30,2000
Scott Clark,"['Kenya', 'Mayotte']",Dressmaker,1874,6,36,1880
John Kennedy,['Kiribati'],Artist,1897,44,56,1941
Ronald Jefferson,"['Sierra Leone', 'Venezuela']",Athlete,1901,69,11,1970
David Sanchez,['Thailand'],Politician,1899,49,33,1948
David Stark,"['Panama', 'Uzbekistan']",Religious figure,1905,36,56,1941
Sara Weeks,"['Netherlands', 'Sri Lanka']",Artist,1879,52,53,1931
Breanna Rasmussen,"['Hong Kong', 'Sierra Leone']",Artist,1891,5,77,1896
Fernando Peterson,['San Marino'],Researcher,1882,89,36,1971
Amy Howell,"['Fiji', 'Honduras']",Artist,1908,71,80,1979
Susan Rivera,['Eritrea'],Politician,1884,16,30,1900
Andre Davidson,['San Marino'],Researcher,1870,22,69,1892
Joseph Hart,['Hong Kong'],Politician,1919,9,74,1928
Rebecca Mckinney,"['Portugal', 'Timor-Leste']",Artist,1904,31,80,1935
Dennis Rodriguez,['Jordan'],Artist,1890,27,65,1917
Shawn Thornton,"['Mali', 'Cameroon']",Politician,1877,42,9,1919
Christopher Miles,['Ghana'],Entrepreneur,1912,85,51,1997
Jose Smith,"['Macao', 'Malaysia']",Religious figure,1875,4,18,1879
Alison Long,['Cocos (Keeling) Islands'],Politician,1878,89,59,1967
Kyle Johnson,['Mauritius'],Artist,1876,45,89,1921
Scott Jimenez,"['Mauritius', 'Gibraltar']",Teacher,1912,75,46,1987
Ethan Robbins,['Macao'],Politician,1905,31,87,1936
Scott Simpson,['Sao Tome and Principe'],Politician,1917,32,27,1949
Samantha Thomas,['Italy'],Athlete,1886,82,58,1968
Karen Johnson,['Djibouti'],Politician,1899,40,26,1939
Brittany Li,['Mayotte'],Politician,1896,30,50,1926
Jason Rosario,['Palestinian Territory'],Artist,1905,85,49,1990
Carolyn Malone,['Sao Tome and Principe'],Athlete,1880,32,70,1912
Tracy Cruz,"['Andorra', 'New Zealand']",Politician,1921,34,3,1955
William Carney,"['Ireland', 'Brunei Darussalam']",Athlete,1884,24,3,1908
Latoya Morales,"['Reunion', 'Bangladesh']",Artist,1894,75,9,1969
Matthew Williams,"['Honduras', 'Russian Federation']",Politician,1888,88,18,1976
Gary Horton,['Fiji'],Military personnel,1874,44,27,1918
Elizabeth Lewis,"['Namibia', 'Tokelau']",Artist,1905,86,46,1991
Anthony Harris,"['Netherlands', 'Puerto Rico']",Artist,1922,48,82,1970
Tony Johnson,"['Brazil', 'Haiti']",Artist,1905,66,12,1971
David Jackson,['United States Minor Outlying Islands'],Spy,1910,82,71,1992
Meghan Sullivan,['Slovenia'],Artist,1875,70,45,1945
Bryan Obrien,"['Vietnam', 'Panama']",Politician,1914,89,39,2003
Julie Johnson,"['Monaco', 'Netherlands Antilles']",Researcher,1923,52,14,1975
Sandra Davis,['Panama'],Mason,1900,25,4,1925
Mrs. Linda Johnson,['Vanuatu'],Military personnel,1883,52,23,1935
Natasha Peterson,"['Saint Helena', 'Oman']",Researcher,1886,30,19,1916
Mitchell Miller,"['Azerbaijan', 'Saint Martin']",Artist,1904,39,9,1943
Michael Marks,['Netherlands Antilles'],Lawyer,1916,2,48,1918
Dorothy Green,['San Marino'],Artist,1913,82,67,1995
Danielle Watson DDS,"['Argentina', 'Chad']",Researcher,1910,11,22,1921
Katherine Hartman,"['Mauritania', 'Burkina Faso']",Artist,1916,87,20,2003
Tamara Jones,"['Martinique', 'Luxembourg']",Artist,1912,26,86,1938
Christopher Kim,"['Dominican Republic', 'Central African Republic']",Artist,1892,21,36,1913
Colleen Johnson,['Monaco'],Military personnel,1881,68,33,1949
Barbara Allison,"['Montenegro', 'Mongolia']",Artist,1903,67,70,1970
Dr. Hailey Wong,['India'],Politician,1888,88,7,1976
Phillip White,['Dominican Republic'],Researcher,1873,84,24,1957
Thomas Garrett,['Antarctica (the territory South of 60 deg S)'],Artist,1923,5,65,1928
Natalie Moore,"['Aruba', 'France']",Religious figure,1898,71,68,1969
Nathan Brown,['South Africa'],Politician,1884,55,23,1939
Carolyn Yoder,['Austria'],Politician,1914,80,24,1994
David Miller,"['Paraguay', 'Canada']",Artist,1912,11,1,1923
Jennifer Schultz,"['French Polynesia', 'Liechtenstein']",Researcher,1898,16,85,1914
Shane George,"['Tokelau', 'Bhutan']",Astrologer,1903,14,19,1917
David Welch,"['French Guiana', 'Montenegro']",Artist,1877,24,56,1901
George Cohen,['Fiji'],Artist,1913,22,33,1935
Monica Martinez,['Tunisia'],Athlete,1894,69,11,1963
Jeanette Henry,['Cyprus'],Artist,1887,48,23,1935
Kim Watson,['Bouvet Island (Bouvetoya)'],Politician,1872,69,39,1941
Julie Little,['Wallis and Futuna'],Researcher,1877,23,16,1900
Sarah Reyes,['Korea'],Politician,1889,88,69,1977
Charles Martinez,['Suriname'],Politician,1896,50,27,1946
Bonnie Jenkins,['Bosnia and Herzegovina'],Politician,1917,40,61,1957
Michael Perez,['Macao'],Artist,1910,7,62,1917
Kara Burke,['Ghana'],Artist,1923,65,44,1988
Dennis Evans,"['Saint Martin', 'Costa Rica']",Artist,1892,7,68,1899
George Potter,"['Kuwait', 'Latvia']",Artist,1918,52,51,1970
Anthony Morris,['United Arab Emirates'],Researcher,1893,59,57,1952
John Ray,['Albania'],Artist,1908,14,11,1922
Janice Combs,['Guinea-Bissau'],Artist,1891,20,29,1911
Reginald Anderson,['Brunei Darussalam'],Artist,1922,1,78,1923
Joseph Aguilar,['Bangladesh'],Architect,1877,19,53,1896
Deanna Salinas,['Ireland'],Artist,1902,19,54,1921
Scott Houston,['Malta'],Entrepreneur,1904,44,15,1948
Audrey Mcmillan,['Australia'],Artist,1898,22,52,1920
Tyler Ortiz,['Kenya'],Politician,1912,16,70,1928
Brandon Kent,['Cyprus'],Businessperson,1917,67,15,1984
Robert Rice,['Liberia'],Politician,1895,69,79,1964
Debra Perry MD,"['Honduras', 'Kazakhstan']",Artist,1899,32,41,1931
Donald Wong,['Marshall Islands'],Military personnel,1902,88,59,1990
Amy Davis,['Hungary'],Researcher,1887,6,24,1893
Julia Reese,['Argentina'],Researcher,1924,40,61,1964
Adam Murillo,"['Palestinian Territory', 'Moldova']",Politician,1879,6,24,1885
Summer Jackson,['Aruba'],Military personnel,1908,8,69,1916
James Elliott,"['Tonga', 'Papua New Guinea']",Artist,1881,46,88,1927
Benjamin Mccarty,['Vietnam'],Artist,1908,24,47,1932
Kristina House,['Reunion'],Artist,1922,58,42,1980
Brandon Kent,['Switzerland'],Athlete,1871,74,19,1945
Stephen Escobar,['Norfolk Island'],Researcher,1897,27,32,1924
Raymond Peterson,['Brazil'],Aristocrat,1906,64,27,1970
Heather Norton,['Paraguay'],Politician,1919,69,62,1988
Ann Walker,['Colombia'],Artist,1898,21,59,1919
Henry Griffin,['United States Virgin Islands'],Artist,1901,23,34,1924
Courtney Sanders,"['Saint Kitts and Nevis', 'Malaysia']",Artist,1907,33,79,1940
Joshua Tate,"['Cocos (Keeling) Islands', 'Malawi']",Artist,1894,89,27,1983
Krystal Kelly,['Wallis and Futuna'],Researcher,1920,0,50,1920
Karen Hall,"['Maldives', 'Micronesia']",Artist,1889,1,19,1890
Alan Ford,"['Serbia', 'Burundi']",Athlete,1875,64,24,1939
Kyle Gonzalez,"['Tajikistan', 'Tunisia']",Politician,1903,89,26,1992
Thomas Patterson,"['Montserrat', 'British Virgin Islands']",Athlete,1872,31,22,1903
Dr. Timothy Roberts,"['Serbia', 'Ethiopia']",Artist,1924,3,76,1927
Jeffrey Sullivan,"['Nigeria', 'Kuwait']",Politician,1902,69,86,1971
Tammy Phillips,['Nauru'],Politician,1888,21,55,1909
Timothy Mason,['Hong Kong'],Politician,1886,58,86,1944
Alicia Bowman,"['Bosnia and Herzegovina', 'Mexico']",Researcher,1873,4,11,1877
Leah Perez,"['Tunisia', 'Korea']",Artist,1908,75,64,1983
Robert Hinton,"['Togo', 'Japan']",Artist,1922,8,12,1930
Phillip Doyle,"['Tuvalu', 'Montserrat']",Politician,1898,25,29,1923
Adam Taylor,"['Syrian Arab Republic', 'Palau']",Politician,1873,78,34,1951
Mr. Kenneth Fernandez,['El Salvador'],Artist,1886,80,5,1966
Michael Elliott,"['Colombia', 'British Virgin Islands']",Banker,1873,74,35,1947
Courtney Farley,"['Holy See (Vatican City State)', 'Western Sahara']",Artist,1887,49,20,1936
Margaret Miller,['Iran'],Artist,1873,27,15,1900
Michael Neal,['Antigua and Barbuda'],Politician,1901,23,17,1924
Zachary Townsend,['Belize'],Artist,1900,7,28,1907
Jesus Jones,"['Libyan Arab Jamahiriya', 'Montenegro']",Politician,1919,71,80,1990
Marissa Rose,"['Nepal', 'San Marino']",Politician,1883,12,1,1895
William Ware,['Cyprus'],Artist,1879,84,47,1963
Mr. Cory Pierce,['Botswana'],Politician,1905,26,74,1931
Faith Stanton,"['Romania', ""Cote d'Ivoire""]",Fashion designer,1915,28,68,1943
Ashley Crawford,"['El Salvador', 'Central African Republic']",Journalist,1874,1,87,1875
Melanie Chan,"['Tanzania', 'Qatar']",Politician,1887,68,32,1955
Barbara Miller,"['Saint Kitts and Nevis', 'French Southern Territories']",Serial killer; spree killer; criminal; prostitute,1887,8,77,1895
Garrett Rosales DVM,['Mauritius'],Politician,1902,23,29,1925
Gregory Walker,['Paraguay'],Sovereign,1894,27,2,1921
Austin Woods,['New Zealand'],Politician,1923,34,34,1957
Monica Vasquez,"['Malawi', 'Romania']",Artist,1900,64,29,1964
Justin Garza,['Japan'],Artist,1913,70,34,1983
Carl Schmidt,"['Bahamas', 'Cuba']",Artist,1879,83,73,1962
Nicole Johnson,"['Somalia', 'Saudi Arabia']",Artist,1908,64,54,1972
Mark Maldonado IV,['Bulgaria'],Entrepreneur,1909,63,25,1972
Michael Robinson,['Bhutan'],Politician,1895,33,14,1928
Donna Davis,['Cape Verde'],Artist,1915,13,56,1928
Bryan Henry,"['Tanzania', 'Angola']",Journalist,1872,89,51,1961
Danny Jackson,"['Macao', 'Senegal']",Military personnel,1879,82,69,1961
Ashley Gill,['France'],Researcher,1916,37,5,1953
Megan Maynard,['Ireland'],Artist,1917,11,52,1928
Curtis Bender,"['Antigua and Barbuda', 'Lithuania']",Religious figure,1889,46,72,1935
Nicholas Gonzalez,['Sri Lanka'],Politician,1876,79,49,1955
Matthew Taylor,"['Libyan Arab Jamahiriya', 'Panama']",Artist,1882,24,87,1906
Cristina James,"['Saint Pierre and Miquelon', 'Nepal']",Politician,1882,9,58,1891
Erica Richardson,['Mongolia'],Researcher,1884,9,76,1893
Kyle Hughes,"['Mali', 'Svalbard & Jan Mayen Islands']",Artist,1923,82,34,2005
Zachary Wright,"[""Lao People's Democratic Republic""]",Artist,1901,79,85,1980
Mr. Michael Bell,"['Central African Republic', 'Bolivia']",Artist,1902,58,47,1960
Brian Wood,['Mexico'],Politician,1904,74,81,1978
Ashley Young,['Kazakhstan'],Artist,1891,25,80,1916
Johnny Lee,['Central African Republic'],Politician,1872,24,46,1896
Maria White,['Equatorial Guinea'],Artist,1882,88,79,1970
Nichole Farley,['Hungary'],Artist,1912,22,20,1934
Melissa Anderson,"['Somalia', 'Cocos (Keeling) Islands']",Politician,1874,73,19,1947
Brady Morrison,['Turkey'],Artist,1879,88,22,1967
Melanie Moore,"['Cape Verde', 'Comoros']",Marineoffizier,1879,27,60,1906
Brent Jones,"['Croatia', 'China']",Athlete,1920,86,65,2006
Sheila Galloway,"['Antigua and Barbuda', 'Togo']",Artist,1903,2,21,1905
Mariah Miller,['Guinea-Bissau'],Artist,1920,87,14,2007
Frank Turner,['Costa Rica'],Artist,1883,78,31,1961
Randy Gonzalez,"['Djibouti', 'American Samoa']",Military personnel,1914,41,29,1955
Jennifer Crosby,['France'],Researcher,1902,10,47,1912
Kristin Hall,['Jordan'],Politician,1905,28,12,1933
Crystal Nielsen,"['Norfolk Island', 'North Macedonia']",Inventor; tailor,1923,13,51,1936
Brenda Williams,"['Israel', 'Chad']",Politician,1916,85,71,2001
Tyler Dawson,['Puerto Rico'],Teacher,1912,27,50,1939
Charles Foster,['Kuwait'],Politician,1888,19,0,1907
Tina Nelson,"['Norfolk Island', 'Hungary']",Athlete,1884,66,14,1950
Gregory Washington,"['Guyana', 'American Samoa']",Artist,1891,46,17,1937
Larry Potter,['Morocco'],Artist,1904,31,47,1935
Christina Johnson,['Oman'],Artist,1904,20,56,1924
Laura Weaver,"['Chile', 'Costa Rica']",Athlete,1909,16,35,1925
Sean Morales,['Bosnia and Herzegovina'],Artist,1887,26,74,1913
Thomas Washington,"['Turkey', 'Eritrea']",Sovereign,1918,53,70,1971
Catherine Moore,"['Aruba', 'Uzbekistan']",Artist,1879,30,68,1909
Suzanne Wright,"['Oman', 'Madagascar']",Entrepreneur,1902,50,2,1952
Tanya White,['American Samoa'],Artist,1875,55,22,1930
Robert Smith,"['Andorra', 'Panama']",Religious figure,1923,43,32,1966
Sabrina Johnson,['Guinea'],Artist,1920,52,16,1972
Dale Mitchell,"['India', 'Nicaragua']",Military personnel,1916,19,86,1935
Guy Smith,['Saint Lucia'],Artist,1874,23,58,1897
Paige Fleming,['United Kingdom'],Artist,1892,31,52,1923
Rachel Morris DDS,['Ecuador'],Politician,1878,86,68,1964
Amy Stevens,"['Palau', 'Saudi Arabia']",Artist,1875,83,40,1958
James Alexander,"['Cambodia', 'Wallis and Futuna']",Artist,1889,17,41,1906
Erin Castillo,"['Somalia', 'Martinique']",Explorer,1912,58,40,1970
Katelyn Little,['Equatorial Guinea'],Artist,1917,15,18,1932
Danielle Johnson,['Serbia'],Artist,1902,45,13,1947
Eric Johnson,"['Ukraine', 'Faroe Islands']",Journalist,1880,71,37,1951
Paul Lin,['Austria'],Mujahid,1897,17,75,1914
Arthur Johnson,['Guam'],Politician,1879,21,23,1900
Stefanie Tucker,"['Saint Martin', 'Estonia']",Politician,1891,48,39,1939
Lisa Cruz,['Antigua and Barbuda'],Magician,1904,65,75,1969
Tyler Logan,['Saint Barthelemy'],Tailor,1896,44,6,1940
Ruth Mcmahon,['Morocco'],Artist,1904,86,66,1990
Christopher Novak,"['Guam', 'Nauru']",Artist,1871,58,29,1929
Carl Carter,"['Panama', 'Slovenia']",Artist,1916,69,66,1985
Patrick Johnson,"['Guinea', 'Rwanda']",Politician,1901,38,13,1939
William Butler,"['Wallis and Futuna', 'Kazakhstan']",Artist,1906,21,16,1927
Sonya Dominguez,['Reunion'],Politician,1887,39,53,1926
Amber Phillips,"['Botswana', 'Palau']",Athlete,1913,62,15,1975
Hannah Robinson,['Singapore'],Artist,1888,46,48,1934
Melissa Smith,"['Holy See (Vatican City State)', 'Mauritania']",Mountaineer,1901,65,27,1966
Victoria Roberts,['United States Minor Outlying Islands'],Artist,1875,73,66,1948
Trevor Martinez,['China'],Artist,1922,57,66,1979
Kimberly Hood,['Papua New Guinea'],Artist,1903,61,10,1964
Mark Glover,"['Uruguay', 'Micronesia']",Artist,1919,72,73,1991
Rebecca Haynes,"['Fiji', 'Wallis and Futuna']",Artist,1894,82,46,1976
April Myers,"['Netherlands', 'Latvia']",Politician,1906,88,23,1994
Michael Michael,"['Zimbabwe', 'Haiti']",Artist,1871,71,40,1942
William Green,"['Lesotho', 'Kuwait']",Artist,1895,13,35,1908
Paul Howell,['San Marino'],Politician,1872,79,40,1951
Timothy Flowers,['Malta'],Artist,1904,34,79,1938
Jill Knight,"['Tonga', 'Guam']",Watercolourist,1920,69,52,1989
Michael Shah,"['French Guiana', 'Jamaica']",Artist,1876,29,80,1905
Joseph Jennings,['Israel'],Athlete,1900,24,74,1924
Carlos Hayden,['Marshall Islands'],Artist,1902,34,12,1936
Laurie Adams,"['Romania', 'Turkmenistan']",Pianist,1915,65,84,1980
Curtis Fitzpatrick,['Hong Kong'],Politician,1896,32,20,1928
Jaime Graham,"['Seychelles', 'Senegal']",Manual worker,1910,44,54,1954
Tara Phillips,['New Zealand'],Artist,1909,40,85,1949
Michael Gould,['Bangladesh'],Artist,1909,73,0,1982
Jessica Taylor,['Taiwan'],Artist,1907,28,88,1935
Robyn Petersen,['Myanmar'],Politician,1870,36,38,1906
Robert Grant,"['Philippines', 'Liechtenstein']",Artist,1923,10,11,1933
Leroy Lopez,"['Martinique', 'Saint Barthelemy']",Athlete,1894,83,69,1977
Jesse Smith,['Niue'],Event rider,1876,63,9,1939
Bruce Martin,['Guernsey'],Artist,1899,78,48,1977
Jasmine Coleman,['Djibouti'],Politician,1910,66,47,1976
Russell Wallace,"['Libyan Arab Jamahiriya', 'Korea']",Artist,1896,42,78,1938
John Griffith MD,['Gibraltar'],Politician,1870,78,52,1948
Marissa Ward,"['Spain', 'Western Sahara']",Politician,1901,64,61,1965
Ashlee Martin,['Togo'],Artist,1874,2,74,1876
David Morgan,"['Swaziland', 'Malaysia']",Artist,1898,79,58,1977
Pam Walker,['Armenia'],Artist,1900,10,58,1910
David Davis,"['Benin', 'Tokelau']",Researcher,1915,46,1,1961
Emma Hill,"['Kuwait', 'Guyana']",Long-distance runner; marathon runner,1913,12,58,1925
Benjamin Moore,"['Venezuela', 'Kenya']",Artist,1917,36,4,1953
Sarah Decker,"['Uzbekistan', 'Brazil']",Artist,1909,7,6,1916
Anthony Hull,"['French Southern Territories', ""Lao People's Democratic Republic""]",Artist,1902,69,75,1971
Brandon Chapman,['Bahamas'],Artist,1891,88,73,1979
Jeremy Moses,['Cuba'],Athlete,1893,54,5,1947
Michael Chambers,"['Norway', 'Dominican Republic']",Researcher,1872,67,7,1939
Austin Montgomery,['Svalbard & Jan Mayen Islands'],Artist,1897,39,40,1936
William Cisneros,"['Saint Martin', 'Argentina']",Researcher,1872,47,37,1919
Justin Russell,['British Indian Ocean Territory (Chagos Archipelago)'],Artist,1907,4,88,1911
Deborah Chaney,"['South Georgia and the South Sandwich Islands', 'Madagascar']",Artist,1924,32,11,1956
Paige Johnson,['Pitcairn Islands'],Artist,1871,42,3,1913
Tyler Chan,['Morocco'],Athlete,1923,88,81,2011
Patrick Maldonado,"['Guatemala', 'Faroe Islands']",Politician,1904,52,37,1956
Kendra Collins MD,['Bulgaria'],Artist,1908,7,5,1915
April Holmes,['France'],Artist,1908,84,64,1992
Monica Munoz,['Tanzania'],Journalist,1889,79,8,1968
Heather White,"['British Indian Ocean Territory (Chagos Archipelago)', 'Tonga']",Artist,1882,58,12,1940
Phyllis Franklin,['Zambia'],Artist,1914,14,70,1928
Stacey Adkins,"['Falkland Islands (Malvinas)', 'Brunei Darussalam']",Artist,1911,41,44,1952
Michael Hoffman,['Falkland Islands (Malvinas)'],Physician,1881,72,56,1953
Nathaniel Hamilton,"['Senegal', 'Puerto Rico']",Military personnel,1900,44,51,1944
Maria Dennis,['Kiribati'],Politician,1894,67,75,1961
Jessica Faulkner,"[""Lao People's Democratic Republic"", 'Niger']",Artist,1884,25,47,1909
Tyler Lee,['Romania'],Artist,1911,77,2,1988
Patricia Ward,"['Germany', 'Antigua and Barbuda']",Artist,1923,7,29,1930
Scott Jones,"['Bosnia and Herzegovina', 'Burundi']",Artist,1894,88,3,1982
Jeffrey Gilbert,['Turks and Caicos Islands'],SeiyÅ«,1916,71,16,1987
Jeffery Wood,['Liberia'],Politician,1895,81,87,1976
Alexis Torres,['French Southern Territories'],Artist,1906,19,85,1925
Katherine Walls,['Marshall Islands'],Athlete,1903,17,24,1920
Brian Sanders,['Palau'],Athlete,1914,54,18,1968
Tara Terry,"['Oman', 'Heard Island and McDonald Islands']",Researcher,1921,20,54,1941
Debra Wiggins,"['Venezuela', 'Seychelles']",Politician,1886,25,60,1911
Donna Sanchez,"['Greenland', 'Iran']",Christians jehovahâ€™s witnesses,1914,10,89,1924
Andrew Johnson,['Guadeloupe'],Politician,1871,16,69,1887
Sherry Green,"['Uganda', 'Saint Barthelemy']",Religious figure,1919,12,65,1931
Melissa Pierce,"['Brazil', 'Ecuador']",Politician,1914,47,89,1961
Miguel Mathis,"['Peru', 'French Southern Territories']",Military personnel,1877,46,66,1923
John Carr,"['North Macedonia', 'North Macedonia']",Politician,1879,65,84,1944
Joe Jones,"['Panama', 'Vietnam']",Artist,1891,44,29,1935
Randall Johnson,['Vietnam'],Athlete,1901,76,72,1977
April Lyons,['Netherlands Antilles'],Artist,1897,10,4,1907
Timothy Calhoun,['Iran'],Politician,1892,31,88,1923
Jonathan Gill,['Puerto Rico'],Researcher,1884,89,11,1973
Carolyn Murphy,"['Pakistan', 'Brunei Darussalam']",Artist,1892,37,35,1929
Dillon Barrett,"['United States Virgin Islands', 'Aruba']",Artist,1915,5,23,1920
Larry Ware,"['Nicaragua', 'Kuwait']",Artist,1906,37,35,1943
Melissa Acosta,['Namibia'],Artist,1885,56,25,1941
Jill Hammond,"['Russian Federation', 'China']",Artist,1893,59,38,1952
Richard Garcia,['Moldova'],Engineer,1910,9,3,1919
Scott Martinez,"['Suriname', 'Saint Vincent and the Grenadines']",Artist,1906,32,46,1938
Stephen Garrett,"['United States of America', 'France']",Physician,1910,28,88,1938
Jerry Hernandez,['Syrian Arab Republic'],Artist,1909,39,70,1948
Lori Best,"['Morocco', 'Dominica']",Artist,1874,39,36,1913
Marcus Sanchez,"['Philippines', 'Namibia']",Artist,1913,31,33,1944
Savannah Wright,"['Congo', 'Thailand']",Researcher,1875,64,7,1939
Dakota White,"['Oman', 'Mauritania']",Politician,1890,68,68,1958
Kyle Lang,['Dominica'],Artist,1889,80,67,1969
Eric Wagner,"['Vietnam', 'Philippines']",Politician,1900,33,21,1933
Tiffany Cruz,"['Senegal', 'Trinidad and Tobago']",Artist,1908,43,61,1951
Douglas Taylor,['Iraq'],Event rider,1870,70,38,1940
Vanessa Morales,['Congo'],Artist,1892,4,15,1896
Mark Miller,"['Haiti', 'Trinidad and Tobago']",Artist,1904,4,46,1908
Sandra Johnson,['Sudan'],Researcher,1906,43,7,1949
Stacey Walker,"['Malawi', 'Korea']",Flower seller; prostitute; crocheter,1902,41,77,1943
Stephanie Thomas,['Singapore'],Artist,1885,16,29,1901
John Phillips,['South Africa'],Artist,1877,23,57,1900
Christopher Martinez,['Brunei Darussalam'],Artist,1918,10,30,1928
Leslie Shannon,['Turkmenistan'],Artist,1891,79,36,1970
John Douglas,['Greenland'],Artist,1907,22,44,1929
Randall Nelson,['Tonga'],Politician,1902,39,28,1941
Johnny Camacho,['Chad'],Artist,1872,11,15,1883
Nathaniel Goodman,['Norway'],Athlete,1892,18,71,1910
Derek Flowers,"['Turkey', 'Croatia']",Researcher,1894,40,6,1934
Paul Reed,"['Swaziland', 'Ukraine']",Entrepreneur,1909,9,18,1918
Carlos Cook,"['New Zealand', 'Saint Pierre and Miquelon']",Artist,1905,34,79,1939
Maria Payne,"['New Caledonia', 'Sri Lanka']",Imam,1877,30,4,1907
Edward Manning,['Portugal'],Rally driver,1876,72,69,1948
Joseph Edwards,['Bouvet Island (Bouvetoya)'],Motorcycle racer,1905,24,24,1929
Thomas Ball,"['Samoa', 'Mongolia']",Artist,1873,38,51,1911
Jason Strickland,['Tuvalu'],Artist,1904,74,83,1978
Veronica Wilson,"['Ireland', 'Bahrain']",Artist,1880,30,47,1910
Megan Larson,['Ecuador'],Artist,1882,39,38,1921
Valerie Payne,['South Georgia and the South Sandwich Islands'],Athlete,1910,7,38,1917
Cody Navarro,['Palestinian Territory'],Politician,1897,48,39,1945
Aaron Abbott,"['Bangladesh', 'Russian Federation']",Artist,1899,70,22,1969
Jennifer Mckee,['Andorra'],Military personnel,1917,46,37,1963
Thomas Jones,['Vietnam'],Politician,1899,7,42,1906
Chad Glover,"['Nepal', 'Somalia']",Artist,1896,60,13,1956
William Young,"['Norfolk Island', 'Libyan Arab Jamahiriya']",Spree killer; mass murderer,1912,86,47,1998
Brandy Bryan,['Peru'],Artist,1895,74,71,1969
Lori Bush,"['Turks and Caicos Islands', 'Western Sahara']",Ballet dancer,1919,54,55,1973
Laura Castillo,"['Venezuela', 'Malaysia']",Artist,1907,81,28,1988
Michael Washington,"['Guyana', 'Slovakia (Slovak Republic)']",Artist,1879,69,62,1948
Angie Peterson,['Chile'],Artist,1902,77,48,1979
Patricia Rodriguez,['French Southern Territories'],Artist,1907,45,72,1952
Brandon Lyons,"['United States Virgin Islands', 'Kiribati']",Artist,1904,2,22,1906
Gabriela Hodge,"['Marshall Islands', 'Antigua and Barbuda']",Artist,1915,56,29,1971
Thomas Davis,['Jamaica'],Athlete,1918,34,27,1952
William Smith,['Turks and Caicos Islands'],Aristocrat,1914,19,12,1933
Michael Ramirez,['Switzerland'],Artist,1923,28,35,1951
Ronald Weaver,['Guernsey'],Politician,1922,82,81,2004
Monica Todd,['Uruguay'],Artist,1912,70,13,1982
Dawn Short,['Mali'],Politician,1890,48,34,1938
Christopher Murray,['British Indian Ocean Territory (Chagos Archipelago)'],Artist,1900,18,59,1918
Elizabeth Martin,"['Latvia', 'Fiji']",Politician,1904,47,35,1951
Stephanie Myers PhD,"['Turkey', 'Bermuda']",Politician,1906,56,50,1962
Keith Hammond,"['Turks and Caicos Islands', 'Western Sahara']",Politician,1872,33,2,1905
Joseph Bishop,['Tokelau'],Esperantist; lexicographer,1873,63,60,1936
Christina Yu,['Greece'],Artist,1904,2,30,1906
Calvin Brown,['Somalia'],Artist,1903,74,85,1977
Erica Atkins,"['Palestinian Territory', 'Namibia']",Terrorist,1917,86,2,2003
Catherine Arnold,"['Yemen', 'Reunion']",Translator,1892,41,11,1933
Kristen Barrera,['Nauru'],Artist,1895,41,16,1936
Diana Smith,"['Sri Lanka', 'Taiwan']",Military personnel,1918,5,83,1923
Curtis Alvarez,['Ukraine'],Researcher,1891,37,46,1928
Steven Roberts,['Singapore'],Artist,1885,11,9,1896
Kathryn Gates,"['Morocco', 'Saint Vincent and the Grenadines']",Military personnel,1923,40,73,1963
Joshua Stephens,"['Somalia', 'French Polynesia']",Athlete,1879,63,59,1942
Matthew Peterson,['Guyana'],Military personnel,1886,76,20,1962
Melissa Moreno,['Monaco'],Politician,1909,87,6,1996
Robert Diaz,['Venezuela'],Artist,1920,55,12,1975
Wesley Brown,"['Monaco', 'Turks and Caicos Islands']",Cook; restaurateur,1924,88,32,2012
Cynthia Oconnor,"['Zambia', 'Czech Republic']",Terrorist,1907,70,75,1977
Elizabeth Martinez,"['Malaysia', 'Portugal']",Politician,1882,24,25,1906
Elizabeth Day,"['Malta', 'Albania']",Politician,1921,44,51,1965
Cory Young,['Albania'],Religious figure,1912,22,20,1934
Monica Rodriguez,"['Costa Rica', 'Somalia']",Artist,1920,31,35,1951
Breanna Johnson,['Oman'],Researcher,1906,55,66,1961
Bethany White,['Vietnam'],Artist,1919,28,64,1947
Randy Simmons,"['Bangladesh', 'Syrian Arab Republic']",Artist,1916,33,18,1949
Jennifer Rojas,['Cayman Islands'],Artist,1905,12,75,1917
Patrick Hall,['Saint Martin'],Artist,1908,8,32,1916
Pamela Freeman,"['Korea', 'Belize']",Religious figure,1886,75,56,1961
Gabriel Lewis,"['Ecuador', 'Guernsey']",Artist,1915,27,23,1942
Brian Garcia,"['Gambia', 'Cayman Islands']",Artist,1905,17,75,1922
Jonathan Fletcher,"['Kuwait', 'Vietnam']",Journalist,1886,30,46,1916
Cynthia Carter,"['Maldives', 'Spain']",Artist,1887,50,86,1937
Timothy Townsend,"['Panama', 'Gibraltar']",Resistance fighter,1870,32,43,1902
Sherri Atkinson,['Cyprus'],Artist,1907,56,59,1963
Kim Collins,"['Kuwait', 'Macao']",Researcher,1916,3,25,1919
Craig Reid,"['Myanmar', 'Czech Republic']",Military personnel,1914,65,89,1979
Laura Bell,"['Solomon Islands', 'Grenada']",Artist,1917,31,16,1948
Cynthia Mejia,['Libyan Arab Jamahiriya'],Artist,1915,71,36,1986
Caitlyn Raymond,"['Isle of Man', 'Gabon']",Canoeist,1899,87,37,1986
Katherine Martinez,"['Central African Republic', 'Cook Islands']",Artist,1879,67,54,1946
Bonnie Terry,['Senegal'],Researcher,1879,28,76,1907
Jonathan Farrell,"['Albania', 'Liechtenstein']",Researcher,1880,77,61,1957
Jennifer Lee,['Cameroon'],Artist,1891,1,78,1892
Christina Hernandez,"['Haiti', 'Slovakia (Slovak Republic)']",Politician,1908,35,1,1943
Elizabeth Johnson,"['Azerbaijan', 'Ethiopia']",Artist,1883,28,77,1911
Jennifer Evans,['South Africa'],Artist,1894,16,50,1910
Karen Rogers,"['Falkland Islands (Malvinas)', 'Estonia']",Artist,1914,70,21,1984
Karen Rodriguez,"['Indonesia', 'Argentina']",Artist,1879,28,38,1907
Katelyn Kennedy,['Hungary'],Artist,1917,87,61,2004
Jennifer Obrien,"['Cayman Islands', 'Turkmenistan']",Researcher,1924,30,38,1954
Mary Dean,"['Myanmar', 'Monaco']",Artist,1917,30,35,1947
Melissa Foley,"['Denmark', 'India']",Researcher,1877,32,34,1909
Christian Wells,"['Belgium', 'Zambia']",Artist,1875,83,83,1958
Jacob Martin,"['Guinea', 'Latvia']",Duke,1920,3,13,1923
Penny Stout,"['Saint Pierre and Miquelon', 'Nicaragua']",Artist,1886,5,65,1891
Jason Duncan MD,['Montserrat'],Artist,1907,1,44,1908
Bradley Kramer,"['Kazakhstan', 'Netherlands Antilles']",Businessperson,1870,64,16,1934
Michael King,['Ethiopia'],Researcher,1879,62,29,1941
Robert Nunez,['Bouvet Island (Bouvetoya)'],Artist,1893,56,57,1949
Shawn Green,['Panama'],Artist,1900,55,75,1955
Michael Carter,['Bolivia'],Artist,1889,54,51,1943
Cassandra Esparza,"['Saint Barthelemy', 'Saint Barthelemy']",Athlete,1913,17,52,1930
James Soto,['Central African Republic'],Artist,1877,11,63,1888
Kevin Hall,"['Cayman Islands', 'Montserrat']",Artist,1898,19,24,1917
Brian Fowler,"['Canada', 'French Polynesia']",Aristocrat,1918,84,75,2002
Eric Miller,['Pakistan'],Artist,1909,9,22,1918
Andrew Schultz,"['Micronesia', 'Monaco']",Athlete,1910,28,10,1938
Paul Cox,['Macao'],Artist,1887,58,57,1945
Michael Ward,"['Colombia', 'British Indian Ocean Territory (Chagos Archipelago)']",Artist,1883,42,10,1925
Kelly Garza,['Western Sahara'],Politician,1923,6,21,1929
Courtney Dawson,['Bahrain'],Artist,1875,46,29,1921
Brian Ali,"['Estonia', 'Falkland Islands (Malvinas)']",Politician,1890,52,61,1942
Charles Vasquez,['France'],Artist,1921,10,11,1931
Antonio Smith,"['Egypt', 'Antarctica (the territory South of 60 deg S)']",Artist,1923,70,38,1993
Carolyn Velasquez,"['Dominica', 'Gibraltar']",Researcher,1881,12,38,1893
Christopher Wilson,"['Benin', 'Guatemala']",Artist,1894,78,48,1972
Kevin Neal,"['Jordan', 'Angola']",Artist,1881,8,61,1889
Robert Powell,"['Cameroon', 'Cyprus']",Artist,1890,14,86,1904
Kenneth Mitchell,['Saint Martin'],Athlete,1890,64,71,1954
Victor Alexander,"['Nicaragua', 'Burundi']",Artist,1914,86,37,2000
Christopher Smith,['Cape Verde'],Politician,1908,42,74,1950
Katrina Walker,"['Guinea', 'Montenegro']",Politician,1906,23,56,1929
Evelyn Young,"['Guyana', 'Finland']",Artist,1912,45,31,1957
Dr. Mark Ingram,"['Denmark', 'Spain']",Military personnel,1883,0,58,1883
Dr. David Williams,"['Panama', 'Saint Helena']",Politician,1881,18,8,1899
Allen Williams,"['Congo', 'Kenya']",Artist,1880,76,8,1956
Michelle White,['Puerto Rico'],Artist,1923,21,53,1944
Tiffany Carroll,['Indonesia'],Racing automobile driver; formula one driver,1873,80,55,1953
Travis Berry,['Israel'],Artist,1873,57,29,1930
Jason Cline,"['Central African Republic', 'Jordan']",Artist,1898,39,50,1937
Angela Kelly,['Djibouti'],Playwright; author; dramaturge,1923,77,78,2000
Logan Vargas,['Botswana'],Artist,1922,71,59,1993
Gerald Turner,"['Bermuda', 'Palau']",Artist,1904,63,57,1967
Christopher Clay,['Sri Lanka'],Artist,1877,57,23,1934
Andre Stephens,['Cyprus'],Artist,1881,15,80,1896
Michelle Mendez,['French Guiana'],Researcher,1900,66,26,1966
Tyler Carney,['Reunion'],Artist,1915,28,26,1943
Jared Smith,['Tuvalu'],Businessperson,1891,33,77,1924
Kenneth Crawford,['Denmark'],Journalist,1895,67,67,1962
Vincent Anderson,"['Mexico', 'Belize']",Politician,1907,62,81,1969
Sarah Pace,"['Moldova', 'Wallis and Futuna']",Politician,1907,34,25,1941
Lauren Jackson,['Kazakhstan'],Athlete,1889,89,81,1978
Nicole Garcia,"['Guyana', 'Isle of Man']",Researcher,1913,54,7,1967
Lindsay Cook,"['Paraguay', 'Australia']",Politician,1882,4,40,1886
Patrick Mcdaniel,['El Salvador'],Researcher,1913,64,74,1977
Katherine Jones,"['Turkey', 'Botswana']",Artist,1905,49,0,1954
Richard Riley,['Vanuatu'],Graphic designer; designer,1914,16,47,1930
Bryan Cabrera,['Egypt'],Artist,1886,74,89,1960
Caleb Gutierrez,['Dominica'],Teacher,1887,6,43,1893
Stanley Sloan,"['Mozambique', 'Christmas Island']",Presbyter; ordination,1895,26,10,1921
Miss Brianna Jones,['Gambia'],Researcher,1901,54,37,1955
Douglas Newton,['Bulgaria'],Researcher,1915,78,82,1993
Mary Sullivan,"['Kiribati', 'Samoa']",Artist,1916,24,11,1940
James Hardy,"['Hong Kong', 'Uruguay']",Artist,1881,19,59,1900
Christine Becker,['Cayman Islands'],Artist,1909,33,78,1942
Rhonda Hancock,"['Montserrat', 'United Kingdom']",Drug lord,1923,25,52,1948
Janice Wright,"['Dominican Republic', 'United States Minor Outlying Islands']",Artist,1908,20,45,1928
Crystal Garner,"['Tonga', 'Togo']",Politician,1911,76,8,1987
Natasha Hopkins,['Uruguay'],Flower seller; prostitute; crocheter,1921,79,88,2000
Tammy Cox,"['San Marino', 'Ethiopia']",Politician,1898,18,30,1916
Crystal Foster,['El Salvador'],Artist,1917,81,79,1998
Kristine Farrell,['Tunisia'],Artist,1881,76,17,1957
Lisa Williams,['Bhutan'],Military personnel,1920,11,87,1931
Jonathan Adams,['Slovakia (Slovak Republic)'],Functionary,1908,73,21,1981
Holly Ray,"['Mexico', 'Latvia']",Artist,1903,17,27,1920
Matthew Anderson,"['Botswana', 'Philippines']",Engineer,1909,22,76,1931
Troy Novak,"['Heard Island and McDonald Islands', 'Syrian Arab Republic']",Artist,1870,20,66,1890
Brittany Webster,"['Saint Martin', 'Costa Rica']",Artist,1905,45,56,1950
Jeremiah Rodriguez,['Qatar'],Serial killer; manual worker,1909,42,46,1951
Nathan Hurst,"['Morocco', 'Finland']",Artist,1902,61,2,1963
Richard Stephens,"['Iraq', 'United States Minor Outlying Islands']",Artist,1870,45,56,1915
Andrew Carter,['New Zealand'],Artist,1894,32,9,1926
Claudia Vazquez,"['Taiwan', 'South Africa']",Artist,1902,46,83,1948
Antonio Dorsey,"['Iceland', 'Guadeloupe']",Politician,1871,78,89,1949
Rhonda Perez,['Qatar'],Artist,1878,22,81,1900
Scott Smith,['Mauritius'],Athlete,1908,19,31,1927
Ashley Gibson,['Micronesia'],Athlete,1876,48,21,1924
Jeff Lopez,['Saint Pierre and Miquelon'],Politician,1875,72,6,1947
Marc Salazar,"['Lithuania', 'Moldova']",Translator,1876,27,8,1903
Patricia Morgan,"['Malta', 'Korea']",Athlete,1873,26,68,1899
Chad Smith,['Faroe Islands'],Artist,1919,87,1,2006
Jessica Brown,"['Zambia', 'French Guiana']",Artist,1888,4,13,1892
Michelle Carter,['Finland'],Politician,1878,86,27,1964
Susan Smith,['United Arab Emirates'],Nurse; serial killer,1896,19,38,1915
Eric Thompson,['Bolivia'],Politician,1919,25,23,1944
Bianca Phillips,['Botswana'],Artist,1924,50,84,1974
Ronald Cooper,['Switzerland'],Artist,1910,43,35,1953
Calvin Williams,['Bermuda'],Artist,1883,34,20,1917
Dana Stephens,['Zimbabwe'],Politician,1891,86,61,1977
Karen Johnson,['Togo'],Artist,1919,33,27,1952
Renee Arnold,"['Falkland Islands (Malvinas)', 'Guatemala']",Military personnel,1889,54,76,1943
Meghan Kelly,['Bulgaria'],Artist,1908,78,79,1986
Leah Jimenez,['Guam'],Military personnel,1890,82,51,1972
Haley Kane,"['Honduras', 'Central African Republic']",Military personnel,1881,46,70,1927
Sean Harris,['Palestinian Territory'],Artist,1880,17,18,1897
Morgan Bell,['Honduras'],Artist,1909,9,31,1918
Brandon Smith,"['Bahamas', 'Georgia']",Artist,1917,57,47,1974
Nicole Gonzales,['Israel'],Artist,1878,89,43,1967
Mark Hobbs,"['Western Sahara', 'Denmark']",Businessperson,1915,11,26,1926
Stephen Willis,['Guyana'],Artist,1916,41,9,1957
Anthony Thomas,['Luxembourg'],Geographer; explorer,1916,78,74,1994
Jacob Baker,['Aruba'],Politician,1900,77,24,1977
Justin Newman,"['Guyana', 'Eritrea']",Artist,1906,18,16,1924
Kayla Swanson,"['Turkmenistan', 'Afghanistan']",Politician,1892,42,69,1934
Cole Moore,['Palestinian Territory'],Researcher,1887,18,41,1905
Larry Morales,"['Tunisia', 'Uganda']",Artist,1906,85,49,1991
Paul Duffy,['Latvia'],Artist,1870,47,51,1917
Joseph Brooks,['Hong Kong'],Artist,1878,61,66,1939
Michael Harvey,['Sweden'],Politician,1901,58,36,1959
Kevin Spencer,"['Pakistan', 'Swaziland']",Artist,1875,4,71,1879
Cole Hill,"['Venezuela', 'Svalbard & Jan Mayen Islands']",Athlete,1915,39,80,1954
James Knight,['Madagascar'],Politician,1873,44,11,1917
Rachel Smith,['Morocco'],Artist,1878,17,79,1895
Rachel Hall,['Mayotte'],Politician,1876,22,7,1898
Ryan Walker,['Guinea-Bissau'],Artist,1893,83,45,1976
Roger Taylor,"['Montserrat', 'Singapore']",Artist,1877,79,9,1956
James Miller,"['Nicaragua', 'Aruba']",Artist,1919,71,62,1990
Barbara Adams,"['Korea', 'Macao']",Artist,1923,15,45,1938
Patrick Glover,['Central African Republic'],Researcher,1874,46,46,1920
Kevin Brown,"['Liechtenstein', 'Reunion']",Researcher,1892,57,10,1949
Natalie Smith,['Luxembourg'],Athlete,1873,5,28,1878
Andre Farrell MD,['Norway'],Artist,1918,77,57,1995
Courtney Bridges,['Falkland Islands (Malvinas)'],Politician,1905,46,59,1951
Kathy Moody,"['Guyana', 'Brunei Darussalam']",Military personnel,1922,19,85,1941
Brendan Reese,"['Guam', 'Gibraltar']",Politician,1916,26,57,1942
Austin Maxwell,"['Comoros', 'Wallis and Futuna']",Suffragette; socialite; philanthropist; suffragist; feminist,1906,44,26,1950
Nicholas Campbell,['British Virgin Islands'],Artist,1889,37,50,1926
Kaitlyn Flores,"['Rwanda', 'Czech Republic']",Freestyle skier,1871,63,2,1934
Cynthia Bell,"['Guinea-Bissau', 'Canada']",Researcher,1876,29,44,1905
John Mitchell,"['Mayotte', 'Suriname']",Artist,1882,57,43,1939
Joseph Bishop,['Nigeria'],Researcher,1884,10,41,1894
Pamela Elliott,"['Zimbabwe', 'Portugal']",Artist,1898,84,53,1982
Rebecca Ramos,"['Mozambique', 'Nauru']",Researcher,1892,43,15,1935
Beth Morris,"['Lebanon', 'Micronesia']",Artist,1876,57,85,1933
Eric Adams,['Paraguay'],Politician,1915,61,78,1976
Helen Welch,['Fiji'],Artist,1919,89,29,2008
Marissa Young,"['Hungary', 'Syrian Arab Republic']",Researcher,1897,75,11,1972
Paul Burke,['Netherlands'],Researcher,1895,40,29,1935
Ashley Brown,['Switzerland'],Athlete,1919,7,74,1926
David Duke,"['Costa Rica', 'Singapore']",Amateur wrestler,1919,70,42,1989
Krystal Martinez,"['Equatorial Guinea', 'Vanuatu']",Engineer,1879,22,25,1901
Daniel Haynes,['Malta'],Artist,1887,82,59,1969
Gabriela Schmidt,"['Burundi', 'Moldova']",Artist,1894,61,21,1955
Michael Morales,"['Spain', 'Canada']",Politician,1884,56,19,1940
Tammy Williams,['Malaysia'],Engineer,1875,37,38,1912
Jared Chang,"['Uruguay', 'Falkland Islands (Malvinas)']",Patron of the arts,1870,78,79,1948
Tabitha Hudson,"['Luxembourg', 'Sweden']",Military personnel,1874,55,39,1929
Joseph Marsh,"['Brunei Darussalam', 'Mali']",Aristocrat,1901,44,76,1945
Zachary Sweeney,['Saint Pierre and Miquelon'],Politician,1875,24,8,1899
Vanessa Bates,['Nauru'],Teacher,1911,60,59,1971
Thomas Ibarra,"['Vietnam', 'Liberia']",Politician,1923,60,52,1983
Christine Bowers,['Finland'],Politician,1911,36,55,1947
Alicia Lee,"['Costa Rica', 'Luxembourg']",Artist,1905,21,40,1926
Mrs. Ashley Rojas,"['Namibia', 'Cuba']",Businessperson,1912,55,57,1967
Amy Olson,['Uzbekistan'],Politician,1889,41,70,1930
Erin Davis,"['United States Minor Outlying Islands', 'Mayotte']",Penciller,1904,43,21,1947
Mr. Matthew Moran,['Micronesia'],Artist,1882,41,47,1923
Dominic Watson,['Russian Federation'],Politician,1881,49,10,1930
Susan Morales MD,['Svalbard & Jan Mayen Islands'],Artist,1899,11,81,1910
Pamela Price,['Wallis and Futuna'],Artist,1904,41,31,1945
Lori Wheeler,"['Bahrain', 'Vietnam']",Politician,1875,65,13,1940
Thomas Morgan,['Australia'],Artist,1922,46,47,1968
Tammy Rivas,['Somalia'],Artist,1899,48,30,1947
Paul Wagner,['Libyan Arab Jamahiriya'],Artist,1896,9,80,1905
Karen Hinton,"['Gambia', 'Mayotte']",Gangster,1886,39,36,1925
Mrs. Chelsey Castro,"['Burundi', 'Bangladesh']",Artist,1900,64,61,1964
Joe Chapman,"['Mongolia', 'India']",Politician,1891,9,85,1900
Danny Allen,"['Faroe Islands', 'Luxembourg']",Presbyter,1912,51,18,1963
Timothy Reyes,"['Djibouti', 'Mexico']",Military personnel,1922,54,86,1976
Jessica Valencia,['Philippines'],Artist,1886,19,63,1905
Timothy Hall,['Myanmar'],Athlete,1887,46,42,1933
Joseph Boyd,"['Palestinian Territory', 'New Zealand']",Artist,1922,63,48,1985
James Fleming,"['United States of America', 'Thailand']",Researcher,1907,3,16,1910
Emily Perez,"['Libyan Arab Jamahiriya', 'Kyrgyz Republic']",Artist,1915,70,37,1985
Tiffany Floyd,"['Netherlands Antilles', 'Pakistan']",Artist,1924,20,72,1944
Mark Peters,['Belarus'],Politician,1878,22,82,1900
Anthony Cooper,['Kyrgyz Republic'],Athlete,1923,20,18,1943
Charles Johnson,['Bhutan'],Teacher,1920,1,27,1921
Jeffrey Parker,['Guinea'],Military personnel,1887,1,21,1888
Katie Clarke,"['Sao Tome and Principe', 'Saint Barthelemy']",Politician,1911,55,76,1966
David Rodriguez,['Guinea'],Athlete,1875,26,82,1901
Steven Peterson,['Holy See (Vatican City State)'],Businessperson,1887,29,66,1916
Angie Compton,"['Heard Island and McDonald Islands', 'Turkey']",Military personnel,1919,31,11,1950
Pamela Harris,"['Netherlands Antilles', 'Mauritius']",Politician,1878,55,14,1933
Anthony Vaughn,['Afghanistan'],Artist,1922,19,62,1941
Michelle Patton,['Austria'],Partisan,1907,40,60,1947
David Rodriguez,['Turkey'],Religious figure,1871,10,75,1881
Vanessa Potter,"['Guernsey', 'Ethiopia']",Artist,1894,65,34,1959
Tara Roberts,"['Poland', 'Gambia']",Ruler,1909,62,51,1971
Robert Rodriguez,"['Mayotte', 'Luxembourg']",Athlete,1922,76,77,1998
Sherry Anderson,['Bermuda'],Artist,1911,45,63,1956
Brandi Gibson,['Vanuatu'],Politician,1896,87,21,1983
Kelly Kelly,"['Kazakhstan', 'Niger']",Artist,1886,68,49,1954
Jason Reed,['French Guiana'],Researcher,1906,25,48,1931
Shannon Mitchell,['Chile'],Athlete,1888,58,48,1946
Wendy Smith,['Hong Kong'],Politician,1892,72,24,1964
Ashley Smith,['Benin'],Engineer,1918,59,31,1977
Mark Bryant,"['Uruguay', 'Nigeria']",Artist,1900,86,54,1986
John Smith,"['Denmark', 'Switzerland']",Nun,1902,11,29,1913
Rachel Garcia,"['Slovenia', 'Madagascar']",Pentito; drug trafficker,1896,21,6,1917
Erica Fernandez,['Korea'],Artist,1882,41,28,1923
Brandon Sanchez,['Venezuela'],Artist,1900,70,23,1970
Barbara Hebert,"['Christmas Island', 'Bosnia and Herzegovina']",Athlete,1911,72,63,1983
Jason Dunn,['Qatar'],Politician,1877,22,15,1899
Matthew Odonnell,"['Chad', 'Paraguay']",Researcher,1878,67,35,1945
Aaron Campbell,"['San Marino', 'Mozambique']",Politician,1885,63,77,1948
Shannon Fitzpatrick,['Somalia'],Film producer,1899,72,56,1971
Eric Gomez,['Albania'],Politician,1921,18,3,1939
Julia Wang,"['Malta', 'Sao Tome and Principe']",Artist,1921,17,11,1938
Keith Mclean,['Saint Martin'],Politician,1881,64,64,1945
Jean Jenkins,"['Thailand', 'Guatemala']",Artist,1903,10,59,1913
Colin Ruiz,"['North Macedonia', 'Azerbaijan']",Researcher,1886,86,1,1972
Troy Klein,['Guinea-Bissau'],Artist,1902,64,34,1966
Brian Reynolds,"['Kyrgyz Republic', 'Algeria']",Artist,1880,53,55,1933
Sharon Elliott,['Norfolk Island'],Entrepreneur,1894,38,55,1932
Laura Rogers,['Korea'],Artist,1914,34,45,1948
Richard Clarke,['Sao Tome and Principe'],Businessperson,1888,4,29,1892
Michael Elliott,['Isle of Man'],Artist,1874,46,34,1920
Jessica Jones,"['Botswana', 'Portugal']",Serial killer,1893,59,38,1952
Courtney Sanchez,"['Dominica', 'Venezuela']",Athlete,1879,76,82,1955
Christopher Phillips,['Gibraltar'],Nurse; serial killer; criminal,1909,81,34,1990
Sean Hardy,"['Turkmenistan', 'Bulgaria']",Artist,1871,15,49,1886
Melissa Russell,['Albania'],Condottiero,1896,83,78,1979
Susan Potts,['Philippines'],Researcher,1908,19,2,1927
Karen Hobbs,['Samoa'],Artist,1889,83,41,1972
Mary Mccormick,"['Syrian Arab Republic', 'Tunisia']",Artist,1914,8,36,1922
Brian Farrell,"['Mali', 'Vanuatu']",Artist,1895,30,40,1925
Jason Rivera,"['Costa Rica', 'Holy See (Vatican City State)']",Entrepreneur,1898,19,1,1917
Michael Roach,"['Anguilla', 'Moldova']",Artist,1900,26,44,1926
Elizabeth Booker,"['Nepal', 'Dominica']",Politician,1923,10,33,1933
Scott Moore,['United Arab Emirates'],Politician,1909,56,67,1965
Michelle Rogers,['United States of America'],Artist,1897,49,75,1946
Sharon Rivera,['Tajikistan'],Artist,1888,28,5,1916
Deborah Lawson,"['Israel', 'Haiti']",Researcher,1872,56,66,1928
Dr. Lawrence Francis MD,['Cyprus'],Artist,1919,20,79,1939
Jacob Griffin,['Bulgaria'],Politician,1907,25,5,1932
Michael Alvarado,['Timor-Leste'],Artist,1901,22,21,1923
Morgan Diaz,['Cocos (Keeling) Islands'],Artist,1896,31,47,1927
Miranda Terry,['Indonesia'],Artist,1874,65,74,1939
Anthony Mccoy,['Egypt'],Athlete,1876,85,46,1961
Rebecca White,"['Martinique', 'Finland']",Politician,1882,13,45,1895
Heather Clements,"['Ghana', 'Croatia']",Artist,1893,71,59,1964
Ryan Johnson,['Niue'],Researcher,1891,48,32,1939
James Allen,['South Africa'],Artist,1900,38,56,1938
Ashley Jackson,"['Togo', 'Switzerland']",Professional wrestler; amateur wrestler,1920,22,15,1942
Marie Fowler,['United States Virgin Islands'],Politician,1905,57,30,1962
James Brown,['Congo'],Athlete,1918,82,67,2000
Tabitha Joseph,"['Mexico', 'Saint Martin']",Military personnel,1916,88,12,2004
Erica Pitts,['Vanuatu'],Artist,1906,76,75,1982
Jimmy Bullock,['Indonesia'],Athlete,1871,62,87,1933
Sarah Taylor,"[""Cote d'Ivoire""]",Artist,1889,43,44,1932
Michael Russo,"['Bolivia', 'Tokelau']",Luger,1883,33,55,1916
Denise Campbell,"['Papua New Guinea', 'Czech Republic']",Artist,1871,48,25,1919
Margaret Smith,"['Heard Island and McDonald Islands', 'Mayotte']",Artist,1873,74,78,1947
Jamie Gardner,"['Kazakhstan', 'Tuvalu']",Politician,1877,37,67,1914
Catherine Ward,['Norfolk Island'],Artist,1916,29,18,1945
Brett Davies,"['Saint Lucia', 'Djibouti']",Artist,1886,25,19,1911
Jennifer Conner,['Bouvet Island (Bouvetoya)'],Athlete,1888,31,0,1919
Aaron Garcia,['Aruba'],Military personnel,1914,3,66,1917
Nathaniel Lucas,['Northern Mariana Islands'],Artist,1893,32,77,1925
Brian Elliott,"['Kuwait', 'Kenya']",Politician,1881,61,73,1942
Daniel Warren,['Congo'],Artist,1887,85,34,1972
Cathy Houston,['Tanzania'],Criminal,1915,84,63,1999
Jill Miller,"['Korea', 'Mozambique']",Politician,1909,46,83,1955
Roberto Hernandez,"['Saint Vincent and the Grenadines', 'Finland']",Artist,1915,76,5,1991
Cheryl Wilson,['Myanmar'],Athlete,1887,30,52,1917
Anna Bender,['Korea'],Athlete,1908,62,84,1970
Diana Miller,"['Paraguay', 'Somalia']",Researcher,1887,6,15,1893
Tiffany Harrison,['Australia'],Nun; christians jehovahâ€™s witnesses,1892,3,13,1895
Elizabeth Nichols,"['Taiwan', 'Palestinian Territory']",Physician,1912,60,23,1972
Stacey Dunn,"['Reunion', 'Lithuania']",Artist,1884,21,85,1905
Carolyn Sparks,"['Uruguay', 'Saint Vincent and the Grenadines']",Politician,1886,70,19,1956
Angela Barnes,['Liberia'],Artist,1903,12,21,1915
Jessica Townsend,['French Southern Territories'],Artist,1892,47,10,1939
Annette Washington,['India'],Religious figure,1921,68,23,1989
Jeffrey Jones,['Nigeria'],Artist,1883,21,78,1904
Eric Harrison,"['Antarctica (the territory South of 60 deg S)', 'Cocos (Keeling) Islands']",Religious figure,1902,82,50,1984
Chelsey Cook,"['Norway', 'Venezuela']",Anthropologist; philosopher,1906,44,8,1950
Lisa Hardin,"['Austria', 'Saudi Arabia']",Artist,1900,7,80,1907
Laurie Johnson,['Guam'],Politician,1908,23,7,1931
Austin Jarvis,"['Argentina', 'Saint Martin']",Artist,1897,79,54,1976
John Ayala,"['Iran', 'Saint Lucia']",Artist,1909,33,40,1942
Derek Kirk,['Yemen'],Artist,1892,5,39,1897
Trevor Sullivan,"['Belarus', 'United States Virgin Islands']",Artist,1904,4,10,1908
Phyllis Le,"['Poland', 'Bangladesh']",Athlete,1899,39,40,1938
Michael Adams,['Mali'],Statesperson,1872,31,18,1903
Evan May,['Uganda'],Religious figure,1898,34,11,1932
Richard Christian,['Belarus'],Researcher,1903,61,70,1964
David Thomas,"['Cameroon', 'Cyprus']",Artist,1901,66,5,1967
Timothy Roberts,['Reunion'],Artist,1907,30,84,1937
Douglas Phillips,"['Korea', 'Senegal']",Researcher,1887,66,75,1953
Sandra Anderson,"['Puerto Rico', 'Rwanda']",Artist,1881,61,76,1942
Dr. Alice Benjamin MD,['Tanzania'],Military personnel,1920,38,25,1958
Timothy Cruz,"['Malaysia', 'Djibouti']",Entrepreneur,1915,84,59,1999
Jacob Rogers,"['Tuvalu', 'Guam']",Researcher,1896,14,48,1910
Kristin Strong,['Jersey'],Artist,1905,24,71,1929
Bryan Berry,['United States Minor Outlying Islands'],Artist,1881,40,7,1921
David May,['Mali'],Sovereign,1887,41,87,1928
Mitchell Holt,['Korea'],Artist,1871,33,69,1904
Tiffany Mack,"['Malta', 'Iraq']",Politician,1877,16,23,1893
Andrew Palmer,"['Guinea-Bissau', 'Angola']",Artist,1887,70,27,1957
Richard Anderson,['Lithuania'],Politician,1917,15,21,1932
John Allen Jr.,"['Heard Island and McDonald Islands', 'Togo']",Rock climber; mountaineer,1912,1,21,1913
Kelly Salinas,['Hong Kong'],Artist,1889,53,75,1942
Michael Hobbs,['Fiji'],Artist,1906,79,57,1985
Alyssa Stephenson,"['Peru', 'Christmas Island']",Researcher,1870,14,37,1884
Gabriella Cherry,['Papua New Guinea'],Artist,1873,43,38,1916
Thomas Cook,"['Cayman Islands', 'Myanmar']",Military personnel,1894,5,45,1899
Daniel Olsen,"['United Arab Emirates', 'Singapore']",Athlete,1887,26,75,1913
Victoria Gonzalez,"['Saint Vincent and the Grenadines', 'Azerbaijan']",Artist,1919,55,65,1974
Jacqueline Duncan,"['Myanmar', 'Saudi Arabia']",Artist,1896,59,54,1955
Christopher Cooper,['Saint Lucia'],Artist,1913,65,82,1978
Christopher Walton,['Belgium'],Military personnel,1877,45,84,1922
Erica Orozco,"['Wallis and Futuna', 'Antarctica (the territory South of 60 deg S)']",Politician,1879,26,36,1905
William Wallace,"['Kenya', 'New Caledonia']",Artist,1892,31,6,1923
Rhonda Ponce,['Kazakhstan'],Physician,1892,64,43,1956
Jennifer Moody,['United States of America'],Athlete,1913,24,20,1937
Craig Murphy,"['Portugal', 'Brazil']",Ice dancer,1880,66,36,1946
Stephanie Caldwell,"['Myanmar', 'Norfolk Island']",Researcher,1910,46,55,1956
Donald Madden,"['Falkland Islands (Malvinas)', 'Tajikistan']",Artist,1922,19,51,1941
Andrew Moore,['Bolivia'],Artist,1921,55,56,1976
John Cox,['Palestinian Territory'],Athlete,1915,2,47,1917
Karina Martin,['North Macedonia'],Entrepreneur,1888,46,40,1934
Lucas Rogers,"['China', 'Mauritius']",Athlete,1909,26,4,1935
Joseph Valdez,['Cuba'],Military personnel,1911,50,78,1961
Alexandra Smith,['Equatorial Guinea'],Artist,1883,20,67,1903
Hannah Chang,['Afghanistan'],Researcher,1923,61,46,1984
Danielle Sparks,['Faroe Islands'],Artist,1887,75,13,1962
Vincent Brewer,['Grenada'],Athlete,1902,36,49,1938
Craig Gillespie,"['Vietnam', 'Angola']",Artist,1916,89,71,2005
Noah Castillo,['Ethiopia'],Artist,1872,83,46,1955
Christian Pineda,"['Zimbabwe', 'Tonga']",Artist,1901,39,53,1940
Anna Davis,['Isle of Man'],Athlete,1894,51,25,1945
Ruth Charles,['Georgia'],Politician,1910,69,84,1979
Ashley Wilson,"['Cuba', 'Aruba']",Politician,1896,5,32,1901
Allison White,"['Portugal', 'Romania']",Athlete,1890,5,60,1895
Eric Golden,['Seychelles'],Artist,1877,63,4,1940
Madison Gonzalez,"['Gambia', 'Dominica']",Artist,1892,82,37,1974
Kelly Dixon,"['Colombia', 'Pitcairn Islands']",Businessperson,1904,39,82,1943
Brooke Hahn,"['Rwanda', 'Tonga']",Artist,1894,4,43,1898
Joshua Jackson,['Congo'],Serial killer,1883,31,85,1914
Austin Curtis,['Switzerland'],Monk,1907,54,78,1961
Dana Williams,"['Timor-Leste', 'Montserrat']",Military personnel,1877,2,28,1879
Rebecca Moore,['Jersey'],Artist,1893,89,12,1982
Stephanie Brewer,['Turks and Caicos Islands'],Politician,1879,46,89,1925
Leslie Harris,"['Montenegro', 'Nepal']",Religious figure,1917,17,13,1934
Deborah Chavez,['Congo'],Artist,1920,66,72,1986
Mrs. Jeanette Hernandez,['Chile'],Politician,1886,11,25,1897
Samantha Leblanc,"['Peru', 'Saint Vincent and the Grenadines']",Politician,1897,59,74,1956
Tara Clark,['Solomon Islands'],Politician,1918,50,11,1968
David Wright,"['Malaysia', 'Hungary']",Artist,1894,7,9,1901
Christopher Hawkins,"['Cayman Islands', 'Gambia']",Motorcycle racer,1882,85,41,1967
Cheryl Oliver,"['Seychelles', 'Kazakhstan']",Artist,1903,31,54,1934
Daniel Fuller,"['United Arab Emirates', 'Antigua and Barbuda']",Politician,1872,75,11,1947
Nicole Dunn,"['Tuvalu', 'Cuba']",Athlete,1917,75,25,1992
Joanne Morrison,"['Latvia', 'Cyprus']",Artist,1904,49,50,1953
Stacey Stewart,"['Seychelles', 'French Polynesia']",Artist,1873,61,12,1934
Emily Cunningham,"['Somalia', 'Israel']",Artist,1920,67,75,1987
Laura Robinson,"['New Caledonia', 'Iceland']",Artist,1916,89,49,2005
Sean Butler,['Sao Tome and Principe'],Artist,1902,67,79,1969
David Ramirez,['Eritrea'],Artist,1890,87,69,1977
Jason Jones,"['Cyprus', 'Gibraltar']",Artist,1873,79,53,1952
Brian Hopkins,"['Brazil', 'Kazakhstan']",Military personnel,1900,9,25,1909
Kyle Ryan,"['Turks and Caicos Islands', 'Nauru']",Engineer,1894,86,84,1980
Rebecca Esparza,"['Montserrat', 'Ecuador']",Television director,1920,28,89,1948
Natasha Martin,['Palestinian Territory'],Military personnel,1893,62,19,1955
Daniel Perkins,['French Southern Territories'],Artist,1908,73,76,1981
Alec Gonzales,['Svalbard & Jan Mayen Islands'],Artist,1921,83,27,2004
Michael Allen,['Belarus'],Artist,1908,68,31,1976
Michael Valdez,['Colombia'],Politician,1879,61,15,1940
Debra Rogers,['Italy'],Military personnel,1924,20,44,1944
Ashley Fisher,"['Kazakhstan', 'United Arab Emirates']",Artist,1916,21,17,1937
Randy Wallace,"['Djibouti', 'Iran']",Artist,1872,63,45,1935
Philip Flores,['Martinique'],Politician,1901,82,77,1983
William Gray,"['Djibouti', 'Morocco']",Artist,1893,39,5,1932
Joshua Castillo,"['Uzbekistan', 'Sudan']",Concentration camp guard,1915,7,54,1922
Thomas Mckenzie,"['Tunisia', 'Korea']",Artist,1891,68,31,1959
Pamela Davis MD,['Finland'],Artist,1888,48,14,1936
William Vincent,"['New Caledonia', 'Jersey']",Ballet dancer; choreographer; ballerina,1923,7,80,1930
Joseph Taylor,"['Uruguay', 'Romania']",Artist,1887,57,29,1944
Ryan Brown,"['Belarus', 'Iceland']",Artist,1897,43,40,1940
Sarah Jones,['French Guiana'],Artist,1877,35,24,1912
Jessica Phillips,['Haiti'],Artist,1874,69,82,1943
Christopher Alvarez,['Tuvalu'],Artist,1907,65,80,1972
Robin Myers,"[""Cote d'Ivoire"", 'Jordan']",Artist,1922,65,48,1987
Autumn Johnson,['Puerto Rico'],Artist,1885,15,51,1900
Tina Moore,['Tonga'],Artist,1878,44,89,1922
Emily Kelly,['Morocco'],Artist,1879,4,44,1883
Aaron Robinson,['Malta'],Artist,1882,86,11,1968
Marisa Horton,['Montenegro'],Submariner,1879,73,26,1952
Isaac Johnson,['Saint Vincent and the Grenadines'],Artist,1873,29,44,1902
Adriana Castillo,['Chad'],Artist,1892,76,50,1968
John Dean,"['Azerbaijan', 'Cook Islands']",Politician,1875,16,87,1891
Micheal Berger,"['Bouvet Island (Bouvetoya)', 'Mauritania']",Artist,1870,72,25,1942
Larry Thompson,"['Micronesia', 'Norfolk Island']",Artist,1896,34,45,1930
Jennifer Garrett,"['Sudan', 'Qatar']",Artist,1905,67,11,1972
Alexandra Lopez,"['Antigua and Barbuda', 'Hungary']",Artist,1914,48,11,1962
Zachary Cox DDS,['Madagascar'],Artist,1893,27,83,1920
Michelle Powell,['Saint Martin'],Artist,1878,33,60,1911
Kenneth Holden,"['Canada', 'Jersey']",Artist,1910,88,73,1998
Brooke Gray,['Egypt'],Politician,1913,59,81,1972
Michele Perez,"['Georgia', 'Lebanon']",Competitive diver,1881,2,74,1883
John Gordon,['Kyrgyz Republic'],Artist,1920,36,24,1956
Jessica Lewis,"['Congo', 'Finland']",Military personnel,1881,40,28,1921
Michael Mills,"['Sri Lanka', 'Svalbard & Jan Mayen Islands']",Artist,1887,20,49,1907
Marissa Harmon,"['Gambia', 'Belarus']",Artist,1914,1,63,1915
Angela White,['Spain'],Artist,1893,0,60,1893
Kimberly Oconnor,"['Vietnam', 'Iceland']",Artist,1900,54,86,1954
John Sanchez,"['Jamaica', 'Ireland']",Artist,1881,27,46,1908
Brandon Holmes,['France'],Athlete,1913,43,88,1956
Thomas Hahn DDS,"['Saint Helena', 'New Zealand']",Social reformer,1884,52,26,1936
Theodore Bernard,['Slovakia (Slovak Republic)'],Flying ace,1882,81,52,1963
Michelle Friedman,['Cape Verde'],Artist,1896,53,70,1949
Jessica Salazar,"['Tunisia', 'Angola']",Police officer; lumberjack,1917,63,67,1980
Dr. Edgar Allison,"['Venezuela', 'Uruguay']",Politician,1871,67,70,1938
Veronica Dunn,"['Saudi Arabia', 'Nauru']",Artist,1877,46,2,1923
Evan Herrera,"['Korea', 'Palau']",Artist,1894,88,38,1982
Christina Martin,"['New Zealand', 'Poland']",Artist,1882,17,44,1899
Mary Williams,['Namibia'],Artist,1917,40,21,1957
Jacqueline Webb,"['New Caledonia', 'Mauritius']",Artist,1890,70,7,1960
Patrick Turner,"['Myanmar', 'Saint Pierre and Miquelon']",Torturer,1886,66,85,1952
Brandy Bridges,"['Yemen', 'Netherlands Antilles']",Artist,1911,68,49,1979
Maria Jackson,['Grenada'],Artist,1910,84,7,1994
Brittney Wood,['Estonia'],Serial killer; criminal,1887,73,0,1960
David Torres,['Iceland'],Artist,1902,6,40,1908
Dawn Burke,"['Jordan', 'Egypt']",Artist,1881,62,74,1943
Daniel Santiago,['Wallis and Futuna'],Artist,1883,4,78,1887
Anna Lee,['Malawi'],Artist,1881,44,56,1925
Steven Cabrera,"['Afghanistan', 'Hungary']",Artist,1899,82,43,1981
Katherine Mclaughlin,"['Cape Verde', 'Senegal']",Researcher,1878,21,47,1899
Alison Gonzalez,['French Guiana'],Artist,1876,28,22,1904
Mark Garcia,"['Netherlands', 'Vanuatu']",Religious figure,1902,48,77,1950
Scott Nguyen,"['Antarctica (the territory South of 60 deg S)', 'Japan']",Artist,1913,16,81,1929
Julie Mason,"['Taiwan', 'Angola']",Artist,1912,78,53,1990
Miss Ann Henry DVM,['Sudan'],Artist,1908,88,4,1996
Alexandra Wells,['Canada'],Artist,1885,53,2,1938
Rachel Hogan,"['Holy See (Vatican City State)', 'Zambia']",Artist,1871,74,46,1945
Cassie Dudley,['Yemen'],Artist,1872,48,12,1920
Rodney Sharp,['Myanmar'],Nun,1884,36,30,1920
Brian Lambert,['New Caledonia'],Politician,1923,13,47,1936
Troy Jackson,['Indonesia'],Criminal,1877,78,48,1955
Ashley Miller,"['French Guiana', 'Zambia']",Student; revolutionary,1894,17,15,1911
Ronald Casey,"['Montserrat', 'Turkmenistan']",Farmer; lecturer,1902,73,53,1975
Nathaniel Edwards,['South Africa'],Researcher,1908,46,23,1954
Lindsey Hawkins,"['Tunisia', 'Brazil']",Artist,1911,33,26,1944
Gavin Schmidt,"['Eritrea', 'Canada']",Artist,1898,44,17,1942
Michelle Clay,['Norfolk Island'],Physician,1884,43,24,1927
Laura Brown,['Wallis and Futuna'],Artist,1900,27,76,1927
Jeremy Cline,"['Saint Lucia', 'British Indian Ocean Territory (Chagos Archipelago)']",Politician,1909,15,9,1924
Tyler Leblanc,['Tanzania'],Teacher,1896,80,71,1976
Timothy Reed,['Ecuador'],Racing automobile driver,1870,86,45,1956
Samuel Hernandez,"['South Africa', 'Somalia']",Aristocrat,1899,78,11,1977
Rebecca Valdez DVM,['Micronesia'],Artist,1875,41,66,1916
John Moore,['Cook Islands'],Military personnel,1886,69,63,1955
Stephanie Johnson,['Mozambique'],Artist,1920,58,65,1978
Ryan Santana,"['Liberia', 'Lesotho']",Politician,1918,3,57,1921
Mr. Robert Curtis,"['Mauritania', 'Tajikistan']",Physician,1884,66,89,1950
James Brewer,"[""Lao People's Democratic Republic"", 'Estonia']",Politician,1892,37,13,1929
William Hess,"['Cayman Islands', 'Puerto Rico']",Artist,1891,82,33,1973
John Cruz,"['Holy See (Vatican City State)', 'Honduras']",Athlete,1877,29,31,1906
Jacob Aguilar,"['Canada', 'Bouvet Island (Bouvetoya)']",Athlete,1893,77,63,1970
Todd Scott,['Russian Federation'],Researcher,1872,6,73,1878
Kimberly Sanchez,"['Kenya', 'Seychelles']",Stand-up comedian,1922,29,59,1951
Ricardo Golden,['Nauru'],Artist,1887,77,48,1964
Michael Ramsey,"['Slovenia', 'Palau']",Cinematographer,1884,69,9,1953
Jessica Contreras,"['Japan', 'Korea']",Entrepreneur,1879,13,82,1892
Jessica Richardson,['Congo'],Artist,1899,60,47,1959
Jeremiah Johnson,"['Canada', 'Ecuador']",Politician,1872,64,7,1936
Stephanie Williamson,['Ecuador'],Businessperson,1918,67,63,1985
Brad White,"['Mayotte', 'Malta']",Artist,1895,69,10,1964
Christine Wilson,"['Russian Federation', 'Kenya']",Artist,1873,52,54,1925
Lauren Butler,['Argentina'],Artist,1913,34,61,1947
Gregory Holland,['Fiji'],Politician,1896,72,79,1968
Shane Christian,"['Togo', 'British Virgin Islands']",Military personnel,1904,64,46,1968
Jonathan Harrington,['Nicaragua'],Researcher,1897,24,64,1921
Karen Ramirez,"['Tonga', 'Sweden']",Athlete,1892,56,16,1948
John Ross,['British Virgin Islands'],Artist,1870,41,67,1911
Jessica Duke,['Ireland'],Politician,1908,12,60,1920
James Lee,"['Sudan', 'Seychelles']",Gynaecologist; pathologist,1923,29,26,1952
Tyler Edwards,"['Papua New Guinea', 'Fiji']",Athlete,1920,57,32,1977
Stacey Williams,"['Canada', 'Nauru']",Researcher,1907,3,16,1910
Christian Brown,['Cape Verde'],Artist,1879,55,77,1934
Roger Mosley,"['Turkey', 'Uruguay']",Religious figure,1895,76,44,1971
Alejandra Rogers,['Saint Vincent and the Grenadines'],Artist,1911,22,7,1933
Aaron Davis,['Holy See (Vatican City State)'],Artist,1873,49,79,1922
Nicole Mcdonald,['Australia'],Artist,1892,47,4,1939
Samantha Calhoun,"['Latvia', 'Nicaragua']",Artist,1883,24,75,1907
Lauren Simpson,['Faroe Islands'],Artist,1921,67,40,1988
Michael Johnson,"['Gibraltar', 'Ghana']",Artist,1890,23,53,1913
Zachary Murray,"['Equatorial Guinea', 'Bhutan']",Artist,1878,69,11,1947
Shannon Fowler,['Kenya'],Artist,1875,73,12,1948
Amy Harmon,['Chile'],Teacher,1891,66,9,1957
Danielle Burton,['South Georgia and the South Sandwich Islands'],Artist,1899,22,74,1921
Elijah Williams,"['Spain', 'Sri Lanka']",Artist,1923,30,77,1953
Denise Strickland,"['Bahamas', 'Peru']",Artist,1901,57,80,1958
Laura Henderson,['Philippines'],Military personnel,1904,70,4,1974
Megan Villarreal,['Uzbekistan'],Artist,1892,32,86,1924
Dave Rosario,"[""Lao People's Democratic Republic"", 'Burkina Faso']",Artist,1920,39,33,1959
Jennifer Smith,['Sierra Leone'],Artist,1877,74,47,1951
Damon May,"['Kenya', 'Antigua and Barbuda']",Military personnel,1924,37,22,1961
Devin Wright,"['Russian Federation', 'Montenegro']",Artist,1910,34,50,1944
Kimberly Stewart,['Northern Mariana Islands'],Artist,1901,70,26,1971
Rachel Smith,"['Armenia', 'Fiji']",Motorcycle racer; rally driver; helicopter pilot,1904,1,44,1905
Patrick Gonzalez,"['Grenada', 'Dominican Republic']",Researcher,1898,6,79,1904
Jonathan Lowery,"['Nepal', 'Thailand']",Researcher,1906,39,68,1945
Joseph Washington,['United States of America'],Military personnel,1893,45,10,1938
Anna Hawkins,"['Qatar', 'Russian Federation']",Researcher,1892,84,41,1976
Cassandra Whitaker,['Cameroon'],Artist,1914,41,83,1955
Tamara Rodriguez,['United States Virgin Islands'],Researcher,1893,61,61,1954
Sara Solis,"['Congo', 'Tunisia']",Military personnel,1907,22,8,1929
Michelle Ray,['Venezuela'],Researcher,1895,24,65,1919
Sarah Jones,['Pitcairn Islands'],Religious figure,1898,41,68,1939
Nathan Johnson,"['Italy', 'United Kingdom']",Military personnel,1876,56,88,1932
Crystal Miller,"['Montenegro', 'Sudan']",Racing automobile driver; formula one driver,1894,80,72,1974
Frances Cox,"['Australia', 'Finland']",Artist,1878,37,58,1915
Mary Dodson,['United Kingdom'],Politician,1904,67,73,1971
Marissa Dorsey,"['Belize', 'Norway']",Politician,1884,30,86,1914
Michelle Tyler,"['Ireland', 'Colombia']",Athlete,1883,6,76,1889
Laura Franklin,"['Mexico', 'Congo']",Politician,1905,67,81,1972
Alexander Hall,['Marshall Islands'],Artist,1890,68,45,1958
Angela Martin,"['Czech Republic', 'Ireland']",Researcher,1900,85,17,1985
Devin Miranda,"['Equatorial Guinea', 'Liechtenstein']",Artist,1915,53,34,1968
Eugene Johns,['Italy'],Politician,1921,68,16,1989
Ashley Lozano,['New Caledonia'],Athlete,1891,30,65,1921
Diana Reed,['British Virgin Islands'],Athlete,1912,21,26,1933
Veronica Dixon,['United States Minor Outlying Islands'],Artist,1872,53,59,1925
Sydney Sanders,['Faroe Islands'],Artist,1914,10,25,1924
Abigail Sullivan,['Sweden'],Freestyle skier,1912,72,54,1984
Jimmy Marshall,['Morocco'],Aristocrat,1879,0,62,1879
George Cobb,['Sri Lanka'],Artist,1891,48,66,1939
Katelyn Hall DVM,['Mozambique'],Artist,1891,80,81,1971
Martin Garcia,['Uzbekistan'],Artist,1894,8,26,1902
Alice Moore,['Belgium'],Athlete,1916,9,43,1925
Allison Davis,"['Isle of Man', 'Moldova']",Politician,1888,9,47,1897
Kelsey Padilla,"[""Lao People's Democratic Republic"", 'El Salvador']",Politician,1917,2,75,1919
Bradley Kline,"['Palau', 'Croatia']",Politician,1922,20,6,1942
Henry Tucker,"['Niger', 'Turkmenistan']",Businessperson,1906,50,4,1956
Samantha Watson,"['Panama', 'Burkina Faso']",Athlete,1895,80,7,1975
Alexandra Brooks,"['French Guiana', 'Comoros']",Navigator; skipper,1914,22,0,1936
Melissa Jackson,"['Honduras', 'Uzbekistan']",Athlete,1885,53,8,1938
Guy Thompson,['Western Sahara'],Politician,1879,36,64,1915
Amanda Grant,"['Saint Barthelemy', 'Thailand']",Artist,1899,26,6,1925
Jessica Jordan,['Afghanistan'],Artist,1880,18,63,1898
Ronald Stewart,"['Pitcairn Islands', 'Guam']",Teacher,1881,12,9,1893
Mr. Alexander Ballard,['New Zealand'],Artist,1883,86,50,1969
Alyssa Griffith,['Philippines'],Entrepreneur,1887,29,77,1916
Steven Gonzalez,['Australia'],Artist,1900,85,16,1985
Mark Yang,['Iran'],Artist,1903,7,15,1910
Chase Fields,['Bermuda'],Politician,1874,58,4,1932
Leonard Brown,"['Reunion', 'French Guiana']",Artist,1883,24,1,1907
Scott Hunt,"['Bosnia and Herzegovina', 'Guernsey']",Artist,1883,89,54,1972
Amy Parker,['Gabon'],Artist,1923,16,20,1939
Paul Rodriguez,['China'],Artist,1888,58,66,1946
Gregory Mathews,"['Libyan Arab Jamahiriya', 'Timor-Leste']",Artist,1907,24,35,1931
Veronica Bennett,['Azerbaijan'],Artist,1919,85,47,2004
Joel Ward,"['South Georgia and the South Sandwich Islands', 'Myanmar']",Teacher,1879,38,5,1917
Heather Warren,['Slovakia (Slovak Republic)'],Politician,1897,82,41,1979
Lauren Tapia,"['Cuba', 'Cambodia']",Artist,1923,48,7,1971
Daniel Stanley MD,"['Syrian Arab Republic', 'Ghana']",Athlete,1910,47,53,1957
Fred Reid,"['Eritrea', 'Moldova']",Athlete,1896,48,72,1944
Jessica Neal,"['Sierra Leone', 'Azerbaijan']",Researcher,1908,64,11,1972
Mario Lewis,['Belize'],Artist,1892,60,60,1952
Robert Smith,['Liechtenstein'],Researcher,1872,76,48,1948
Thomas Baker,['Australia'],Politician,1881,64,62,1945
Yesenia Hoffman,['Norfolk Island'],Researcher,1888,52,20,1940
Jason Barnes,['Thailand'],Criminal,1921,43,74,1964
Robert Mitchell,"['Wallis and Futuna', 'New Zealand']",Samurai; bushi,1886,83,7,1969
Crystal Ibarra,['Liberia'],Artist,1879,41,22,1920
Sharon Garcia,"['Malawi', 'Equatorial Guinea']",Artist,1917,5,17,1922
Tracey Flynn,"['Austria', 'South Georgia and the South Sandwich Islands']",Athlete,1891,29,82,1920
Juan Morton,"['Fiji', 'Honduras']",Artist,1875,61,50,1936
Kimberly Coleman,"['Turks and Caicos Islands', 'Tunisia']",Artist,1883,25,53,1908
Caitlin Price,"['Mali', 'Gambia']",Politician,1877,24,71,1901
Amber Stafford,['Mali'],Researcher,1872,3,0,1875
Brenda Jefferson,"['Burkina Faso', 'Egypt']",Artist,1909,47,10,1956
Brittany Lamb,['Rwanda'],Artist,1904,41,59,1945
Melissa Davidson,"['Korea', 'Togo']",Engineer,1891,79,60,1970
Brenda Flores,['Guam'],Artist,1903,27,43,1930
Joseph Morris,['Sao Tome and Principe'],Politician,1911,50,5,1961
Barbara Fernandez,['Kiribati'],Artist,1922,25,80,1947
Jessica Leach,['Lebanon'],Artist,1882,42,9,1924
Lisa Anderson,['Chad'],Politician,1879,44,26,1923
Allison Brown,['Venezuela'],Teacher,1886,30,51,1916
Jordan Park,['Gambia'],Artist,1888,63,85,1951
Annette George,['Lesotho'],Politician,1894,31,75,1925
Brent Graham,"['Qatar', 'Macao']",Artist,1878,44,57,1922
Brenda Rogers,['Guinea-Bissau'],Engineer,1900,49,65,1949
Marissa Jones,['Malaysia'],Military personnel,1896,79,49,1975
Elizabeth Walton,['Central African Republic'],Artist,1878,32,9,1910
Michael Jacobson,['Botswana'],Partisan,1921,38,79,1959
Eric Jones,['Saint Lucia'],Aristocrat,1921,27,87,1948
Mr. Scott Holmes,['Saint Pierre and Miquelon'],Artist,1879,81,29,1960
Mrs. Regina Good PhD,"['Burundi', 'Sierra Leone']",Artist,1908,27,29,1935
Keith Terry,['Guatemala'],Artist,1874,12,53,1886
Brianna Harmon,"['Norway', 'Jordan']",Artist,1917,75,57,1992
Yvonne Anderson,['Luxembourg'],Artist,1902,28,16,1930
Tiffany Meadows,"['Madagascar', 'Papua New Guinea']",Researcher,1903,26,8,1929
Erin Rodriguez,"['Albania', 'Bosnia and Herzegovina']",Researcher,1921,38,22,1959
Crystal Marshall,['Azerbaijan'],Artist,1895,3,39,1898
Jacob Adams,['Kyrgyz Republic'],Artist,1921,82,36,2003
Travis Jackson,"['India', 'Burundi']",Artist,1912,40,28,1952
Rhonda Stafford,"['Western Sahara', 'Japan']",Artist,1884,5,84,1889
James Martinez,"['United Arab Emirates', 'Belize']",Artist,1887,32,21,1919
Steven Sawyer,"['British Virgin Islands', 'Chad']",Athlete,1882,0,16,1882
Gary Moody,"['Wallis and Futuna', 'Antigua and Barbuda']",Artist,1913,27,53,1940
Brenda Hudson,['Pitcairn Islands'],Artist,1872,35,79,1907
Cynthia Johnson,"['Pakistan', 'Uzbekistan']",Monarch,1913,25,78,1938
Gerald Clark,['Saint Vincent and the Grenadines'],Politician,1916,36,17,1952
Kristen Barajas,"['Belarus', 'Algeria']",Politician,1924,20,31,1944
Patty Tucker,"['Azerbaijan', 'Singapore']",Artist,1921,37,78,1958
Teresa Walsh,['New Zealand'],Athlete,1878,35,73,1913
Matthew Garza,"['Belize', 'Sweden']",Explorer,1872,10,68,1882
Christopher Perez,['Serbia'],Sailor,1872,76,56,1948
Kevin Bradford,['Namibia'],Winegrower,1882,87,17,1969
Megan Rios,['Comoros'],Anthropologist,1924,27,78,1951
Lynn Garcia,['Puerto Rico'],Journalist,1906,18,62,1924
Shelly Murray,"['American Samoa', 'Spain']",Religious figure,1889,72,35,1961
Michael Combs,"['Mali', 'Cocos (Keeling) Islands']",Artist,1896,40,85,1936
Christopher Williams,['Denmark'],Artist,1911,56,69,1967
Thomas Carroll,"['Poland', 'Norway']",Artist,1882,67,20,1949
Beth Woods,['Gabon'],Religious figure,1870,18,45,1888
Jeffrey Perez,"['Tunisia', 'Philippines']",Artist,1871,53,75,1924
Matthew White,"['Papua New Guinea', 'Spain']",Athlete,1908,26,2,1934
Robin Velez,['Nigeria'],Artist,1890,88,50,1978
Sara Butler,['Cocos (Keeling) Islands'],Politician,1880,72,0,1952
Kimberly Jones,"['Peru', 'Germany']",Artist,1898,87,32,1985
Karen Farmer,"['British Indian Ocean Territory (Chagos Archipelago)', 'Turkey']",Artist,1910,49,63,1959
Scott Scott,['Sweden'],Artist,1923,34,8,1957
Jeffrey Boyle MD,"['Suriname', 'New Caledonia']",Engineer,1904,50,51,1954
James Beard,"['Dominican Republic', 'Taiwan']",Mountaineer; explorer,1887,47,11,1934
Austin Mcdonald,"['Botswana', 'Libyan Arab Jamahiriya']",Athlete,1914,74,29,1988
Whitney Barnes,"['Ghana', 'Belarus']",Artist,1891,61,27,1952
Angelica Preston,"['Tokelau', 'Norfolk Island']",Artist,1880,41,84,1921
Jonathan Walker,"['Bolivia', 'Venezuela']",Politician,1900,18,15,1918
Monica Owens,['Botswana'],Engineer,1873,36,39,1909
Autumn Williams,['Montenegro'],Politician,1916,40,59,1956
Denise Allen,['Fiji'],Researcher,1900,78,61,1978
Stacey Beck,"['Seychelles', 'Tonga']",Military personnel,1882,63,69,1945
Priscilla Gibson,"['Bermuda', 'Norway']",Researcher,1885,42,6,1927
April Campbell,"['Isle of Man', 'Turkmenistan']",Artist,1874,46,34,1920
Brian Cruz,"['Faroe Islands', 'Malta']",Artist,1887,51,85,1938
Ashley Garcia,['Guinea-Bissau'],Shogun,1870,26,46,1896
Jonathan Allen,['Maldives'],Politician,1873,22,18,1895
Debbie Kaufman,['Western Sahara'],Researcher,1888,21,3,1909
Wendy Walsh,['Grenada'],Artist,1877,40,60,1917
Pamela Walls,['Saint Martin'],Researcher,1899,38,78,1937
Kathy Butler,"['Guam', 'Tanzania']",Artist,1916,27,86,1943
Amanda Gomez,['Bolivia'],Politician,1914,5,20,1919
Michael Moore,['Germany'],Artist,1903,9,12,1912
Veronica Adams,['Japan'],Politician,1923,37,39,1960
Jennifer Skinner,['Zimbabwe'],Artist,1910,68,23,1978
Elizabeth Jordan,"['Moldova', 'Uzbekistan']",Military personnel,1872,8,14,1880
Jacob Burns,"['Mexico', 'Christmas Island']",Artist,1886,84,74,1970
Blake Bell,"['British Indian Ocean Territory (Chagos Archipelago)', 'Montenegro']",Artist,1909,12,43,1921
Christopher Morton,"['Jordan', 'India']",Parson,1873,11,83,1884
Angela Pierce,['Estonia'],Politician,1895,22,75,1917
Tammy Davis,"['Nauru', 'Korea']",Artist,1883,20,47,1903
Jeffrey Smith,"['Guernsey', 'Serbia']",Politician,1885,19,2,1904
Ryan Perry,['Barbados'],Artist,1881,49,45,1930
Theresa Wilson,"['Bouvet Island (Bouvetoya)', 'Algeria']",Politician,1874,79,75,1953
Jason Robinson,"['Armenia', 'Saint Barthelemy']",Politician,1923,28,51,1951
Derek Barnes,"['Somalia', 'Sao Tome and Principe']",Police officer,1891,11,48,1902
Jonathan Hernandez,"['Liberia', 'Lesotho']",Politician,1883,59,9,1942
Jessica Hall,"['Pakistan', 'Tanzania']",Alpine skier,1886,4,67,1890
Robert Tanner,"['Christmas Island', 'Somalia']",Aristocrat,1910,20,16,1930
Mary Roberts,"['Swaziland', 'Israel']",Politician,1881,59,19,1940
Natalie Wilkinson,['New Caledonia'],Politician,1886,89,9,1975
Jamie Harvey,['Palau'],Religious figure,1881,11,79,1892
Emily Payne,"['Mauritania', 'Tokelau']",Artist,1906,56,38,1962
Lauren Brown,"['Sao Tome and Principe', 'Nicaragua']",Politician,1918,69,37,1987
Steven Werner,['American Samoa'],Artist,1875,60,59,1935
Jeff White,"['Korea', 'Japan']",Artist,1917,35,20,1952
Wendy Robinson,['New Caledonia'],Researcher,1909,5,37,1914
Cynthia Taylor,"['Anguilla', 'Gabon']",Politician,1896,5,40,1901
Angela Sanchez,"['Bouvet Island (Bouvetoya)', 'Italy']",Artist,1881,13,62,1894
Stephen Young,"['Romania', 'Mauritius']",Artist,1907,42,61,1949
Diane Jensen,['Netherlands Antilles'],Artist,1921,40,29,1961
Eric Garcia,"['Chad', 'Montenegro']",Artist,1877,23,25,1900
Dr. Mary Meza DDS,"['Colombia', 'Thailand']",Artist,1915,17,58,1932
Eduardo Davidson,"['French Southern Territories', 'Lesotho']",Artist,1902,59,71,1961
Charles Moreno,"['Thailand', 'Argentina']",Artist,1918,70,30,1988
Sarah Ford,"['Saudi Arabia', 'Colombia']",Researcher,1911,86,82,1997
Lauren Schroeder,"['Iran', 'El Salvador']",Politician,1911,56,69,1967
Jennifer Schroeder,"['Lithuania', 'Sudan']",Artist,1899,53,33,1952
Elizabeth Stein,"['Lebanon', 'Liberia']",Researcher,1885,64,76,1949
Derrick Ramirez,"['Samoa', 'Kiribati']",Politician,1887,87,75,1974
Aaron Walker,['American Samoa'],Artist,1921,11,34,1932
Dylan Wood,"['Seychelles', 'Equatorial Guinea']",Military personnel,1882,72,7,1954
Darius Mathews,"['Ghana', 'Syrian Arab Republic']",Politician,1921,52,39,1973
Victoria Wright,['Kiribati'],Athlete,1915,26,57,1941
Lisa Nash,"['Switzerland', 'Algeria']",Artist,1879,22,69,1901
Alexander Bentley,"['Jamaica', 'Hong Kong']",Artist,1905,40,86,1945
Lisa Henderson,['Luxembourg'],Artist,1872,25,85,1897
Taylor Woodward,"['Gibraltar', 'Bolivia']",Teacher,1900,2,67,1902
Amber Sanchez,['Niue'],Artist,1897,6,88,1903
Michael Livingston,"['Egypt', 'Morocco']",Artist,1909,56,62,1965
Sean Robinson,['Madagascar'],Astronomer,1909,38,31,1947
Alexander Miller,['Kiribati'],Artist,1903,23,82,1926
Mary Gross,"['Antigua and Barbuda', 'Hungary']",Artist,1913,36,64,1949
Adam Brewer,"['Cayman Islands', 'Belgium']",Politician,1873,60,36,1933
Scott Gordon,['France'],Athlete,1895,78,64,1973
Chelsea Allen,"['North Macedonia', 'United States Virgin Islands']",Artist,1871,44,25,1915
Robert Bailey,['Gibraltar'],Artist,1887,59,61,1946
Shelby Carson,['Togo'],Politician,1901,30,44,1931
Ashley Bryant,['Albania'],Artist,1912,83,31,1995
Christopher Roman,['Denmark'],Military personnel,1870,84,44,1954
Gina Brown,"['Angola', 'Falkland Islands (Malvinas)']",Politician,1914,74,61,1988
Maria Williams,['Ecuador'],Artist,1882,64,66,1946
Jeremy Robinson,"['Costa Rica', 'Italy']",Journalist,1876,86,24,1962
Brian Flores,['Holy See (Vatican City State)'],Artist,1910,41,10,1951
Crystal Jackson,"['Grenada', 'Rwanda']",Artist,1910,5,19,1915
Patrick Snow,['Nicaragua'],Artist,1873,83,26,1956
Chad Rogers,['Liechtenstein'],Artist,1878,21,12,1899
Daniel Rush,"['Somalia', 'Tanzania']",Nurse,1904,37,11,1941
Anthony Anderson,"['Tokelau', 'Benin']",Artist,1880,86,32,1966
Luke Wyatt,['Bahamas'],Artist,1912,6,23,1918
Rebecca Maxwell,"['Mauritania', 'Algeria']",Athlete,1897,52,7,1949
Joshua Rogers,['Heard Island and McDonald Islands'],Artist,1870,71,89,1941
Amanda Barrett,"['Reunion', 'Palau']",Record producer; music executive,1874,70,40,1944
Suzanne Tanner,"['Hungary', 'El Salvador']",Religious figure,1882,21,5,1903
Monica Evans,"['France', 'Cook Islands']",Artist,1915,58,71,1973
Donna Sanders,['Cuba'],Teacher,1878,81,51,1959
William Sanders,['Kyrgyz Republic'],Artist,1907,36,79,1943
Melissa Cross,['Greece'],Artist,1910,36,4,1946
Emily Johnson,"['Turkmenistan', 'Latvia']",Artist,1922,25,11,1947
Katherine Davis,['Iceland'],Artist,1916,84,75,2000
Jamie Castillo,"['Norfolk Island', 'Peru']",Astronomer,1894,60,62,1954
Mary Logan,['New Caledonia'],Artist,1909,41,44,1950
Sonya Mccormick,"['Tajikistan', 'Cayman Islands']",Artist,1915,23,27,1938
David Bowers,"['Kuwait', 'Somalia']",Artist,1897,59,3,1956
Alan Brooks,['Nicaragua'],Artist,1911,84,79,1995
Melanie Ortiz,"['Saint Kitts and Nevis', 'Panama']",Artist,1883,0,58,1883
Charlotte Smith,['Romania'],Politician,1878,78,5,1956
Jerome Gonzalez,"['Somalia', 'Ireland']",Artist,1924,26,64,1950
Mrs. Mary Stone,['British Virgin Islands'],Artist,1891,68,83,1959
Jared Smith,['India'],Artist,1878,88,23,1966
Rebecca Price,"['Northern Mariana Islands', 'China']",Politician,1890,70,45,1960
Jessica Anderson,"['Saint Vincent and the Grenadines', 'Timor-Leste']",Athlete,1909,42,54,1951
Barbara Le,['Honduras'],Entrepreneur,1873,59,41,1932
Philip Stewart,"['Guyana', 'Montserrat']",Artist,1902,48,20,1950
Rachel Guerra,['Reunion'],Politician,1895,3,81,1898
Bianca Savage,['Puerto Rico'],Artist,1919,81,18,2000
Catherine Elliott,['Madagascar'],Artist,1898,41,48,1939
Amber Prince,"['Liberia', 'Guinea-Bissau']",Artist,1920,20,82,1940
Jeffrey Allen,['Egypt'],Artist,1910,56,78,1966
Janet Wang,['Lesotho'],Artist,1877,48,82,1925
Benjamin Williams,"['Trinidad and Tobago', 'Belize']",Artist,1918,87,48,2005
James Williams,['Grenada'],Politician,1916,19,65,1935
Marissa Lopez,['Botswana'],Politician,1894,54,13,1948
Sara Wolfe,['Papua New Guinea'],Artist,1898,87,52,1985
Mark English,['Trinidad and Tobago'],Artist,1914,0,5,1914
Steven Ortiz,"['Bouvet Island (Bouvetoya)', 'New Caledonia']",Researcher,1911,76,41,1987
Rickey Hoover,"['Hungary', 'Libyan Arab Jamahiriya']",Orator; professional wrestler; bodybuilder,1907,86,47,1993
Nathan Bolton,['Grenada'],Artist,1921,48,80,1969
Joan Jenkins,['Libyan Arab Jamahiriya'],Entrepreneur,1921,65,56,1986
Jamie Murphy,['Azerbaijan'],Politician,1916,88,3,2004
Michele Olson,['Chad'],Racing automobile driver,1890,77,83,1967
Mary Huff,['Saint Martin'],Athlete,1892,22,65,1914
Travis Mitchell,"['Afghanistan', 'Maldives']",Artist,1896,57,83,1953
Michael Rowe,['Chad'],Artist,1877,33,5,1910
Richard Owen,['Mauritania'],Artist,1902,76,67,1978
Nina Green MD,['Kuwait'],Businessperson,1916,12,88,1928
Gary Cisneros,['Haiti'],Artist,1914,59,59,1973
Morgan Vega,"['Madagascar', 'Burundi']",Artist,1907,3,61,1910
Christopher Clark,['French Southern Territories'],Politician,1874,76,83,1950
Matthew Spears,['Guam'],Politician,1897,33,12,1930
Jessica Taylor,"['Norfolk Island', 'United States of America']",Artist,1876,78,77,1954
Jessica Burke,"['Ghana', 'Montserrat']",Artist,1889,48,64,1937
Brenda Berry,"['Norfolk Island', 'Brazil']",Researcher,1897,84,78,1981
Brandon Benitez,['Sweden'],Politician,1911,60,9,1971
Carrie Walker,"[""Cote d'Ivoire"", 'Egypt']",Politician,1891,87,45,1978
Rachel Smith,['Denmark'],Artist,1920,67,3,1987
Patrick Hernandez,"['Vietnam', 'Solomon Islands']",Artist,1875,67,24,1942
Jessica Simmons,"['Panama', 'Mongolia']",Artist,1914,46,21,1960
Regina Warren,"['Puerto Rico', 'Syrian Arab Republic']",Artist,1874,89,62,1963
Linda James,['El Salvador'],Artist,1892,51,43,1943
Jordan Morgan,['Niger'],Artist,1878,87,44,1965
Matthew Fowler,"['China', 'Denmark']",Astronomer,1905,86,32,1991
Robert Rivera,['Germany'],Artist,1882,3,11,1885
Carrie Coleman,['Hungary'],Politician,1882,30,51,1912
Scott Luna,"['Zambia', 'Palestinian Territory']",Inventor,1923,53,36,1976
Sara Smith DVM,"['Timor-Leste', 'Turks and Caicos Islands']",Artist,1886,54,8,1940
Hayden Richardson,"['Saint Kitts and Nevis', 'Eritrea']",Researcher,1888,10,19,1898
Jacob Hutchinson,"['Congo', 'Japan']",Politician,1886,75,80,1961
Amy Myers,['Somalia'],Researcher,1892,88,74,1980
Barbara Anderson,['Gambia'],Artist,1873,17,62,1890
Laura Joseph,['Turkmenistan'],Politician,1873,69,62,1942
Tiffany Barnett,"['French Polynesia', 'Norway']",Artist,1884,20,0,1904
Ryan Flores,"['Dominica', 'Turks and Caicos Islands']",Artist,1917,9,0,1926
Brittany Mitchell,['Reunion'],Researcher,1893,89,78,1982
Elizabeth Schroeder,['Israel'],Artist,1884,88,31,1972
Marvin Watkins,"['Holy See (Vatican City State)', ""Cote d'Ivoire""]",Artist,1885,34,25,1919
Heather Webb,"['Denmark', 'South Georgia and the South Sandwich Islands']",Artist,1904,31,30,1935
Barbara Deleon,['Korea'],Artist,1891,7,82,1898
Stephanie Newman,['Chile'],Artist,1879,39,69,1918
Justin Cooper,['Benin'],Politician,1870,0,54,1870
John Lewis,['Anguilla'],Ruler,1880,76,46,1956
Christian Hubbard,"['Fiji', 'Seychelles']",Politician,1899,64,36,1963
Jacqueline Webster,['France'],Artist,1886,16,7,1902
Diana Li,['American Samoa'],Artist,1921,79,16,2000
Roger Levine,"['Indonesia', 'Botswana']",Athlete,1874,11,33,1885
Julie Harris,"['Grenada', 'Bouvet Island (Bouvetoya)']",Artist,1900,83,30,1983
Annette Wang,['Reunion'],Cobbler; artisan,1872,42,58,1914
Kevin Sanchez,['San Marino'],Politician,1922,52,6,1974
Brittany Cardenas,"['Russian Federation', 'Reunion']",Artist,1918,82,1,2000
James Washington,"['Anguilla', 'Saint Helena']",Artist,1882,13,48,1895
Alexis Shelton,"['Guinea', 'Georgia']",Artist,1883,30,62,1913
Laura Hoffman,"['Russian Federation', 'Nepal']",Researcher,1878,31,0,1909
Juan Stephens,"['Mayotte', 'Cuba']",Military personnel,1917,55,41,1972
Geoffrey Norman,"['Vietnam', 'Solomon Islands']",Politician,1911,55,10,1966
Tammy Richards,"['Hungary', 'Oman']",Athlete,1874,17,32,1891
Phillip Blankenship,"['Netherlands Antilles', 'Bhutan']",Military personnel,1902,67,59,1969
Danny Sanchez,['Bulgaria'],Artist,1896,63,31,1959
Nathan Silva,"['Gambia', 'Niger']",Artist,1887,45,2,1932
Felicia Lee,['Mauritania'],Military personnel,1897,31,57,1928
Andrew Richardson,"['Martinique', 'Luxembourg']",Artist,1879,22,18,1901
Thomas Gallagher,['Djibouti'],Artist,1924,34,8,1958
Michelle Lopez,['Aruba'],Artist,1904,62,59,1966
Rebecca Powell,"['Kenya', 'American Samoa']",Military personnel,1912,71,20,1983
Stacy Richard,['China'],Trade unionist,1900,57,40,1957
Brandy Norris,['Samoa'],Artist,1871,56,38,1927
Carolyn Terrell,['Bermuda'],Artist,1900,87,41,1987
David Nguyen,['Croatia'],Artist,1904,56,22,1960
Nichole Floyd,['Angola'],Artist,1886,45,4,1931
Daniel Christensen,"['Italy', 'Turks and Caicos Islands']",Artist,1881,18,25,1899
Teresa Barr,"['Argentina', 'Bolivia']",Artist,1881,37,65,1918
Stephen Stark,['Mali'],Athlete,1890,54,65,1944
Mary Nicholson,['Bosnia and Herzegovina'],Politician,1894,61,11,1955
Dean Stevenson,['United States Minor Outlying Islands'],Rally driver,1919,1,52,1920
Matthew Cooper,['Suriname'],Politician,1909,25,27,1934
Melissa Olson,['Niger'],Artist,1901,38,19,1939
Jennifer Krueger,['Faroe Islands'],Politician,1882,34,69,1916
Tracy Winters,"['Togo', 'Kyrgyz Republic']",Artist,1881,59,81,1940
Jacqueline Morris,['United States of America'],Artist,1904,61,39,1965
Vanessa Walker,"['Venezuela', 'Togo']",Artist,1906,79,34,1985
Robert Hartman,['Kazakhstan'],Researcher,1919,60,49,1979
Kimberly Curry DDS,"['Moldova', 'Montenegro']",Artist,1922,88,38,2010
Nicholas Lambert,"['Uruguay', 'Luxembourg']",Politician,1899,16,39,1915
Daniel Olsen,['Anguilla'],Businessperson,1924,6,2,1930
Shelby White,['Liechtenstein'],Motorcycle racer,1895,26,20,1921
Jorge Baker,"['Venezuela', 'Guam']",Athlete,1901,56,7,1957
Sara Nelson,"['French Guiana', 'Finland']",Artist,1902,31,3,1933
Linda Moore,['Saint Pierre and Miquelon'],Politician,1919,59,77,1978
Barry Williams,"['Denmark', 'Suriname']",Politician,1899,52,36,1951
Steven Price,"['Greece', 'Oman']",Artist,1900,83,38,1983
David Floyd,['Denmark'],Artist,1910,61,3,1971
Brendan Snyder,['Austria'],Professional wrestler,1873,64,10,1937
Cassandra Campbell,['Libyan Arab Jamahiriya'],Artist,1894,74,22,1968
Renee Sosa,['Anguilla'],Conductor,1881,67,26,1948
Matthew Brooks,['Netherlands Antilles'],Artist,1905,29,50,1934
Derrick Garcia,"['Sao Tome and Principe', 'Austria']",Artist,1899,15,41,1914
Kimberly Baker,"['Jersey', 'Turkey']",Military personnel,1870,8,51,1878
Jasmine Perez,['Nicaragua'],Artist,1922,25,0,1947
Jessica Elliott,"['Luxembourg', 'Bouvet Island (Bouvetoya)']",Artist,1874,1,12,1875
Martin Wright,"['Kazakhstan', 'Pitcairn Islands']",Conductor,1921,66,35,1987
Michelle Smith,['Honduras'],Artist,1890,82,68,1972
Rachel Morales,"['Svalbard & Jan Mayen Islands', 'Sri Lanka']",Artist,1904,36,38,1940
Nancy Finley,"['Suriname', 'Rwanda']",Politician,1910,23,41,1933
Mrs. Kristy Chavez,['Holy See (Vatican City State)'],Researcher,1899,16,7,1915
Sandra Carrillo,"[""Lao People's Democratic Republic"", 'Tanzania']",Politician,1913,3,59,1916
Sharon Werner,['Lebanon'],Military personnel,1886,30,11,1916
Sarah Tran,['Tanzania'],Artist,1874,39,41,1913
Molly Adams,"['Belize', 'Gambia']",Politician,1921,82,86,2003
Samantha Benson,['India'],Artist,1884,35,36,1919
Jennifer Hall,"['Mexico', 'Northern Mariana Islands']",Researcher,1882,27,79,1909
Margaret Knight,['Malawi'],Businessperson,1894,36,6,1930
Kelly Mckinney,['Fiji'],Artist,1921,1,84,1922
Robert Jones,"['Cyprus', 'Jersey']",Politician,1878,71,4,1949
Jacob Robertson,['Angola'],Artist,1923,48,48,1971
Heather Parker,['Comoros'],Athlete,1922,71,79,1993
Greg Robinson,"['Nepal', 'Turks and Caicos Islands']",Politician,1871,2,59,1873
William Mckay,['Slovenia'],Artist,1906,28,31,1934
William Moore,['French Guiana'],Politician,1899,64,23,1963
Henry Gordon,['Nauru'],Researcher,1884,56,29,1940
John Cook,"['Syrian Arab Republic', 'Tonga']",Artist,1884,15,87,1899
Jonathan Watson,['Portugal'],Politician,1876,82,79,1958
Miguel Ortega,['Sudan'],Artist,1886,79,89,1965
Douglas Barnett,['Korea'],Politician,1885,48,68,1933
Joe Stanley,"['San Marino', 'Sierra Leone']",Military personnel,1919,66,62,1985
William Stewart,['Netherlands'],Politician,1915,52,76,1967
Adrienne Baker,"['Korea', 'Yemen']",Athlete,1872,82,29,1954
James Richardson,['Poland'],Politician,1873,8,48,1881
Michelle Galloway,"['Christmas Island', 'Aruba']",Artist,1907,57,38,1964
Raymond Moore,['Togo'],Researcher,1876,40,10,1916
Julie Williams,"['Guyana', 'Ethiopia']",Politician,1870,24,80,1894
Angela Hester,"['Niue', 'Mozambique']",Politician,1898,65,2,1963
Oscar Riley,"['Vietnam', 'France']",Politician,1871,20,18,1891
Harold James,['Cambodia'],Architect,1924,52,73,1976
Carrie Reilly,"['Lesotho', 'Peru']",Researcher,1884,73,0,1957
Jason Fox,"['Gibraltar', 'Brazil']",Journalist,1889,18,65,1907
Brooke Allen,"['Japan', 'Saint Kitts and Nevis']",Artist,1893,3,79,1896
James Stone,['Maldives'],Serial killer; spree killer; criminal; prostitute,1878,80,59,1958
Jeremy Williams,"['South Georgia and the South Sandwich Islands', 'Romania']",Artist,1903,47,64,1950
Christopher Gonzales,"['Saint Lucia', 'Mauritania']",Hotel manager,1870,67,10,1937
Jeremiah Myers,"['Andorra', 'Dominican Republic']",Pretender,1876,40,53,1916
Edward Moyer,['Tokelau'],Artist,1882,21,9,1903
Jason Baldwin,['Iceland'],Sailor,1903,52,57,1955
Victoria Spencer,"['Lesotho', 'Cambodia']",Artist,1899,9,87,1908
Jackie Sims,['Tanzania'],Researcher,1885,87,61,1972
Nancy Gomez,['Estonia'],Artist,1909,33,19,1942
Daniel Anthony,"['Uganda', 'Philippines']",Artist,1871,7,24,1878
Mrs. Hannah Dillon,['France'],Military personnel,1875,78,7,1953
Andrew Kelly,['Libyan Arab Jamahiriya'],Artist,1903,70,14,1973
Alice Johnson,['Seychelles'],Electrician; concentration camp guard,1920,31,4,1951
Rebecca Williams,"['Bermuda', 'Andorra']",Artist,1882,71,76,1953
Elizabeth Brown,"['Northern Mariana Islands', 'Mali']",Artist,1888,52,15,1940
Douglas Jones,['Luxembourg'],Politician,1888,63,38,1951
Emily Rodriguez,"['Togo', 'Andorra']",Artist,1898,38,43,1936
Jamie Brandt,"['Palau', 'Tuvalu']",Artist,1884,32,65,1916
Joseph Hernandez,"['Guinea-Bissau', 'Belize']",Artist,1871,41,24,1912
Bernard Benson,['Guinea'],Artist,1895,63,17,1958
Anna Russell,"['India', 'Senegal']",Researcher,1887,52,80,1939
Mark Mccarty,['United States Virgin Islands'],Astronomer,1889,6,28,1895
Brian Smith,"['Guinea', 'United States Minor Outlying Islands']",Military personnel,1875,52,87,1927
Lauren Campbell,['United Kingdom'],Politician,1897,65,9,1962
Rebekah Richardson,['Dominican Republic'],Politician,1877,53,54,1930
Amber Brown,['Reunion'],Politician,1903,73,57,1976
Amber Evans,['British Indian Ocean Territory (Chagos Archipelago)'],Politician,1871,27,70,1898
Erica Weaver,['Brunei Darussalam'],Artist,1911,25,78,1936
Reginald Palmer,['Saudi Arabia'],Politician,1912,74,77,1986
Robert Dunlap,['Mozambique'],Politician,1912,52,24,1964
Thomas Mcbride,"['French Southern Territories', 'Antigua and Barbuda']",Politician,1887,26,64,1913
Charles Newton,['Montserrat'],Artist,1908,58,23,1966
Cheryl Robinson,"['Equatorial Guinea', 'Finland']",Artist,1911,59,89,1970
Scott Lambert,['Ukraine'],Murderer; peace activist,1880,46,14,1926
Christian Young,"['Korea', 'United Arab Emirates']",Artist,1870,22,62,1892
Jonathan Jenkins,['Lithuania'],Artist,1899,25,17,1924
Ruth Murphy,['Puerto Rico'],Artist,1917,29,40,1946
Mariah Mendoza,"['Israel', 'Niger']",Racing automobile driver; formula one driver,1885,27,74,1912
Jonathan Williams,['Guinea'],Teacher,1904,17,36,1921
William Lowery,['Djibouti'],Artist,1909,53,8,1962
Christian Park,['Guatemala'],Researcher,1879,59,9,1938
Carlos Mcguire,['Uganda'],Athlete,1882,87,53,1969
John Clark,['Solomon Islands'],Politician,1913,87,27,2000
Shane Thompson,"['Solomon Islands', 'Falkland Islands (Malvinas)']",Politician,1916,73,38,1989
James Schaefer,"[""Lao People's Democratic Republic"", 'Lebanon']",Politician,1903,28,43,1931
Jasmine Washington,['Nicaragua'],Entrepreneur,1919,72,5,1991
Brittany Elliott,['Ecuador'],Artist,1880,36,52,1916
Luke Goodman,"['Micronesia', 'Turks and Caicos Islands']",Military personnel,1891,31,55,1922
Mark Harvey,['Somalia'],Artist,1884,19,38,1903
Brittany Mendez,['Kiribati'],Businessperson,1884,40,23,1924
Debra Collins,['Tunisia'],Artist,1881,79,11,1960
Allison Moore,['Grenada'],Artist,1886,49,63,1935
Crystal Lopez,"['Monaco', 'Spain']",Politician,1883,24,1,1907
Robin Henderson,"['Chad', 'Argentina']",Politician,1923,73,11,1996
Mary Hall,['British Virgin Islands'],Artist,1905,29,62,1934
Mariah Becker,['Mauritania'],Politician,1901,27,87,1928
Lindsay Bailey,['Finland'],Politician,1889,18,78,1907
Jasmine Robertson,"['Cyprus', 'Djibouti']",Artist,1908,34,69,1942
Rachel Castro,"['Romania', 'Nauru']",Artist,1915,61,0,1976
Jason Thompson,"['Cuba', 'Northern Mariana Islands']",Artist,1913,81,46,1994
Alex Young,['El Salvador'],Revolutionary,1877,67,9,1944
Ian Cuevas,['Saint Lucia'],Politician,1878,61,63,1939
Jacob Mcmahon,"['Iceland', 'Nicaragua']",Athlete,1874,18,42,1892
Shaun Garner,['New Zealand'],Artist,1886,41,35,1927
Teresa Smith,['Cocos (Keeling) Islands'],Military personnel,1901,45,39,1946
Tom Sutton,"['Brunei Darussalam', ""Cote d'Ivoire""]",Artist,1907,11,39,1918
Brandon Bridges,['Portugal'],Artist,1890,24,18,1914
Heather Roberts,['Anguilla'],Politician,1902,73,54,1975
Amanda Ramsey,['Zimbabwe'],Artist,1923,38,42,1961
John Hahn,"['Vanuatu', 'Martinique']",Artist,1909,30,45,1939
Taylor Anderson,['Tonga'],Violinist,1899,89,86,1988
Emily Ortiz,"['Falkland Islands (Malvinas)', 'Libyan Arab Jamahiriya']",Artist,1900,47,27,1947
Jacob Day,"['Chile', 'Kyrgyz Republic']",Artist,1893,73,48,1966
Nicholas Jefferson,"['Greece', 'Slovenia']",Artist,1889,9,16,1898
Cindy Alexander,['Sri Lanka'],Politician,1890,82,5,1972
Christopher Medina,"['Dominican Republic', 'Georgia']",Politician,1875,30,33,1905
Caitlin Soto,['Jordan'],Criminal,1914,85,27,1999
Jessica Ibarra,"['Honduras', 'Western Sahara']",Nurse,1914,73,8,1987
Aaron Macdonald,"['Guadeloupe', 'Panama']",Athlete,1898,63,56,1961
Stephen Mora,"['Slovenia', 'Liberia']",Artist,1883,83,37,1966
Jon Hall,"['Chad', 'North Macedonia']",Judge,1877,35,36,1912
Barbara Nguyen,"[""Cote d'Ivoire"", 'Botswana']",Athlete,1910,65,43,1975
Lori Johnson,['Ireland'],Athlete,1909,77,73,1986
Charles Webb,"['Belarus', 'Tuvalu']",Serial killer; murderer; criminal,1880,27,36,1907
Preston Sullivan,"['Sierra Leone', 'Poland']",Politician,1916,89,6,2005
Brittany Tanner,"['Falkland Islands (Malvinas)', 'Nauru']",Researcher,1899,48,68,1947
Michelle Mcintosh,['Portugal'],Athlete,1882,34,63,1916
Jeffrey Daniels,"['New Caledonia', 'Armenia']",Artist,1904,13,4,1917
Michelle Landry,"['Timor-Leste', 'Svalbard & Jan Mayen Islands']",Politician,1912,57,66,1969
Lori Davis,"['Kuwait', 'Aruba']",Artist,1879,79,59,1958
Kimberly Martinez,['Lesotho'],Artist,1882,83,87,1965
Amber Burnett,"['Greenland', 'Poland']",Artist,1901,50,21,1951
Annette Morris,"['Saint Helena', 'Anguilla']",Artist,1873,20,5,1893
Jacqueline Willis,"['French Southern Territories', 'Ecuador']",Artist,1870,32,77,1902
David Smith,['Somalia'],Athlete,1900,52,54,1952
Jason Mckenzie,"['Gibraltar', 'Kyrgyz Republic']",Artist,1895,28,41,1923
Felicia Williams,['Taiwan'],Politician,1903,53,66,1956
Peter Adams Jr.,"['Falkland Islands (Malvinas)', 'Palestinian Territory']",Military personnel,1871,84,17,1955
Bryan Heath,"['Rwanda', 'South Georgia and the South Sandwich Islands']",Artist,1876,27,76,1903
Richard Hendrix,['Cape Verde'],Researcher,1880,19,61,1899
Lisa Perry,['Saint Lucia'],Artist,1907,1,14,1908
Mr. Darrell Herrera,['Falkland Islands (Malvinas)'],Journalist,1905,80,7,1985
Jennifer Compton,['Mongolia'],Artist,1910,86,18,1996
Vincent Wolfe,"['Hong Kong', 'Bermuda']",Politician,1893,50,1,1943
Rachel Floyd,['Moldova'],Artist,1887,28,58,1915
Emily Livingston,"['Norfolk Island', 'Venezuela']",Artist,1881,63,58,1944
Brian Maxwell,"['Zimbabwe', ""Cote d'Ivoire""]",Artist,1907,41,78,1948
Mary Lewis,"['Uzbekistan', 'Lesotho']",Politician,1896,19,26,1915
Mary Travis,"['Greece', 'Russian Federation']",Artist,1886,83,9,1969
Angela Nguyen,"['Sierra Leone', 'Cambodia']",Serial killer,1887,75,23,1962
April Dalton,['Svalbard & Jan Mayen Islands'],Artist,1910,72,41,1982
Jonathan Gonzalez,"['Morocco', 'Seychelles']",Motorcycle racer,1880,21,18,1901
Kaitlin Terrell,"['Turkey', 'Saint Vincent and the Grenadines']",Artist,1888,49,15,1937
Francis Wong,"['Sierra Leone', 'Ireland']",Physician,1896,56,64,1952
Anna Crawford,"['Grenada', 'Hong Kong']",Artist,1875,7,60,1882
Alexis Newman,['Jamaica'],Artist,1913,50,42,1963
James Mendez,"['Romania', 'Lesotho']",Artist,1906,31,52,1937
Megan Dawson,"['Swaziland', 'Switzerland']",Penciller,1880,23,28,1903
Rhonda Phelps,['Kyrgyz Republic'],Artist,1914,65,31,1979
Marcus Heath,['Peru'],Artist,1922,50,82,1972
Adriana Robinson,"['Ethiopia', 'Belize']",Serial killer; drug trafficker,1915,46,86,1961
Curtis Lowe,['Timor-Leste'],Artist,1882,81,25,1963
Amy Oneill,"['Malta', 'Guinea-Bissau']",Artist,1888,25,58,1913
Tiffany Chang,"['Tanzania', 'Malaysia']",Astronomer,1894,1,17,1895
Kathryn Bowen,['Taiwan'],Researcher,1873,30,35,1903
Barbara Garcia,"['Argentina', 'Mozambique']",Artist,1878,28,28,1906
William Hines,['Austria'],Social work; clinical nurse specialist; social worker; social activist; activist,1918,77,12,1995
Maria Clark,"['United Kingdom', 'Slovakia (Slovak Republic)']",Sovereign,1919,24,28,1943
Michelle Hernandez,"['Bahrain', 'Albania']",Artist,1885,18,21,1903
Phillip Callahan,['South Africa'],Artist,1922,16,84,1938
Lisa Cook,['Angola'],Politician,1910,75,87,1985
William Marsh,"['Maldives', 'Afghanistan']",Cellist,1880,42,45,1922
Hannah Pratt,"['South Africa', 'Montserrat']",Businessperson,1883,59,84,1942
Pamela Robertson,"['Western Sahara', 'Bermuda']",Artist,1884,15,66,1899
Sara Medina,['Niue'],Artist,1916,26,16,1942
Sara Bush,['South Africa'],Artist,1917,64,6,1981
Brandi Carr,['New Caledonia'],Aristocrat,1915,83,38,1998
Patrick Roberts,['South Georgia and the South Sandwich Islands'],Military personnel,1917,27,24,1944
Crystal Smith,['Angola'],Politician,1885,13,66,1898
Aaron Freeman,"['Cape Verde', 'Senegal']",Politician,1900,87,67,1987
Sandra Williams,"['Burundi', 'Armenia']",Artist,1914,60,63,1974
Monica Walters,"['Turks and Caicos Islands', 'Faroe Islands']",Artist,1885,63,7,1948
Kenneth Gray,"['Palestinian Territory', 'Bhutan']",Artist,1899,65,60,1964
Jorge Gonzalez,"['Kyrgyz Republic', 'Haiti']",Artist,1895,20,74,1915
Janice Douglas,"['Switzerland', 'Hungary']",Researcher,1904,22,87,1926
Andrea Carter,"['Congo', 'United States Minor Outlying Islands']",Monarch,1901,67,14,1968
Francisco Mathis,"['Barbados', 'United States Minor Outlying Islands']",Researcher,1921,45,70,1966
Misty Lopez,['Poland'],Athlete,1902,58,45,1960
William Braun,"['Bolivia', 'Vietnam']",Judoka,1875,25,79,1900
Jonathan Gonzalez,['Malaysia'],Researcher,1880,87,54,1967
Jermaine Hull,"['Sierra Leone', 'South Georgia and the South Sandwich Islands']",Socialite,1913,5,41,1918
Gail Bauer,"['Wallis and Futuna', 'Slovakia (Slovak Republic)']",Artist,1921,49,7,1970
Pamela Miller,"['Uruguay', 'Sao Tome and Principe']",Artist,1890,74,65,1964
Joshua Johnson,"['Serbia', 'Croatia']",Artist,1882,47,18,1929
Cody Simmons,['Guatemala'],Researcher,1884,85,71,1969
Cynthia Cooper,"['Guyana', 'Congo']",Politician,1871,34,82,1905
Brittany Phillips,['Guadeloupe'],Artist,1883,79,82,1962
Peter Martin,"['Estonia', 'Thailand']",Athlete,1886,76,68,1962
Joseph Roman,"['Haiti', 'Paraguay']",Resistance fighter; submariner; intelligence officer; naval officer,1881,84,40,1965
Joseph Fuller,['Singapore'],Artist,1887,25,31,1912
Darlene Santana,"['Spain', 'Bahrain']",Translator,1886,81,7,1967
Joseph Riley,['Andorra'],Artist,1900,14,35,1914
Briana Williams,"['Costa Rica', 'Gabon']",Artist,1871,57,29,1928
Mark Stanley,['Gambia'],Politician,1924,65,17,1989
James Abbott,"['Germany', 'South Georgia and the South Sandwich Islands']",Artist,1899,32,27,1931
Jason Reeves,"['Barbados', 'Saint Vincent and the Grenadines']",Artist,1893,14,38,1907
Mrs. Michelle Cooper,['Burundi'],Artist,1904,45,42,1949
Carol Kelly,['Uganda'],Politician,1921,58,88,1979
Leah Humphrey,"['Niue', 'China']",Artist,1921,11,59,1932
Sharon Nguyen,['Latvia'],Researcher,1912,6,78,1918
Claudia Burgess,['Niger'],Politician,1902,70,66,1972
Heather Kim,"['Bolivia', 'Suriname']",Politician,1885,83,79,1968
Joseph Sanchez,['Serbia'],Racing automobile driver,1919,65,56,1984
Jennifer Parker,"['Trinidad and Tobago', 'Saint Barthelemy']",Artist,1904,31,16,1935
Dorothy Jones,['Indonesia'],Religious figure,1914,47,42,1961
Gary Estrada,"['Tonga', 'Suriname']",Artist,1890,10,7,1900
Christopher Washington,['Saudi Arabia'],Artist,1900,59,63,1959
Robert Carrillo,['Finland'],Artist,1906,88,26,1994
William Dennis,['Latvia'],Pianist,1919,7,76,1926
Lynn Novak,"['Libyan Arab Jamahiriya', 'France']",Artist,1911,63,46,1974
Eric Russell,"['Botswana', 'Norway']",Athlete,1919,83,4,2002
Kyle Payne,['Eritrea'],Athlete,1921,88,18,2009
Kevin Hayes,['Montserrat'],Artist,1909,63,88,1972
Lisa Hill,"['Australia', 'Bahamas']",Artist,1878,18,76,1896
Antonio Peck,['Vanuatu'],Politician,1903,48,26,1951
Sara Graves,['Albania'],Artist,1896,65,81,1961
Kimberly Gates,['Antigua and Barbuda'],Researcher,1913,28,38,1941
Linda Mitchell,['Falkland Islands (Malvinas)'],Middle-distance runner,1919,65,89,1984
Jamie Morgan,"['Nigeria', 'Netherlands Antilles']",Politician,1902,87,11,1989
Kevin Thomas,['Austria'],Artist,1884,61,80,1945
Justin Bennett,['Belgium'],Artist,1909,34,28,1943
Sabrina Clark,"['El Salvador', 'Cuba']",Taxi driver,1896,28,87,1924
Jorge Hensley,"['Netherlands', 'Uganda']",Artist,1918,25,14,1943
Louis Taylor,"['Jamaica', 'Brunei Darussalam']",Artist,1877,12,19,1889
Kathleen Fox,"['Jordan', 'Finland']",Artist,1917,22,8,1939
Elizabeth Clark,['Gambia'],Politician,1879,2,17,1881
Lucas Sanchez,"['Djibouti', 'Cocos (Keeling) Islands']",Politician,1871,87,15,1958
David Gomez,['Korea'],Artist,1910,38,12,1948
Brooke Garcia,"['Timor-Leste', 'Swaziland']",Artist,1871,34,85,1905
Matthew Hughes,"['Congo', 'Uruguay']",Artist,1878,7,11,1885
Suzanne Young,"['Peru', 'Vanuatu']",Journalist,1893,70,14,1963
Tiffany Smith,"['Cape Verde', 'Mozambique']",Artist,1893,64,4,1957
James Reed,['Kazakhstan'],Politician,1914,57,83,1971
David Patterson,['Bahrain'],Artist,1894,35,23,1929
Sarah Shelton,['Angola'],Politician,1881,71,4,1952
Kimberly Hernandez,"['Germany', 'Slovakia (Slovak Republic)']",Artist,1885,74,38,1959
Cindy Bell,"['Ireland', 'South Georgia and the South Sandwich Islands']",Military personnel,1891,64,14,1955
Diane Anderson,"['Norway', 'Argentina']",Aristocrat,1875,83,45,1958
David Cross,['Iceland'],Artist,1897,2,82,1899
Kayla Parker,"['Equatorial Guinea', 'Samoa']",Artist,1907,4,13,1911
Christina Chan,['Bangladesh'],Artist,1899,80,45,1979
Brittany Johnson,"['Jersey', 'Gibraltar']",Artist,1914,29,71,1943
Donna Mann,"['Poland', 'Netherlands Antilles']",Artist,1893,61,62,1954
Luis Krause,['United States Virgin Islands'],Researcher,1873,60,34,1933
Marcus Wiggins,['Brunei Darussalam'],Aristocrat,1880,8,3,1888
Sarah Campbell,['Saudi Arabia'],Politician,1903,46,68,1949
Crystal Woodward,"['Malta', 'Germany']",Kayaker,1920,8,10,1928
Kevin Lewis,"['Togo', 'Congo']",Artist,1891,19,16,1910
Jessica Hernandez,"['Guyana', 'Syrian Arab Republic']",Artist,1911,28,37,1939
Jenna Hall,['Iraq'],Artist,1917,63,66,1980
Theresa Hendricks,"['Tuvalu', 'Mongolia']",Researcher,1918,3,45,1921
Heather Estrada,['Macao'],Artist,1894,68,33,1962
Stephen Jackson,"['Eritrea', 'San Marino']",Entrepreneur,1883,58,9,1941
Jeff Weiss,['Belarus'],Athlete,1916,53,86,1969
Carrie Warren,"['Hungary', 'Solomon Islands']",Human rights activist,1886,12,39,1898
Brittany Callahan,"['Paraguay', 'Vanuatu']",Artist,1871,49,9,1920
Erica Pena,"['Saint Helena', 'Montserrat']",Artist,1903,10,79,1913
Krystal Smith,['Sierra Leone'],Artist,1883,12,2,1895
Ryan Brown,"['Burundi', 'Georgia']",Researcher,1876,27,29,1903
Jacob Chavez,['Sao Tome and Principe'],Drawer; gallerist,1895,43,61,1938
Derek Ball,['Niue'],Researcher,1893,72,8,1965
Kelly Marshall,['Northern Mariana Islands'],Artist,1917,65,36,1982
Daniel Morales,"['New Zealand', 'Slovakia (Slovak Republic)']",Researcher,1917,64,66,1981
Kara Zamora,['Montenegro'],Artist,1875,17,56,1892
Timothy Ross,"['Guam', 'Myanmar']",Researcher,1914,25,30,1939
Lauren Williamson,['Sierra Leone'],Teacher,1889,26,46,1915
Kim Vaughan,"['Central African Republic', 'Kiribati']",Artist,1905,64,16,1969
Jessica Brown,"['Turks and Caicos Islands', 'Andorra']",Athlete,1895,85,36,1980
Jeffrey Butler,"['Tanzania', 'India']",Military personnel,1919,18,65,1937
Angela Morales,['Saint Barthelemy'],Artist,1898,65,43,1963
Lisa Hughes,['Saint Helena'],Politician,1886,35,29,1921
Jaime Phillips,"['Moldova', 'Afghanistan']",Military personnel,1890,68,81,1958
Andrew Gay,['Solomon Islands'],Researcher,1901,22,37,1923
Nicholas Marquez,['Korea'],Artist,1870,61,7,1931
Rhonda Baker,['French Guiana'],Artist,1921,32,53,1953
Kristin Webb,"['Indonesia', 'Saint Martin']",Athlete,1892,22,87,1914
Craig Myers,"['South Africa', 'Djibouti']",Artist,1897,1,55,1898
Rebekah Robinson,"['France', 'Brazil']",Artist,1906,69,54,1975
Stephanie Decker,"['Cook Islands', 'Guatemala']",Politician,1923,27,60,1950
Kathryn Acevedo,"['Madagascar', 'Jersey']",Artist,1884,6,40,1890
William Waller,"['Namibia', 'Solomon Islands']",Criminal; street vendor,1882,28,34,1910
Michael Sexton DVM,['Turkey'],Politician,1894,63,61,1957
Andrea Richards,"['Maldives', 'Bosnia and Herzegovina']",Artist,1924,26,41,1950
William Wright,"['Palestinian Territory', 'Guatemala']",Artist,1874,50,37,1924
Gloria Taylor,['Colombia'],Artist,1885,82,76,1967
Gabriel May,"['Saint Kitts and Nevis', 'Moldova']",Politician,1875,11,33,1886
Aaron Watts,['Burkina Faso'],Artist,1881,22,56,1903
Brandon Adams,"['Gabon', 'Morocco']",Military personnel,1900,5,16,1905
Jade Cole,"['Myanmar', 'Egypt']",Artist,1870,75,78,1945
Michael Garcia,"['Denmark', 'French Southern Territories']",Artist,1876,36,36,1912
Darlene Pearson,"['Suriname', 'Luxembourg']",Artist,1873,9,49,1882
Jamie Torres,['Czech Republic'],Researcher,1904,36,15,1940
Jacob Porter,"['Peru', 'Faroe Islands']",Alpine skier,1872,11,85,1883
Kari Andrews,['Malaysia'],Entrepreneur,1902,29,81,1931
Christina Smith,['Malawi'],Esperantist; lexicographer,1915,10,55,1925
Amy Hernandez,['Congo'],Artist,1900,15,77,1915
Andrea Spencer,['Austria'],Politician,1871,82,52,1953
Frank Mcclure,['Nauru'],Artist,1910,86,80,1996
Megan Reynolds,"['Romania', 'Benin']",Serial killer; criminal,1874,15,29,1889
Nancy Bowen,['Malaysia'],Artist,1896,44,72,1940
Kelly Jones,"['Brunei Darussalam', 'Guadeloupe']",Researcher,1916,35,62,1951
Bobby Alvarez,"['Myanmar', 'Uruguay']",Military personnel,1912,79,84,1991
Rachel Chan,"['Slovenia', 'Uganda']",Artist,1913,41,56,1954
James Oliver,"['Congo', 'Norfolk Island']",Artist,1875,6,54,1881
Alice Cooper,['Germany'],Artist,1909,66,13,1975
Alice Barnes,"['Somalia', 'Trinidad and Tobago']",Journalist,1907,48,45,1955
Erica Medina,"['Holy See (Vatican City State)', 'French Guiana']",Politician,1910,67,5,1977
Joshua Thompson,['Faroe Islands'],Artist,1879,30,48,1909
Gary Lowe,"['Sudan', 'Morocco']",Artist,1888,7,16,1895
Shelly Velez,"['Mali', 'Ghana']",Politician,1877,79,13,1956
Daniel Wang,"['Liechtenstein', 'Lebanon']",Artist,1897,75,22,1972
Richard Alvarez,"['French Polynesia', 'Tanzania']",Racing automobile driver,1913,32,82,1945
Henry Gonzales,['South Georgia and the South Sandwich Islands'],Politician,1917,69,37,1986
Jeffrey Hays,['Chad'],Religious figure,1875,50,25,1925
Robin Munoz,"['Haiti', 'Canada']",Athlete,1874,45,82,1919
Megan Hensley,['Cape Verde'],Artist,1889,25,18,1914
Teresa Mitchell,"['Gabon', 'Cayman Islands']",Politician,1899,45,8,1944
Amber Smith,"['Niger', 'Croatia']",Athlete,1873,89,62,1962
Alexis Adams,['Moldova'],Cinematographer,1915,74,41,1989
Kelly Howell,['Djibouti'],Artist,1873,66,20,1939
Gary Carr,['Germany'],Entrepreneur,1902,37,84,1939
Bryan Williams,['Congo'],Playwright; art critic; film critic; literary critic; novelist,1880,56,51,1936
Whitney Murphy,"['Myanmar', 'Lebanon']",Artist,1915,51,21,1966
Jeffrey May,['Kiribati'],Revolutionary,1900,45,4,1945
Jacob Russo,"['Saint Helena', 'Denmark']",Artist,1883,89,9,1972
Steven Mills,['Guinea-Bissau'],Politician,1917,55,55,1972
Joseph Taylor,['Nicaragua'],Artist,1922,14,54,1936
Justin Acosta,['Chile'],Politician,1907,2,45,1909
Misty Smith,['Bangladesh'],Artist,1885,54,56,1939
Mark Mccormick,"['Chad', 'Burundi']",Artist,1884,22,36,1906
Lydia Martin,['Ghana'],Politician,1901,83,42,1984
Michael Walls,"['Kenya', 'Brunei Darussalam']",Politician,1888,69,55,1957
Lisa Kennedy,['Jordan'],Artist,1889,7,89,1896
Gary Johnson,"['Denmark', 'Croatia']",Military personnel,1890,50,22,1940
Michael Williams,['Qatar'],Politician,1883,17,80,1900
Emily Sanders,"['Kazakhstan', 'Ukraine']",Politician,1873,33,82,1906
Richard Warner,"['Nigeria', 'Guatemala']",Artist,1914,30,49,1944
Jeremy Hall,"['Myanmar', 'Guernsey']",Artist,1872,54,43,1926
Gordon Kelley,['Albania'],Artist,1913,69,38,1982
Brandon Rogers,"['Ethiopia', 'Cocos (Keeling) Islands']",Politician,1881,29,8,1910
Elizabeth Mason,"['Saudi Arabia', 'Isle of Man']",Researcher,1923,18,21,1941
Elizabeth Davenport,['French Polynesia'],Athlete,1916,51,47,1967
Patrick Lopez,"['Switzerland', 'Sao Tome and Principe']",Artist,1879,19,32,1898
Kyle Robbins,['Italy'],Monarch,1912,29,81,1941
Dr. Robert Guzman,['Ireland'],Explorer,1896,20,69,1916
Kara Reynolds,"['Kuwait', 'Tajikistan']",Politician,1902,76,73,1978
Bryan Sanders,"['Cuba', 'Czech Republic']",Artist,1916,88,82,2004
Roger Spears,"['Malawi', 'Norfolk Island']",Artist,1899,83,85,1982
Richard Franklin,"['Congo', 'Guernsey']",Artist,1916,69,59,1985
Daniel Stewart,"['Congo', 'United Arab Emirates']",Politician,1874,70,41,1944
Jeremy Owens,"['Chile', 'Bangladesh']",Artist,1918,13,8,1931
Keith Shelton,"['Cook Islands', 'Venezuela']",Artist,1906,61,75,1967
Sherri Brown,['Turkmenistan'],Artist,1894,53,86,1947
Ian Barker,['Zambia'],Artist,1890,45,53,1935
Joel Acosta,['Congo'],Artist,1902,32,18,1934
Melissa Yoder,"['Sweden', 'Holy See (Vatican City State)']",Businessperson,1872,89,38,1961
Leah Parrish,"['Peru', 'Saint Kitts and Nevis']",Artist,1877,52,61,1929
April Clarke,"['Mongolia', 'Namibia']",Racing automobile driver,1870,3,52,1873
Megan Baker,['Latvia'],Artist,1921,22,74,1943
Julie Mcmahon,['Mayotte'],Athlete,1915,62,22,1977
Frances Berger,"['Marshall Islands', 'Serbia']",Researcher,1878,73,59,1951
Leah Crawford,"['Pakistan', 'Burkina Faso']",Athlete,1880,89,82,1969
Diane Dominguez,"['Albania', 'Senegal']",Politician,1883,43,26,1926
Nicholas Cole,"['Luxembourg', 'Austria']",Artist,1916,6,23,1922
David Gray,"['Comoros', 'Ireland']",Researcher,1881,49,4,1930
Donald Barton PhD,"['Czech Republic', 'Chile']",Researcher,1901,15,40,1916
Charles Wilson,['Luxembourg'],Artist,1922,2,31,1924
David Thompson,['Korea'],Racing automobile driver,1892,55,51,1947
Kathy Austin,"['United Arab Emirates', 'Sri Lanka']",Artist,1908,62,79,1970
Melissa Davis,"['Egypt', 'Swaziland']",Artist,1892,10,80,1902
Ashley Hall,"['Italy', 'Korea']",Artist,1901,16,40,1917
Brian Mitchell,"['Tuvalu', 'Jordan']",Artist,1884,57,80,1941
Jamie Watson,['Panama'],Military personnel,1896,44,67,1940
Samantha Woods,"[""Cote d'Ivoire""]",Researcher,1875,40,3,1915
Kelly Hunter,['Liberia'],Artist,1905,37,51,1942
Jennifer James,['Canada'],Artist,1895,12,7,1907
Brenda Heath,['Taiwan'],Politician,1921,77,5,1998
Alisha Williams,"['Niger', 'British Virgin Islands']",Politician,1892,63,88,1955
Gary Reid,['Slovenia'],Politician,1921,37,19,1958
Michael Dunn,"['Georgia', 'China']",Formula one driver,1919,11,0,1930
Francis Woodward,"['Slovakia (Slovak Republic)', 'Honduras']",Astronomer,1890,15,53,1905
John Scott,['Guadeloupe'],Artist,1920,18,64,1938
John Moyer,"['Netherlands', 'Indonesia']",Artist,1890,12,87,1902
Christopher Nelson,['Guam'],Politician,1924,81,25,2005
Denise Cannon,"['Namibia', 'Saudi Arabia']",Artist,1905,7,82,1912
Christopher Bridges,"['Zimbabwe', 'Guernsey']",Military personnel,1912,1,50,1913
David King,['Cambodia'],Athlete,1888,46,51,1934
Marvin Arnold,"['Saint Kitts and Nevis', 'Georgia']",Artist,1881,34,41,1915
Charles Cruz,['Bosnia and Herzegovina'],Artist,1914,6,35,1920
Lindsey Jimenez,"['Antarctica (the territory South of 60 deg S)', 'Lebanon']",Artist,1914,56,85,1970
David Brown,"['Gambia', 'Christmas Island']",Military personnel,1901,77,86,1978
Nicholas Barker,"['Kiribati', 'Georgia']",Sovereign,1923,55,39,1978
David Mason,"['Saudi Arabia', 'Liberia']",Researcher,1907,69,6,1976
Nathaniel Johnson,['Wallis and Futuna'],Artist,1873,27,46,1900
Kirsten Taylor,"['Namibia', 'China']",Artist,1883,77,14,1960
Randy Oneill,['Turkmenistan'],Artist,1872,72,31,1944
Jeffrey Larson,"['Singapore', 'Guatemala']",Artist,1887,16,1,1903
Vickie Jackson,['Germany'],Artist,1915,76,45,1991
Keith Thornton,"['American Samoa', 'Ethiopia']",Duke,1883,7,30,1890
Sarah Calderon,['Congo'],Artist,1871,3,65,1874
Cory Moore,"['Venezuela', 'San Marino']",Politician,1909,89,12,1998
Alicia Brady,"['Madagascar', 'Kenya']",Record producer; personal assistant; talent manager; business executive; road manager,1903,77,31,1980
Anthony Copeland,"['Haiti', 'Belgium']",Artist,1909,55,22,1964
Andrea Adams,"['Norway', 'Swaziland']",Artist,1895,87,25,1982
Kendra Johnson,['Lesotho'],Artist,1917,26,70,1943
Diane Mendez,"['Nigeria', 'Saudi Arabia']",Athlete,1899,13,75,1912
Charles Brandt,"['Japan', 'Pitcairn Islands']",Ballet dancer; choreographer,1889,87,33,1976
Holly Williamson,['Greece'],Politician,1892,13,26,1905
Matthew Chavez,"['Barbados', 'Burkina Faso']",Politician,1915,68,37,1983
Alicia Young,"['Sao Tome and Principe', 'Iran']",Artist,1878,4,21,1882
Emily Farrell,['Anguilla'],Artist,1885,37,36,1922
Bobby Cummings,['Iran'],Artist,1914,62,53,1976
Rebecca Simpson,"['Libyan Arab Jamahiriya', 'Indonesia']",Religious figure,1907,29,40,1936
Angel Rodriguez,"['Armenia', 'North Macedonia']",Artist,1884,83,13,1967
John Poole,['Monaco'],Politician,1873,18,14,1891
Steven Moreno,"['Singapore', 'Russian Federation']",Accordionist,1914,4,38,1918
Matthew Martinez,['Guatemala'],Artist,1908,19,16,1927
Mrs. Samantha Rice,['Christmas Island'],Artist,1910,86,27,1996
Jason Bautista,"['Denmark', 'Mauritius']",Politician,1900,18,58,1918
Marcus Wise,"['Armenia', 'Anguilla']",Religious figure,1906,1,88,1907
Andrew Cannon,['Kyrgyz Republic'],Artist,1894,11,41,1905
Angela Davis,['Tajikistan'],Athlete,1918,79,62,1997
Linda White,"['Kiribati', 'Guadeloupe']",Athlete,1913,84,31,1997
Andrew Hall,['Nepal'],Artist,1907,34,7,1941
Maria Taylor,"['Cyprus', 'Honduras']",Artist,1916,40,51,1956
Sheena Miller,"['Belarus', 'Gabon']",Psychologist; psychotherapist,1894,36,88,1930
Holly Martinez,"['Mali', 'Dominican Republic']",Artist,1874,88,51,1962
Jodi Kelly,['Kazakhstan'],Politician,1921,72,37,1993
Nicholas Garcia,['Uganda'],Artist,1913,34,14,1947
Brianna Colon,"['Congo', 'Bhutan']",Artist,1886,36,83,1922
Ashley Ward,['Mauritius'],Artist,1917,39,74,1956
Vanessa Reynolds,"['Guyana', 'Slovenia']",Artist,1923,48,67,1971
John Reid,['Brunei Darussalam'],Artist,1915,56,59,1971
Kevin Lopez,"['Serbia', 'Nauru']",Artist,1900,40,61,1940
Raymond Turner,"['Guadeloupe', 'Jersey']",Military personnel,1908,66,23,1974
Kenneth Vaughn,"['Bolivia', 'Costa Rica']",Artist,1900,40,83,1940
Sherry Phillips,['Chile'],Artist,1919,2,7,1921
Jennifer Morris,['Bahrain'],Military personnel,1905,53,23,1958
Cynthia Johnson,"['Belgium', 'Taiwan']",Military personnel,1873,65,63,1938
Brandon Terry,"['Latvia', 'Tanzania']",Military personnel,1923,63,5,1986
Gary Shepherd,"['North Macedonia', 'Kiribati']",Artist,1924,77,14,2001
Jessica Wise,"['Guyana', 'Netherlands']",Racing automobile driver,1920,27,45,1947
Carrie Guerra,"['Slovenia', 'Chile']",Artist,1895,63,35,1958
Nathaniel Wilkinson,"['New Caledonia', 'Vanuatu']",Religious figure,1874,85,63,1959
Maurice Walker,['Malaysia'],Artist,1897,40,4,1937
Tiffany Thomas,"['Bahamas', 'Moldova']",Artist,1878,81,85,1959
Heather Rogers,"['Dominican Republic', 'Mozambique']",Artist,1896,84,26,1980
Connor Ramirez,"['Honduras', 'Jamaica']",Artist,1916,36,10,1952
Karen King,['Belize'],Politician,1890,38,16,1928
Stephanie Richards,"['Dominica', 'Colombia']",Artist,1903,43,82,1946
Mikayla Wallace,['Uganda'],Artist,1916,45,87,1961
Michael Kelly,"['Western Sahara', 'Lebanon']",Artist,1909,21,19,1930
Manuel Smith,['Spain'],Military personnel,1895,13,66,1908
Amy Gonzalez,"['Kenya', 'Jamaica']",Artist,1919,46,21,1965
Christopher James,"['Uganda', 'Lebanon']",Architect,1908,29,33,1937
Danielle Ball,"['Trinidad and Tobago', 'Angola']",Teacher,1880,53,61,1933
Kerry Hall,"['Chile', 'Mauritania']",Artist,1911,54,86,1965
Elizabeth Wood,['Sierra Leone'],Artist,1917,59,32,1976
Barbara Robinson,['Cocos (Keeling) Islands'],Religious figure,1906,10,18,1916
Omar Murphy,"['Palestinian Territory', 'Norfolk Island']",Artist,1886,13,22,1899
Jamie Johnson,['Tajikistan'],Researcher,1883,70,34,1953
Karen Taylor,['United States Virgin Islands'],Disc jockey,1870,29,16,1899
Olivia Smith,['Pitcairn Islands'],Researcher,1888,0,11,1888
John Walsh,['Andorra'],Artist,1876,68,39,1944
Denise Morgan,['Moldova'],Entrepreneur,1888,8,69,1896
Amanda Pena,"['Maldives', 'Namibia']",Politician,1881,85,54,1966
Richard Horn,"['Heard Island and McDonald Islands', 'Iceland']",Artist,1887,63,87,1950
Sean Rosales,"['Romania', 'French Southern Territories']",Athlete,1880,1,4,1881
William Warren,['Guyana'],Politician,1907,35,12,1942
Susan Burgess,['Croatia'],Politician,1889,14,48,1903
Sherry Tucker,"['Egypt', 'Singapore']",Artist,1897,56,77,1953
Dawn Gilbert,['Congo'],Teacher,1885,88,59,1973
Barbara Baker,['Qatar'],Artist,1912,20,85,1932
Aaron Chambers,"['Bhutan', 'Iceland']",Athlete,1893,75,76,1968
James Robinson,"['Algeria', 'French Guiana']",Artist,1919,35,12,1954
Richard Stone,"['Georgia', 'Jersey']",Artist,1881,45,15,1926
Cindy Joseph,['Saint Vincent and the Grenadines'],Presbyter,1874,12,18,1886
Robert Miller,['Senegal'],Teacher,1870,24,74,1894
Eric Jenkins,"['Namibia', 'Oman']",Athlete,1892,34,50,1926
Cynthia Ward,['Iceland'],Artist,1917,27,59,1944
William Khan,"['Saint Pierre and Miquelon', 'Timor-Leste']",Professional wrestler; amateur wrestler,1897,31,22,1928
James Haynes IV,['Angola'],Politician,1874,20,61,1894
Mr. Jacob Ferrell,['Romania'],Artist,1896,4,60,1900
Daniel Floyd,['Congo'],Businessperson,1894,48,2,1942
Patricia Gonzalez,"['Palau', 'Swaziland']",Artist,1897,24,83,1921
Michael Wall,['Montserrat'],Artist,1876,87,57,1963
Allen Everett,"['Reunion', 'Mozambique']",Artist,1914,0,35,1914
Frank Ayala,"['Liberia', 'North Macedonia']",Politician,1910,60,24,1970
Rebecca Harrison DDS,"['Oman', 'Liberia']",Choreographer; dancer,1913,4,1,1917
Vicki Arnold,"['Brazil', 'Germany']",Athlete,1881,45,78,1926
Ryan Allen,"['Australia', 'British Virgin Islands']",Artist,1911,10,18,1921
Laura Robbins,"['Australia', 'Canada']",Politician,1901,59,34,1960
Donald Hawkins,"['Martinique', 'Trinidad and Tobago']",Artist,1886,45,83,1931
Brandon Wagner,['Hungary'],Artist,1889,32,49,1921
Tiffany Carroll,['Yemen'],Artist,1895,61,57,1956
Nathan Joseph,['Tokelau'],Politician,1893,25,63,1918
Nicholas Richard,['Tunisia'],Artist,1899,60,7,1959
Michael Lopez,"['Italy', 'Turks and Caicos Islands']",Researcher,1918,80,14,1998
Louis Adams,"['Micronesia', 'Pitcairn Islands']",Artist,1905,87,0,1992
David Aguilar,['Saint Pierre and Miquelon'],Rock climber,1911,44,72,1955
Patrick Ferguson,"['Togo', 'Vietnam']",Artist,1876,87,78,1963
Dennis Mccoy,"['Ethiopia', 'Japan']",Artist,1870,18,42,1888
Robert Perez,"['Spain', 'Kuwait']",Military personnel,1917,52,10,1969
Brittney Simon,"['Nepal', 'Aruba']",Religious figure,1914,45,27,1959
Christopher Campbell,"['Maldives', 'Suriname']",Submariner,1897,21,13,1918
Cindy Chen,"['Aruba', 'Ireland']",Artist,1907,77,39,1984
Courtney Robertson,['Ghana'],Artist,1889,35,2,1924
Charles Garcia,"['Turkey', 'Azerbaijan']",Politician,1875,78,47,1953
Daniel Macias,"['Swaziland', 'India']",Artist,1924,10,40,1934
Donna Medina,"['Madagascar', 'Saudi Arabia']",Artist,1871,54,88,1925
Peggy Gutierrez,['Burkina Faso'],Artist,1899,18,78,1917
Lori Walker,['Jamaica'],Military personnel,1913,78,4,1991
Richard Wilson,"['Costa Rica', 'Singapore']",Researcher,1870,43,44,1913
Daniel Brown,"['North Macedonia', 'Mauritius']",Researcher,1890,35,77,1925
David Coleman,['French Southern Territories'],Artist,1889,12,6,1901
Barbara Page,['Morocco'],Explorer,1872,27,65,1899
Sarah Dean,"['Cambodia', 'Australia']",Athlete,1903,0,69,1903
Brittany Fields,['Solomon Islands'],Artist,1916,48,71,1964
Marc Jones,"['Fiji', 'Peru']",Artist,1904,32,1,1936
George Howard,['Saint Vincent and the Grenadines'],Artist,1885,14,19,1899
Dustin Harding,['Antigua and Barbuda'],Announcer,1900,35,67,1935
Randy Ford,['Sudan'],Artist,1924,53,78,1977
Traci Hurst,['Algeria'],Artist,1895,42,45,1937
Jason Klein,['Malawi'],Artist,1881,42,4,1923
Christopher Valenzuela,['New Zealand'],Artist,1879,80,81,1959
Jason Green,"['American Samoa', 'Afghanistan']",Researcher,1890,7,71,1897
Anthony Barker,"['Tonga', 'Colombia']",Artist,1888,0,48,1888
Mr. Adam Garcia Jr.,['Aruba'],Artist,1910,82,50,1992
Timothy Carpenter,"['Jamaica', 'Sweden']",Artist,1876,56,68,1932
Eric Johnson,['Micronesia'],Artist,1897,39,43,1936
Mr. Thomas Day,"['Egypt', 'Cayman Islands']",Artist,1920,26,85,1946
Candice Weaver,['Guatemala'],Artist,1885,18,61,1903
Kimberly Brown,"['Paraguay', 'Guernsey']",Artist,1881,32,67,1913
Sydney Torres,"['Montserrat', 'Somalia']",Artist,1874,45,0,1919
Morgan Wilson,['Paraguay'],Researcher,1897,9,80,1906
Brandon Baldwin,"['Equatorial Guinea', 'Jordan']",Politician,1879,51,55,1930
Scott West,['Philippines'],Artist,1874,30,59,1904
Patrick Copeland,['Cocos (Keeling) Islands'],Politician,1897,3,15,1900
Sherry Dawson,['Samoa'],Researcher,1919,31,52,1950
Heidi Elliott,['Cameroon'],Artist,1893,76,76,1969
Greg Hughes,"['Saint Pierre and Miquelon', 'Mayotte']",Businessperson,1914,72,16,1986
Joseph Hartman,['Swaziland'],Athlete,1911,60,87,1971
Jessica Stokes,['Czech Republic'],Monarch,1905,51,52,1956
Laurie James,['Ethiopia'],Artist,1891,74,46,1965
Andrea Poole,['Kyrgyz Republic'],Politician,1885,17,76,1902
Veronica Lawson,"['Hungary', 'Comoros']",Artist,1891,69,86,1960
Gabriela Oconnor,"['Burundi', 'Tokelau']",Artist,1905,85,3,1990
Paul Livingston,"['Mali', 'Aruba']",Researcher,1873,8,84,1881
Diana Schmidt,['United Kingdom'],Politician,1879,77,66,1956
William Rodgers,"['Benin', 'Estonia']",Artist,1906,64,48,1970
David Jones,"['Fiji', 'Cuba']",Artist,1896,39,33,1935
Jermaine Torres,['Papua New Guinea'],Amateur wrestler,1896,33,50,1929
Mckenzie Greer,"['Solomon Islands', 'Haiti']",Artist,1921,25,23,1946
Danielle Keith,"['Ethiopia', 'Uruguay']",Politician,1906,13,21,1919
Matthew Gonzales Jr.,['Zambia'],Politician,1898,12,12,1910
Katherine Aguilar,"['Saint Helena', 'Cape Verde']",Politician,1891,75,79,1966
David Walker,['Uruguay'],Politician,1918,66,67,1984
Mason King,['Sudan'],Artist,1921,70,55,1991
Jacob Melendez,"['Rwanda', 'Niue']",Athlete,1907,82,22,1989
Gerald Macias,['Bouvet Island (Bouvetoya)'],Artist,1890,73,86,1963
Karen Adams,['Comoros'],Artist,1914,68,16,1982
Kayla Cook,"['Seychelles', 'Guadeloupe']",Athlete,1885,85,54,1970
Sara Brown,"['Jordan', 'Libyan Arab Jamahiriya']",Businessperson,1903,4,15,1907
Stacie Hughes,['Australia'],Artist,1915,37,11,1952
Daniel Powell,"['Finland', ""Lao People's Democratic Republic""]",Artist,1895,27,20,1922
Debra Warner,['Ukraine'],Artist,1878,87,48,1965
Roger Beasley,"['Lebanon', 'Mali']",Politician,1913,67,29,1980
Jamie Brown,['Greece'],Teacher,1898,80,43,1978
Joshua Morris,['British Virgin Islands'],Artist,1894,54,19,1948
Thomas Nunez,"['Taiwan', 'Malawi']",Politician,1874,32,13,1906
Michelle Huber,['Djibouti'],Politician,1913,54,47,1967
Frank Smith,"['Cyprus', 'Central African Republic']",Artist,1870,67,86,1937
Tiffany Harrington,['Panama'],Athlete,1890,29,4,1919
Abigail Jackson,['Wallis and Futuna'],Athlete,1887,47,78,1934
Isaac Butler,"['Israel', 'Equatorial Guinea']",Artist,1911,44,4,1955
Steven Griffin Jr.,"['Pakistan', 'Bulgaria']",Artist,1872,77,81,1949
Christina Petersen MD,['Greece'],Researcher,1903,19,65,1922
Daniel Johnson,['Gibraltar'],Politician,1901,80,18,1981
Karen Melton,"['Solomon Islands', 'Antarctica (the territory South of 60 deg S)']",Politician,1920,34,26,1954
Andrea Lynn,"['Burundi', 'Turkey']",Artist,1901,0,57,1901
Austin Norman,"['Senegal', 'Timor-Leste']",Artist,1892,23,87,1915
Travis Chambers,['Ethiopia'],Religious figure,1904,73,61,1977
Jordan Cain,"['Slovakia (Slovak Republic)', 'Saint Kitts and Nevis']",Artist,1902,72,39,1974
William Cox,"['Venezuela', 'Niger']",Athlete,1893,69,7,1962
Carrie Reed,"['Indonesia', 'Armenia']",Artist,1879,13,47,1892
Mrs. Tracy Garcia,"['Mali', 'Armenia']",Politician,1900,16,53,1916
Ricky Reyes,"['Falkland Islands (Malvinas)', 'Latvia']",Businessperson,1893,72,31,1965
Miss Nicole Schmidt MD,['Sierra Leone'],Religious figure,1922,73,10,1995
Mr. Norman White,"['Haiti', 'Mongolia']",Athlete,1886,27,82,1913
Cheryl Rogers,"['Hungary', 'Yemen']",Artist,1904,24,84,1928
Teresa Suarez,"['Switzerland', 'Albania']",Politician,1918,20,67,1938
Nathan Stone,['Niue'],Politician,1905,20,68,1925
Terry Davis MD,['British Virgin Islands'],Politician,1897,8,83,1905
Alex Hancock,['Ethiopia'],Artist,1902,11,39,1913
Theodore Nguyen,['Bosnia and Herzegovina'],Artist,1888,53,71,1941
Monica Rivera,['Belize'],Journalist,1886,23,46,1909
David Valentine,['Libyan Arab Jamahiriya'],Researcher,1900,54,42,1954
Gina Duffy,"['Monaco', 'Falkland Islands (Malvinas)']",Fighter pilot,1880,22,31,1902
Kyle Lee,"['Martinique', 'Montenegro']",Athlete,1898,84,56,1982
Tammy Graham,['Malaysia'],Artist,1885,29,26,1914
Matthew Hernandez,['Russian Federation'],Artist,1885,5,9,1890
Pamela James,['Saint Kitts and Nevis'],Artist,1920,29,14,1949
Marc Davis,"['Saint Helena', 'Colombia']",Artist,1892,14,44,1906
Angela Murray,"['Iceland', 'Pakistan']",Artist,1895,3,53,1898
Sharon Reed,['Myanmar'],Artist,1895,44,22,1939
Ann Wilson,"['Denmark', 'Bahamas']",Artist,1907,16,4,1923
Rhonda Mckee,['Iran'],Artist,1881,77,32,1958
Paul Mckinney,['Jamaica'],Artist,1912,81,17,1993
Gloria Wilkinson,"['Spain', 'Maldives']",Artist,1887,68,42,1955
Mr. Brian Edwards,"['Ecuador', 'Netherlands Antilles']",Artist,1916,73,24,1989
Anita Diaz,['Albania'],Politician,1920,18,72,1938
Chelsey Olson,"['Niue', 'Algeria']",Cinematographer,1893,62,24,1955
Brittney Franco,['Bahrain'],Artist,1884,8,86,1892
Stephanie Smith,['Isle of Man'],Politician,1886,59,31,1945
Rachel Houston,['Serbia'],Artist,1878,45,70,1923
Brooke Hess,"['Saint Pierre and Miquelon', 'Denmark']",Politician,1924,6,59,1930
Justin Morales,['Dominica'],Politician,1906,75,24,1981
Donna Cline,['San Marino'],Athlete,1922,59,83,1981
Kelli Zamora,['South Georgia and the South Sandwich Islands'],Religious figure,1924,73,42,1997
Stephanie Torres,['Aruba'],Trade unionist,1892,2,20,1894
Krista Hernandez,['United States of America'],Artist,1886,58,2,1944
Carol Mccarthy,['Netherlands'],Artist,1889,71,78,1960
Jason Skinner,['Philippines'],Athlete,1884,10,42,1894
Ana Castillo,['Egypt'],Military personnel,1876,87,28,1963
Amanda Burns,"['Kyrgyz Republic', 'Saint Pierre and Miquelon']",Artist,1923,22,70,1945
Tyler Banks,"['Niger', 'Albania']",Athlete,1876,42,35,1918
Sarah Silva,['Guinea'],Researcher,1905,78,24,1983
Christine Morris,['Bahrain'],Artist,1878,16,43,1894
Lori Stuart,"['Reunion', 'Guatemala']",Artist,1878,58,32,1936
Sheila Lewis,['Seychelles'],Politician,1917,67,54,1984
Renee Becker,"[""Cote d'Ivoire"", 'Norfolk Island']",Artist,1918,86,51,2004
Sarah Murphy,"['Oman', 'Qatar']",Racing automobile driver; formula one driver,1881,32,68,1913
Katherine Williams,"['Antarctica (the territory South of 60 deg S)', 'Guernsey']",Judoka,1896,67,45,1963
Andrew Rodriguez,"['Nigeria', 'Luxembourg']",Artist,1920,23,88,1943
Tami Burton,['Colombia'],Artist,1883,64,2,1947
Darren Hunt,['United Arab Emirates'],Researcher,1904,4,14,1908
Bradley Alexander,"['Azerbaijan', 'Greenland']",Politician,1897,33,10,1930
Stephen Pitts MD,['Brazil'],Military personnel,1902,63,4,1965
Tyler Hawkins,"['Bermuda', 'Sudan']",Artist,1873,60,32,1933
Robin Barnes,"['Dominica', 'Bouvet Island (Bouvetoya)']",Artist,1890,88,40,1978
Manuel Cline,"['Heard Island and McDonald Islands', 'Puerto Rico']",Television producer; aerobatics pilot,1891,20,11,1911
Nicholas Schultz,"['North Macedonia', 'Tanzania']",Athlete,1900,62,17,1962
Cindy Rodriguez,"['Belgium', 'Malawi']",Politician,1881,37,34,1918
Marvin Pierce,"['Belarus', 'Taiwan']",Artist,1886,39,18,1925
Brittany Calderon,"['Sri Lanka', 'Cyprus']",Politician,1880,14,7,1894
Julia Guerra,"['Antigua and Barbuda', 'Ecuador']",Esperantist,1902,32,75,1934
Tracie Santos,"['Guinea-Bissau', 'Uzbekistan']",Athlete,1877,87,53,1964
Donna Clark,"['Montenegro', 'Greece']",Artist,1892,40,6,1932
Jennifer Wheeler,['Afghanistan'],Artist,1918,11,56,1929
Michael Jones,"['Djibouti', 'Kyrgyz Republic']",Politician,1902,62,57,1964
Barbara Sloan,"['United Kingdom', 'Tanzania']",Researcher,1901,39,35,1940
Megan Lynch,"['Seychelles', 'Sri Lanka']",Artist,1895,46,89,1941
Kara Johnson,['Ukraine'],Artist,1875,13,64,1888
Jessica Houston,"['Brunei Darussalam', 'Guernsey']",Artist,1905,82,64,1987
Francis Garcia,"['Costa Rica', 'Ecuador']",Artist,1915,42,6,1957
Mark Parrish,"['Senegal', 'Saint Lucia']",Capo dei capi; criminal,1923,45,88,1968
Willie Williams,"['Bouvet Island (Bouvetoya)', 'Cape Verde']",Artist,1924,47,29,1971
William Wilson,['French Southern Territories'],Artist,1882,19,60,1901
Patricia Chung,['Dominica'],Artist,1878,15,5,1893
Andrew Young,['Mauritius'],Artist,1882,58,32,1940
Drew Haley,"['Belize', 'Saint Pierre and Miquelon']",Politician,1912,41,32,1953
Alexander Hamilton,"['Kazakhstan', 'Trinidad and Tobago']",Artist,1884,69,28,1953
Brianna Ingram,"['Tajikistan', 'Tokelau']",Politician,1904,37,41,1941
Corey Estes,['Chile'],Artist,1901,26,20,1927
Kelly Hall,['Niue'],Politician,1906,20,52,1926
Linda Alvarez,['Bahamas'],Artist,1918,17,4,1935
Victoria Massey,['Malaysia'],Politician,1880,62,14,1942
Ernest Molina,['Philippines'],Athlete,1885,38,56,1923
Hector Hart,['Bahamas'],Artist,1918,17,40,1935
Gina Woods,"['Slovakia (Slovak Republic)', 'Qatar']",Artist,1889,25,88,1914
Amy Hunt,"['South Georgia and the South Sandwich Islands', 'Saint Helena']",Politician,1921,36,11,1957
Jacob Garcia,['Cook Islands'],Politician,1903,74,56,1977
Antonio Wong,['Malawi'],Athlete,1909,9,8,1918
Karen Espinoza MD,['Saint Barthelemy'],Athlete,1897,43,1,1940
Gina Mitchell,"['Czech Republic', 'British Virgin Islands']",Researcher,1888,18,42,1906
Jennifer Pena,['Croatia'],Partisan,1919,21,2,1940
Kevin Thornton,['Tokelau'],Athlete,1890,5,81,1895
Michelle Johnson,['Bhutan'],Artist,1885,73,19,1958
Mrs. Rebecca Hernandez,"['Malta', 'Taiwan']",Artist,1909,63,51,1972
Michael Davis,"['Nicaragua', 'Sierra Leone']",Researcher,1897,56,73,1953
Richard Hall,['Finland'],Politician,1884,43,57,1927
Dean Hendrix,"['Costa Rica', 'Guernsey']",Politician,1887,84,41,1971
James Tucker,['Heard Island and McDonald Islands'],Politician,1870,86,79,1956
Evan Cox,"['Cook Islands', 'Haiti']",Politician,1894,50,38,1944
Kenneth Leonard,"['Croatia', 'Puerto Rico']",Artist,1902,32,14,1934
Phillip Jones,['Tokelau'],Artist,1920,22,29,1942
John Ramsey,['Mauritania'],Politician,1924,30,59,1954
Danielle Thomas,['Mauritania'],Artist,1887,69,15,1956
Daniel Lambert,"['Liechtenstein', 'Iraq']",Artist,1918,46,87,1964
Kimberly Gillespie,['Ireland'],Military personnel,1911,85,40,1996
Brandi Davenport,"['Namibia', 'Turkmenistan']",Businessperson,1916,18,53,1934
Lonnie Young,['Sierra Leone'],Artist,1921,72,83,1993
George Blair,['Equatorial Guinea'],Artist,1872,12,84,1884
Johnny Miller,['Faroe Islands'],Artist,1917,11,35,1928
Barbara Rivera,"['Cuba', 'Tonga']",Athlete,1893,37,4,1930
John Schroeder,['Isle of Man'],Athlete,1885,59,88,1944
Andrea Hill,['Moldova'],Politician,1903,29,28,1932
Christine Jones,['Palau'],Artist,1924,81,57,2005
Carrie Li,"['Saudi Arabia', 'Solomon Islands']",Artist,1921,48,79,1969
Penny Juarez,"['New Caledonia', 'Montenegro']",Artist,1871,39,41,1910
Hannah Allen,"['Cameroon', 'Sweden']",Researcher,1909,25,33,1934
Becky Hays,"['Myanmar', 'Argentina']",Military personnel,1905,78,14,1983
William Vaughan,['Sao Tome and Principe'],Artist,1882,9,15,1891
Nathan Jones,['Trinidad and Tobago'],Artist,1904,4,44,1908
Robert Patterson,"[""Lao People's Democratic Republic"", 'Iran']",Artist,1879,3,33,1882
Derek Henderson,"['Pakistan', 'South Georgia and the South Sandwich Islands']",Politician,1903,52,54,1955
Maria Young,['Wallis and Futuna'],Artist,1879,51,52,1930
Christopher Edwards MD,['French Guiana'],Athlete,1919,68,88,1987
Joseph Johnson,['Libyan Arab Jamahiriya'],Artist,1882,8,66,1890
Courtney Gilmore,['Faroe Islands'],Artist,1883,74,2,1957
William Blackwell,"['Saint Martin', 'Cape Verde']",Artist,1891,78,55,1969
Claudia Clark,"['Algeria', 'Czech Republic']",Athlete,1910,2,8,1912
Rose Pittman,"['Uruguay', 'Argentina']",Artist,1881,23,89,1904
Debra Brown,"['Turkey', 'Peru']",Artist,1906,41,46,1947
Sergio Foster,"['Estonia', 'Ukraine']",Artist,1881,79,22,1960
Kyle Williams,['Jordan'],Environmentalist; trade unionist,1910,73,0,1983
Joanna Russo,"['Western Sahara', 'Suriname']",Religious figure,1878,74,62,1952
Laura Powell,['Tunisia'],Artist,1908,75,36,1983
Cassandra Mills,['Croatia'],Artist,1883,53,86,1936
Logan Wyatt,['Belarus'],Artist,1901,32,71,1933
Javier Phillips,['Japan'],Artist,1921,73,23,1994
Jonathan Young,"['Azerbaijan', 'Vietnam']",Politician,1921,19,15,1940
Amanda Scott,['French Polynesia'],Military personnel,1895,63,80,1958
Aaron Kelly,['Falkland Islands (Malvinas)'],Artist,1899,4,67,1903
Andre Oneal,['Hungary'],Artist,1904,26,41,1930
Abigail Chapman,"['Bahamas', 'Palestinian Territory']",Artist,1871,67,22,1938
Anthony Nguyen,"['Sierra Leone', 'Eritrea']",Researcher,1871,41,11,1912
Shari Warner,['Falkland Islands (Malvinas)'],Torturer,1891,25,69,1916
Troy Mills,['Guernsey'],Religious figure,1895,61,34,1956
Michael Wood,"['Cayman Islands', 'Israel']",Researcher,1875,72,21,1947
Bruce Hernandez,"['Lithuania', 'Congo']",Artist,1875,58,27,1933
Yvonne Howard,"['Belize', 'Norfolk Island']",Artist,1888,62,87,1950
Cynthia Levy,['Italy'],Artist,1874,26,2,1900
Robert Parsons,"['Estonia', 'Andorra']",Politician,1894,71,25,1965
David Butler,['Greenland'],Politician,1901,68,32,1969
William Lewis,"['Saint Lucia', 'Mauritius']",Artist,1896,35,82,1931
Sue Douglas,['Liechtenstein'],Artist,1904,61,62,1965
Tina Evans,"['Korea', 'Bhutan']",Artist,1909,23,4,1932
Hailey Jones,"['Gibraltar', 'Thailand']",Politician,1882,66,59,1948
Kevin Mason,['Cape Verde'],Artist,1888,38,71,1926
Margaret Hogan,"['Tuvalu', 'Namibia']",Artist,1876,27,25,1903
Deborah Li,['Albania'],Artist,1909,11,5,1920
Angel Martin,"['China', 'Andorra']",Artist,1911,45,61,1956
Amanda Smith,['Indonesia'],Artist,1895,57,85,1952
Jason Barnett,"['Croatia', 'Albania']",Politician,1886,12,6,1898
Teresa Ramirez,"['Niger', 'Guadeloupe']",Researcher,1874,48,67,1922
Katherine Moore,['Korea'],Politician,1886,40,76,1926
Natalie Peterson,"['Mauritania', 'Cook Islands']",Artist,1881,65,47,1946
Kelsey Davis,"['Belize', 'Azerbaijan']",Artist,1874,1,67,1875
Timothy Scott,['United States Virgin Islands'],Researcher,1883,70,50,1953
Sherri Meadows,['Congo'],Politician,1878,19,44,1897
Kenneth Williams,"['Panama', 'Croatia']",Politician,1887,46,19,1933
Victoria Jackson,['Sweden'],Artist,1896,77,81,1973
Evelyn Rodriguez,['Liechtenstein'],Artist,1892,28,19,1920
Suzanne Roth,"['Canada', 'Nepal']",Rally driver,1878,46,39,1924
Kimberly Floyd,"['Luxembourg', 'Saint Lucia']",Artist,1875,33,15,1908
Christopher Smith,"['Nauru', 'Guernsey']",Artist,1890,19,29,1909
Stephanie Collins,"['Northern Mariana Islands', 'Iceland']",Alpine skier,1891,9,71,1900
Kristina Mann,['Vietnam'],Researcher,1888,76,35,1964
Casey Martinez,"['Germany', 'Angola']",Artist,1913,16,63,1929
Timothy Lawrence,['Christmas Island'],Athlete,1879,4,15,1883
Laura Gray,['Moldova'],Artist,1908,71,36,1979
Melissa Nash,"['Wallis and Futuna', 'Guatemala']",Artist,1919,8,66,1927
Philip Brown,"['Faroe Islands', 'Namibia']",Artist,1876,43,55,1919
Jessica Moran,"['South Georgia and the South Sandwich Islands', 'Dominican Republic']",Artist,1891,65,38,1956
Frances Williams,"['Italy', 'Ecuador']",Conductor; pedagogue,1881,6,10,1887
Kathryn Stephens,"['Guinea-Bissau', 'Bermuda']",Athlete,1911,11,70,1922
Mitchell Anderson,"['Micronesia', 'Reunion']",Researcher,1878,83,38,1961
Cheryl Hurst,['Bulgaria'],Artist,1923,53,79,1976
Amanda Wright,['Argentina'],Funeral director; manager; professional wrestler,1910,4,60,1914
Lisa Olson,"['Poland', 'Faroe Islands']",Politician,1910,31,46,1941
Andrew Jennings,['Cook Islands'],Politician,1880,52,35,1932
Thomas Brown,"['Saudi Arabia', 'Mongolia']",Artist,1880,77,56,1957
Kelly Jackson,"['Western Sahara', 'Belarus']",Artist,1920,24,4,1944
Jose Hines,"['United States Virgin Islands', 'Mauritania']",Serial killer; criminal,1889,62,6,1951
Crystal Gallegos,"['Fiji', 'Qatar']",Artist,1908,20,41,1928
Katherine Rocha,"['Iran', 'Saint Lucia']",Artist,1895,10,31,1905
Corey Nelson,['Guatemala'],Researcher,1906,84,0,1990
Matthew Baldwin,"['Norfolk Island', 'Timor-Leste']",Military personnel,1891,16,18,1907
Amy Parker,['North Macedonia'],Researcher,1914,85,43,1999
Daniel Phillips,['Estonia'],Researcher,1873,51,76,1924
Angela Sanchez,['Macao'],Artist,1911,58,50,1969
Michael Martinez,"['Philippines', 'Bahamas']",Artist,1882,22,42,1904
Danielle Perez,"['Ecuador', 'Saint Kitts and Nevis']",Artist,1897,69,50,1966
Laura Schroeder,['Iran'],Journalist,1921,19,26,1940
Sarah Cook,['Swaziland'],Athlete,1879,7,12,1886
David Bartlett,['Qatar'],Artist,1875,45,72,1920
Steven Valdez,"['Burkina Faso', 'Russian Federation']",Artist,1892,31,10,1923
Cynthia Jacobs,['Comoros'],Artist,1919,3,45,1922
Nicole Williams,['Iran'],Artist,1878,53,6,1931
Michael Barrett,"['Puerto Rico', 'United States Virgin Islands']",Researcher,1892,8,55,1900
Shelby Becker,['Mongolia'],Artist,1907,31,0,1938
Ronald Cole,['Namibia'],Artist,1877,52,60,1929
Mike Walker,['Palestinian Territory'],Artist,1895,22,23,1917
Sharon Keller,"['Switzerland', 'Palestinian Territory']",Politician,1917,65,85,1982
Jessica Mcintyre,"['Guyana', 'Togo']",Artist,1878,75,34,1953
Lisa Bennett,"['Saint Barthelemy', 'Tonga']",Politician,1886,4,34,1890
Sherri Jones,"['Saint Barthelemy', 'Heard Island and McDonald Islands']",Artist,1918,55,89,1973
Paige Pratt,"['Martinique', 'Bulgaria']",Politician,1902,61,25,1963
Thomas Gray,['Haiti'],Artist,1913,74,27,1987
Anna Carr,"['Honduras', 'Bouvet Island (Bouvetoya)']",Researcher,1875,73,71,1948
Dr. Kimberly Mccoy MD,"['Egypt', 'Gibraltar']",Artist,1897,37,89,1934
Steven Vazquez,['Saudi Arabia'],Military personnel,1914,87,19,2001
Sandra Simpson,['Canada'],Military personnel,1906,29,66,1935
Kristina Henry,['Panama'],Politician,1902,0,62,1902
Mr. Christopher Chavez,"['Rwanda', 'Haiti']",Athlete,1896,3,81,1899
Maria Duncan,"['Swaziland', 'French Guiana']",Psychologist; psychoanalyst,1909,19,62,1928
Heather Hudson,['El Salvador'],Regent,1908,83,49,1991
Melissa Bailey,"['Saudi Arabia', 'Lithuania']",Artist,1911,86,68,1997
Pam Alexander,"['Lithuania', 'Argentina']",Artist,1881,85,45,1966
Craig David,['Christmas Island'],Artist,1922,49,59,1971
John Monroe,['Heard Island and McDonald Islands'],Sovereign,1892,60,82,1952
Jeffrey Leach,"['Holy See (Vatican City State)', 'Mauritania']",Artist,1872,80,39,1952
Zachary Coleman,['Svalbard & Jan Mayen Islands'],Artist,1897,25,34,1922
Andrew Stafford,"['Liberia', 'Saint Kitts and Nevis']",Artist,1922,28,79,1950
Steven Kelly,"['Congo', 'Costa Rica']",Artist,1887,24,77,1911
Henry Contreras,['French Guiana'],Artist,1875,87,63,1962
Robert Klein,['Gibraltar'],Psychiatrist; psychoanalyst,1881,18,5,1899
Debbie Jones,['Sierra Leone'],Teacher,1903,29,7,1932
Susan Terry,"['United Kingdom', 'Cyprus']",Artist,1882,80,63,1962
Susan Morgan,"['Monaco', 'India']",Pirate,1875,36,46,1911
Laura Powell,"['Madagascar', 'Bolivia']",Researcher,1910,88,74,1998
Mary Chavez,['Bermuda'],Politician,1870,51,31,1921
Sonya Garza,"['Haiti', 'Belarus']",Entrepreneur,1879,28,51,1907
Larry Kelly,"['Ghana', 'Papua New Guinea']",Politician,1899,75,69,1974
Mrs. Chloe Sharp,['Iceland'],Artist,1904,76,30,1980
Pamela Schwartz,['Grenada'],Military personnel,1883,84,83,1967
Dylan Davis,"['Saint Martin', 'Netherlands Antilles']",Artist,1916,62,67,1978
Eric Alvarez,"['Latvia', 'Croatia']",Politician,1911,1,30,1912
Joseph Luna,"['Malaysia', 'Gibraltar']",Researcher,1880,86,33,1966
Stacy Brown,"['Guyana', 'Korea']",Artist,1893,46,14,1939
Brittney Green,['United Kingdom'],Artist,1894,13,85,1907
Dustin Smith,"['Vanuatu', 'Finland']",Artist,1904,0,8,1904
James Garcia,"['Cape Verde', 'Suriname']",Artist,1872,22,74,1894
Mary Nguyen,"['Cambodia', 'Timor-Leste']",Artist,1890,22,84,1912
Natalie Meyer,['Australia'],Researcher,1910,47,31,1957
Robert Watson,"['Tokelau', 'Guatemala']",Politician,1894,44,88,1938
Martin Roberts,['Uruguay'],Artist,1879,70,81,1949
Jeffrey Fox,['Germany'],Politician,1873,38,49,1911
William Johnson,"['Armenia', 'Myanmar']",Artist,1885,72,59,1957
Michael Willis,['Macao'],Politician,1894,40,35,1934
Sheryl Johnson,['Latvia'],Religious figure,1894,51,54,1945
John Taylor,"['Lithuania', 'Micronesia']",Artist,1879,46,59,1925
Whitney Calderon,['El Salvador'],Artist,1892,12,26,1904
Adam Torres,"['Latvia', 'Ireland']",Researcher,1887,37,21,1924
James Todd,"['Marshall Islands', 'Fiji']",Artist,1896,65,56,1961
Dominique Delacruz,['Jordan'],Samurai; bushi,1911,61,3,1972
Jamie Cortez,"['Kazakhstan', 'India']",Architect,1878,46,23,1924
Kendra Johnson,['Romania'],Teacher,1919,29,21,1948
Sheila Ross,"['Ethiopia', 'Romania']",Journalist,1873,55,86,1928
Lisa Santiago,"['United States Minor Outlying Islands', 'Wallis and Futuna']",Researcher,1881,77,6,1958
Andrew Perry,"['Micronesia', 'Tanzania']",Military personnel,1916,53,28,1969
Diane Small,"['Turks and Caicos Islands', 'Ecuador']",Ruler,1894,13,39,1907
Matthew Hardy,"['Mauritius', 'Pakistan']",Monarch,1921,64,66,1985
Jordan Ramirez,"['Yemen', 'Korea']",Artist,1887,63,28,1950
Shawn Nichols,['Australia'],Artist,1879,30,47,1909
Michael Johnson,"['Barbados', 'Papua New Guinea']",Politician,1883,60,52,1943
Tony Griffith,['Saint Kitts and Nevis'],Businessperson,1914,15,77,1929
Beth Figueroa,"['Central African Republic', 'China']",Athlete,1916,54,43,1970
Nicholas Gates,"['Antigua and Barbuda', 'American Samoa']",Artist,1919,46,40,1965
Jennifer Barry,"['Niger', 'Mongolia']",Artist,1879,80,3,1959
Tricia Wilson,['Swaziland'],Artist,1894,38,65,1932
Daniel Kim,"['Monaco', 'Venezuela']",Religious figure,1882,23,23,1905
Veronica Weaver,['Tonga'],Researcher,1897,62,35,1959
William Reed,"['Indonesia', 'Argentina']",Artist,1900,33,16,1933
Cynthia Vasquez,['Nauru'],Artist,1883,56,6,1939
Laura Kim,"['Belarus', 'Saint Helena']",Artist,1923,87,13,2010
Tyler Carter,['Kyrgyz Republic'],Politician,1873,51,11,1924
Lisa Avila,['Finland'],Artist,1880,66,34,1946
Thomas Robbins,"['Algeria', 'Monaco']",Artist,1896,55,9,1951
Dr. Kevin Hayes,"['Zimbabwe', 'Venezuela']",Artist,1872,89,37,1961
Breanna Hill,"['Tajikistan', 'Montenegro']",Artist,1875,12,48,1887
Alyssa Smith,"['Namibia', 'Vietnam']",Military personnel,1919,79,22,1998
Hector Wagner,"['New Zealand', 'Andorra']",Researcher,1896,72,32,1968
Lisa Sanders,['Sri Lanka'],Artist,1924,37,79,1961
Amanda Jennings,['Equatorial Guinea'],Artist,1890,48,80,1938
Michael Rice,['Armenia'],Nun,1906,38,80,1944
Bryan Bailey,['Serbia'],Artist,1924,34,59,1958
Dawn Huynh,"['Luxembourg', 'Romania']",Politician,1924,41,51,1965
Mary Bryant,"['Timor-Leste', 'American Samoa']",Artist,1899,47,26,1946
Christian Thomas,['Russian Federation'],Researcher,1912,7,46,1919
Cassandra Doyle,"['Cook Islands', 'Morocco']",Researcher,1894,72,31,1966
Shelley French,['Afghanistan'],Artist,1916,23,61,1939
Carlos Nelson,"['Bahrain', 'Zambia']",Racing driver; racing automobile driver,1870,10,5,1880
Judy Braun,['Togo'],Athlete,1887,40,57,1927
Megan Howard,"['Kenya', 'New Zealand']",Entrepreneur,1903,18,22,1921
Steven Hobbs,['Nauru'],Politician,1892,13,38,1905
Erik Donovan,"['Northern Mariana Islands', 'French Southern Territories']",Artist,1891,81,75,1972
Daniel Oliver,"['Kuwait', 'United Arab Emirates']",Artist,1915,59,65,1974
Theresa Maynard,"['Saint Helena', 'Malta']",Researcher,1920,77,84,1997
David Ward,['Andorra'],Artist,1890,50,73,1940
John Allen,"['Jersey', 'Egypt']",Ruler,1900,86,27,1986
Darren Scott,['Australia'],Politician,1876,25,8,1901
Joseph Williams,['United Kingdom'],Researcher,1895,55,17,1950
Abigail Brown,['France'],Serial killer,1870,40,88,1910
Erik Larsen,['Australia'],Artist,1895,50,46,1945
Derek Robinson,['Iceland'],Athlete,1880,10,3,1890
Jill Garcia,"['Qatar', 'Myanmar']",Artist,1881,72,74,1953
Shane Hayes,"['Indonesia', 'Malaysia']",Artist,1904,32,46,1936
Kayla Smith,['Cook Islands'],Artist,1889,0,0,1889
Lisa Guzman,"['Slovakia (Slovak Republic)', 'Belarus']",Artist,1914,2,85,1916
Paige Moon,"['Paraguay', 'China']",Military personnel,1890,24,52,1914
Philip Davis,"['Anguilla', 'United States Minor Outlying Islands']",Politician,1888,1,79,1889
Hannah Hicks,"['Tajikistan', 'Niger']",Military personnel,1877,5,68,1882
Christopher Garcia,"['Congo', 'Guam']",Athlete,1883,23,9,1906
James Wheeler,"['Nigeria', 'Slovenia']",Artist,1870,87,65,1957
Rachel Byrd,"['Ethiopia', 'Sweden']",Politician,1892,65,20,1957
Chelsea Shelton,"['Brunei Darussalam', 'Seychelles']",Spy,1870,58,86,1928
Brian Padilla,['Venezuela'],Hammer thrower,1899,47,63,1946
Stephanie James,"['Cayman Islands', 'Ethiopia']",Athlete,1885,23,83,1908
Gordon Thomas,['Slovenia'],Politician,1884,18,74,1902
Brandi Allison,['Montenegro'],Artist,1894,61,23,1955
William Simmons DVM,['Slovakia (Slovak Republic)'],Athlete,1873,43,39,1916
Marissa Brown,['Nicaragua'],Artist,1898,22,18,1920
Richard Mack,"['New Caledonia', 'Cook Islands']",Politician,1887,83,33,1970
Candice Jones,"['British Virgin Islands', 'Netherlands Antilles']",Religious figure,1922,88,84,2010
Lisa Fritz,"['Afghanistan', 'Mauritania']",Politician,1895,33,26,1928
Angel Khan,['Sao Tome and Principe'],Artist,1880,64,65,1944
John Savage,['New Zealand'],Athlete,1921,77,33,1998
Sierra Ford,['Belarus'],Religious figure,1877,66,39,1943
Makayla Alexander,['Suriname'],Artist,1877,66,75,1943
Tracy Bell,['French Polynesia'],Military personnel,1894,12,47,1906
Thomas Thomas,"['Israel', 'Tuvalu']",Artist,1879,54,80,1933
Gregory Anderson,['Lesotho'],Revolutionary,1884,4,17,1888
Anthony Barrett,"['Benin', 'Bahamas']",Military personnel,1884,71,66,1955
Chelsea Stafford,"['Kyrgyz Republic', 'Seychelles']",Teacher,1919,34,21,1953
Tara Murray,"['Saint Vincent and the Grenadines', 'Western Sahara']",Artist,1900,54,3,1954
Jonathan Campbell,"['Congo', 'American Samoa']",Artist,1909,36,33,1945
Barbara Morgan,"['Holy See (Vatican City State)', 'Sudan']",Politician,1875,72,77,1947
Justin Cook,"['Guatemala', 'Belarus']",Teacher,1896,42,61,1938
Theresa Williams DVM,['Falkland Islands (Malvinas)'],Artist,1884,87,61,1971
Nicole Moore,['Solomon Islands'],Artist,1879,42,2,1921
Susan Ramos,['Armenia'],Politician,1877,14,43,1891
Christopher Schaefer,"['Antigua and Barbuda', 'Iran']",Artist,1876,57,76,1933
Mr. Justin Keller,"['American Samoa', 'Russian Federation']",Military personnel,1914,22,24,1936
Cathy Wilson,['Anguilla'],Businessperson,1878,81,9,1959
Stephen Peterson,['Antigua and Barbuda'],Journalist,1898,66,40,1964
Vanessa Bailey,"['Cameroon', 'Bouvet Island (Bouvetoya)']",Politician,1880,79,36,1959
Jerry Richardson,"['Zambia', 'Tokelau']",Artist,1888,48,22,1936
Joseph Bell,"['France', 'Taiwan']",Researcher,1887,19,35,1906
Mackenzie Buck,"['Slovakia (Slovak Republic)', 'Micronesia']",Athlete,1879,84,23,1963
Stacey Hess,['Samoa'],Artist,1903,14,80,1917
Eric Smith,"['Spain', 'Japan']",Researcher,1888,84,60,1972
Melissa Hughes,['Bolivia'],Secretary,1881,89,65,1970
Scott Reynolds,['Russian Federation'],Politician,1875,24,73,1899
Brandon Bauer,['Kiribati'],Athlete,1894,68,16,1962
Kristen Phillips,"['Algeria', 'India']",Artist,1883,13,60,1896
Paula Jefferson,['Congo'],Artist,1873,48,10,1921
Frederick Evans,['French Guiana'],Politician,1906,25,53,1931
Steven Oneill,['Antarctica (the territory South of 60 deg S)'],Architect,1884,42,78,1926
Bruce Henry,"['United States Virgin Islands', 'Eritrea']",Artist,1907,15,75,1922
Carolyn Wright,"['Brunei Darussalam', 'Kiribati']",Athlete,1886,76,51,1962
Shelley Pena,"[""Lao People's Democratic Republic"", 'Guernsey']",Artist,1876,5,67,1881
Jessica Shaffer,['Georgia'],Politician,1893,67,3,1960
Renee Ross,['Andorra'],Athlete,1878,42,42,1920
Amy Carson,"['Libyan Arab Jamahiriya', 'Belize']",Spy; terrorist,1902,5,12,1907
Beverly Booth,['Namibia'],Artist,1885,72,10,1957
Brianna Klein,"['Portugal', 'South Georgia and the South Sandwich Islands']",Researcher,1896,25,79,1921
Brenda Johnson,['Greenland'],Politician,1912,29,40,1941
Mark Pearson,['Madagascar'],Politician,1889,69,82,1958
Kelly Guzman PhD,"['Liberia', 'Aruba']",Artist,1904,44,41,1948
Jacob Lopez,['Malaysia'],Farmer; serial killer,1877,84,66,1961
Courtney Frost,['Northern Mariana Islands'],Businessperson,1924,32,26,1956
Jessica Daniels,['Saint Kitts and Nevis'],Military personnel,1872,65,23,1937
James Martin,['Bahrain'],Religious figure,1908,73,7,1981
Anthony Erickson,"['French Southern Territories', 'Zimbabwe']",Politician,1917,62,17,1979
Jeff Miller,['New Zealand'],Politician,1879,77,7,1956
Ian Pierce,['Thailand'],Athlete,1871,50,87,1921
Debra Woods,['New Zealand'],Artist,1885,78,54,1963
Stephen Woods,"['Haiti', 'Latvia']",Artist,1872,67,27,1939
Roberto Marshall,"['Micronesia', 'French Southern Territories']",Artist,1911,52,66,1963
Katherine Rhodes,"['Nauru', 'Palestinian Territory']",Ruler,1874,6,37,1880
Tammy Nguyen,['Albania'],Researcher,1896,34,89,1930
Kyle Watson,"['Switzerland', 'Egypt']",Researcher,1908,55,76,1963
Cassandra Webb,"['Belize', 'Singapore']",Artist,1873,46,67,1919
Katelyn King,['Djibouti'],Athlete,1879,24,70,1903
William Rodgers,['Swaziland'],Artist,1920,65,13,1985
Terry Cantu,['Kazakhstan'],Researcher,1907,30,86,1937
John Downs,"['Mozambique', 'Mauritania']",Artist,1921,56,65,1977
Bonnie Valdez,"['French Guiana', 'Bolivia']",Politician,1897,63,44,1960
Scott Cole,"['Palau', 'Guernsey']",Artist,1919,52,84,1971
Cristian Ferguson,"['Trinidad and Tobago', 'Germany']",Artist,1902,63,37,1965
Amy Lopez,['Zambia'],Artist,1895,17,54,1912
Alexis Ortiz,"['Jamaica', 'Honduras']",Artist,1897,21,27,1918
Pamela Christian,"['Morocco', 'Philippines']",Researcher,1921,50,28,1971
Danny Hernandez,"['San Marino', 'Senegal']",Artist,1896,55,34,1951
Joseph Cabrera,['Hungary'],Artist,1903,14,48,1917
Emma Mccormick,"['Bangladesh', 'Malawi']",Military personnel,1909,43,64,1952
Calvin Brown,['Montserrat'],Artist,1891,52,0,1943
Javier Delgado,['Timor-Leste'],Artist,1887,6,56,1893
Angela Spencer,"['Guatemala', 'Rwanda']",Artist,1890,71,32,1961
Janet Harris,"['Pakistan', 'Andorra']",Athlete,1882,89,72,1971
Anna Mcdonald,['Italy'],Politician,1878,40,71,1918
Antonio Gallegos,['Saint Martin'],Researcher,1906,3,82,1909
Melissa Nielsen,"['Oman', 'South Georgia and the South Sandwich Islands']",Criminal,1906,74,34,1980
Brenda Hall,"['Indonesia', 'Senegal']",Researcher,1922,7,62,1929
Mark Morris,"['Myanmar', 'Svalbard & Jan Mayen Islands']",Politician,1878,48,69,1926
Teresa Kent,['Saint Lucia'],Researcher,1904,58,45,1962
Bradley Hubbard,"['Martinique', 'Samoa']",Artist,1908,64,41,1972
Sharon Weaver,['Cuba'],Teacher,1880,89,57,1969
Andrea Duncan,"['India', 'Jamaica']",Artist,1874,56,35,1930
Katherine Barnes,"['Korea', 'Vanuatu']",Artist,1881,48,87,1929
Angela Edwards,['Thailand'],Journalist,1891,71,56,1962
Claire Williams,"['San Marino', 'Norfolk Island']",Artist,1888,43,49,1931
Scott Jennings,['Brunei Darussalam'],Artist,1913,6,7,1919
Amy Mejia,"['French Guiana', 'United States Virgin Islands']",Politician,1873,27,35,1900
Brittany Williams,"['Maldives', 'Georgia']",Researcher,1912,82,40,1994
John Lloyd,['Western Sahara'],Artist,1919,34,28,1953
Michele Reyes,"['Mali', 'Guinea-Bissau']",Artist,1909,16,56,1925
Carmen Ramirez,['Ireland'],Artist,1917,6,34,1923
David Williams,"['Marshall Islands', 'Ethiopia']",Politician,1906,77,85,1983
Angela Hall,"['Belgium', 'Croatia']",Artist,1872,53,65,1925
Alexander Fletcher,"['Guyana', 'South Georgia and the South Sandwich Islands']",Artist,1875,89,17,1964
Joanna Lewis,['South Georgia and the South Sandwich Islands'],Researcher,1891,46,19,1937
Bruce Williams,['Guinea'],Researcher,1877,88,72,1965
Jason Knight,['Saint Helena'],Artist,1905,34,82,1939
Mr. Joshua Taylor,['Iran'],Artist,1904,64,41,1968
Michelle Welch,['Sao Tome and Principe'],Artist,1893,65,43,1958
Amanda Jordan,['Reunion'],Artist,1890,48,8,1938
Christine Webb,"['Denmark', 'Trinidad and Tobago']",Politician,1891,5,52,1896
Dennis Navarro,"['Gibraltar', 'Qatar']",Artist,1897,24,73,1921
Chris Oconnor,"['French Guiana', 'Guadeloupe']",Artist,1887,88,50,1975
Sean Turner,"['Guinea', 'Denmark']",Businessperson,1903,89,52,1992
Jack Decker,['Iraq'],Artist,1897,21,24,1918
Amanda Vincent,"['Netherlands Antilles', 'Angola']",Artist,1884,50,85,1934
Lisa Martinez,"['American Samoa', 'South Georgia and the South Sandwich Islands']",Artist,1878,66,49,1944
Garrett Jensen,"['Sweden', 'Czech Republic']",Researcher,1914,59,1,1973
Michael Mckinney,['Vietnam'],Artist,1915,12,85,1927
Mariah Moore,['Congo'],Artist,1905,52,76,1957
Diane Webster,"['Bermuda', 'Norfolk Island']",Artist,1879,19,5,1898
Andrew Peterson,"['Svalbard & Jan Mayen Islands', 'Suriname']",Engineer,1871,19,62,1890
Kelly Chavez,"['Tanzania', 'British Virgin Islands']",Artist,1889,18,14,1907
Richard Gay,['Afghanistan'],Politician,1871,36,13,1907
Taylor Wall,['Senegal'],Athlete,1921,83,58,2004
Ashley Harrington,"['Belarus', 'Hong Kong']",Artist,1879,4,1,1883
Roger Porter,"['Palestinian Territory', 'Thailand']",Artist,1900,33,58,1933
Annette Cruz,['Spain'],Artist,1917,13,29,1930
Brittany Schroeder,"['Estonia', 'Jordan']",Artist,1921,56,79,1977
Audrey Johnson,"['Afghanistan', 'Czech Republic']",Artist,1897,70,45,1967
Kyle Brooks,"['Saudi Arabia', 'Slovakia (Slovak Republic)']",Politician,1886,35,39,1921
Brian Wise,"['Oman', 'Ecuador']",Artist,1875,11,76,1886
Cheyenne Cruz,"['British Virgin Islands', 'Luxembourg']",Artist,1905,64,82,1969
Brian Palmer,['Western Sahara'],Researcher,1873,0,23,1873
Laura Henderson,"['Grenada', 'Malta']",Researcher,1892,33,12,1925
Brian Duffy,"['Papua New Guinea', 'Estonia']",Artist,1888,23,2,1911
Dawn Morales,"['Belgium', 'Iran']",Athlete,1910,36,85,1946
Danny Lucas,['Nigeria'],Researcher,1903,52,33,1955
Ian Morgan,"['Belarus', 'Djibouti']",Artist,1893,56,56,1949
Julie Powell,['Christmas Island'],Artist,1911,3,46,1914
Kristi Williams,['Spain'],Conductor; music director; theater director,1917,2,12,1919
Jeffrey Luna,['Myanmar'],Politician,1879,37,50,1916
Dylan Rasmussen,['Kenya'],Artist,1888,68,24,1956
Meagan Trevino,['India'],Entrepreneur,1896,7,28,1903
John Stein,"['Eritrea', 'Portugal']",Researcher,1920,68,15,1988
Rachel Jones MD,['Indonesia'],Politician,1907,33,20,1940
Dustin Gonzalez,"['Guinea-Bissau', 'Solomon Islands']",Politician,1921,12,80,1933
Thomas Holmes,['Lithuania'],Politician,1908,16,50,1924
James Mata,"['Poland', 'Antigua and Barbuda']",Artist,1924,55,86,1979
Ricardo Brooks,['Ukraine'],Artist,1879,34,72,1913
Linda Johnson,"['Sweden', 'Uruguay']",Artist,1916,62,55,1978
David Krause,['Martinique'],Athlete,1912,5,38,1917
Sabrina Day,['San Marino'],Athlete,1884,23,75,1907
Kimberly Myers,['Ukraine'],Military personnel,1903,31,4,1934
Vanessa Reyes,"['Nicaragua', 'Saint Pierre and Miquelon']",Politician,1917,9,50,1926
Jennifer Garrett,"['Andorra', 'Thailand']",Artist,1886,5,45,1891
Todd Thompson,"['Latvia', 'Palestinian Territory']",Artist,1906,23,40,1929
Julie Mills,['Swaziland'],Torturer; concentration camp guard,1877,64,10,1941
Daniel Cordova,['Bahamas'],Researcher,1908,49,22,1957
Danielle Jackson,['Jersey'],Athlete,1906,62,15,1968
Thomas Vazquez,"['Uruguay', 'Qatar']",Athlete,1907,62,69,1969
Lawrence Maddox,['Lebanon'],Politician,1883,40,11,1923
Laura Morgan,['Italy'],Athlete,1914,74,86,1988
Nicholas Padilla,"['Eritrea', 'Guam']",Philosopher,1910,62,53,1972
Sandra Valentine,['Taiwan'],Researcher,1893,4,64,1897
Joanna Valdez,"['Bosnia and Herzegovina', 'Slovakia (Slovak Republic)']",Researcher,1897,22,50,1919
Kimberly Robbins,['Papua New Guinea'],Artist,1898,87,4,1985
Leah Collins,['South Georgia and the South Sandwich Islands'],Artist,1914,37,67,1951
Jennifer Monroe,"['Hong Kong', 'Sao Tome and Principe']",Military personnel,1918,63,0,1981
Monica Graham,['Congo'],Politician,1879,71,12,1950
Elijah Mills,['British Virgin Islands'],Artist,1893,80,31,1973
Martha Castillo,"['Benin', 'Ghana']",Artist,1900,64,50,1964
Natalie House,['Norway'],Artist,1919,64,11,1983
Lauren Clark,['Grenada'],Artist,1907,69,40,1976
Sierra Webb,"['Eritrea', 'Netherlands Antilles']",Politician,1894,82,1,1976
Christopher King,['Moldova'],Artist,1917,80,83,1997
Alyssa Young,"['Fiji', 'Anguilla']",Engineer,1922,22,66,1944
Mark Swanson,['Greenland'],Artist,1893,84,21,1977
Amy Moore,['Syrian Arab Republic'],Athlete,1879,48,86,1927
Caitlin Cox,['Togo'],Athlete,1909,9,47,1918
Jamie Baldwin,"['Micronesia', 'French Southern Territories']",Military personnel,1899,29,75,1928
Debra Ward,"['British Virgin Islands', 'Western Sahara']",Resistance fighter; political activist,1920,84,70,2004
Sue Nguyen,"['France', 'Vietnam']",Artist,1889,51,60,1940
Kyle Hill,"['Monaco', 'Bermuda']",Athlete,1874,22,24,1896
Dustin Bowman,['Chad'],Researcher,1886,70,10,1956
Wesley Graves,['Finland'],Artist,1924,72,84,1996
Brianna Carson,['Libyan Arab Jamahiriya'],Artist,1880,74,63,1954
Bianca Young,"['Hong Kong', 'Japan']",Artist,1883,17,22,1900
Sarah Hernandez,['Burundi'],Teacher,1900,5,76,1905
Wendy Wilson,['British Indian Ocean Territory (Chagos Archipelago)'],Politician,1902,71,22,1973
Tamara Martinez,['Jersey'],Artist,1908,65,84,1973
Samuel Neal,"['Saint Vincent and the Grenadines', 'Northern Mariana Islands']",Politician,1909,77,89,1986
Kevin Anderson,"['Malaysia', 'Sierra Leone']",Athlete,1872,79,14,1951
Tammy Ramos,['Equatorial Guinea'],Athlete,1874,63,6,1937
Shane Brown,"['Papua New Guinea', 'Zimbabwe']",Artist,1883,46,29,1929
Robin Simpson,['Cameroon'],Politician,1873,5,33,1878
Tyler Thompson,['Canada'],Researcher,1885,30,39,1915
Penny Hale,['Trinidad and Tobago'],Artist,1891,64,23,1955
Benjamin Hutchinson,"['Kuwait', 'Tonga']",Artist,1883,54,40,1937
Adam Ross,['Burundi'],Politician,1901,80,53,1981
Christopher Kaiser,['Botswana'],Athlete,1900,50,13,1950
Cassandra Briggs,['Guatemala'],Artist,1916,31,59,1947
Reginald Houston,"['Norfolk Island', 'Andorra']",Artist,1905,38,70,1943
Brandon Delgado,"['Morocco', 'Liechtenstein']",Athlete,1871,18,8,1889
Madeline Taylor,['Germany'],Artist,1890,60,61,1950
Melody Mcintyre,['Lithuania'],Artist,1871,38,83,1909
Timothy Barr,['Nauru'],Artist,1898,74,87,1972
Mark Flores,['Saint Martin'],Artist,1913,59,80,1972
Kevin Garner,"['Malaysia', 'Trinidad and Tobago']",Artist,1882,36,40,1918
Chase Russell,['Equatorial Guinea'],Artist,1906,52,6,1958
Katherine Ortiz,['Luxembourg'],Artist,1908,40,25,1948
Felicia Bradley,"['Liberia', 'Palestinian Territory']",Physician,1874,42,57,1916
Melissa Davis,"['Tokelau', 'Panama']",Artist,1870,86,49,1956
Tammy Weaver,['Djibouti'],Artist,1886,83,53,1969
Monica Fox,['Lesotho'],Researcher,1907,82,85,1989
Brandy Perkins,"['Palestinian Territory', 'South Georgia and the South Sandwich Islands']",Politician,1902,38,16,1940
Brent Farrell,"['Saint Martin', 'Eritrea']",Artist,1883,62,70,1945
Ryan Rivera,['Taiwan'],Artist,1875,6,67,1881
Nicholas Cook,['Morocco'],Karateka,1893,16,45,1909
Breanna Thompson,"['Netherlands Antilles', 'Northern Mariana Islands']",Politician,1923,1,61,1924
Diane Rodriguez,"['Azerbaijan', 'Belgium']",Artist,1877,21,79,1898
Kimberly Thomas,"['Northern Mariana Islands', 'Grenada']",Military personnel,1879,47,43,1926
Michele Mahoney,['Colombia'],Artist,1911,85,61,1996
Ronald Davis,"['Philippines', 'Korea']",Athlete,1905,1,20,1906
Amanda Jones,"['Bermuda', 'Austria']",Researcher,1902,72,22,1974
Daniel Stone,"['Haiti', 'Jamaica']",Artist,1888,29,18,1917
John Williamson,"['Indonesia', 'Puerto Rico']",Artist,1912,82,23,1994
Michael Reed,"['Botswana', 'Chile']",Politician,1908,66,9,1974
Victor Williams,"['Samoa', 'Jersey']",Artist,1907,3,3,1910
Melissa Wood DDS,['United States Minor Outlying Islands'],Artist,1906,10,2,1916
Wendy May,"['French Southern Territories', 'Guinea-Bissau']",Politician,1879,23,29,1902
Chris Jensen,"['China', 'Dominican Republic']",Researcher,1887,69,4,1956
Karen Jackson,"['Guinea-Bissau', 'American Samoa']",Artist,1914,13,55,1927
Stacy Thomas,"['Uruguay', ""Lao People's Democratic Republic""]",Artist,1912,60,5,1972
Cameron Jordan,['Martinique'],Artist,1883,40,24,1923
George Webb,['Canada'],Politician,1874,16,40,1890
Tiffany Spencer,['China'],Businessperson,1909,54,78,1963
Carl Lawrence,['Cayman Islands'],Artist,1910,46,45,1956
Lauren Le,"['Trinidad and Tobago', 'Myanmar']",Artist,1873,12,89,1885
Kathleen Bartlett,"['Estonia', 'Ethiopia']",Artist,1909,23,34,1932
Cynthia Torres,['Saint Martin'],Artist,1877,83,81,1960
Kelsey Hooper,"['Kiribati', 'Cyprus']",Artist,1916,24,1,1940
Edward Howard,['Isle of Man'],Artist,1887,69,81,1956
William Wise,['Antarctica (the territory South of 60 deg S)'],Artist,1890,27,88,1917
Robert Hanson,"['Sweden', 'Guernsey']",Religious figure,1901,61,78,1962
Elizabeth Frank,"['Egypt', 'Gibraltar']",Samurai,1907,3,42,1910
Jay Jenkins,"['Micronesia', 'Egypt']",Politician,1906,48,2,1954
Timothy Moreno,['Sudan'],Artist,1914,22,75,1936
Brian Powers,"['United Kingdom', 'Puerto Rico']",Athlete,1905,59,7,1964
Dale Johnson,['British Indian Ocean Territory (Chagos Archipelago)'],Politician,1895,7,88,1902
Jonathan Williams,['Falkland Islands (Malvinas)'],Artist,1898,28,67,1926
Ricky Johnson,"['Mayotte', 'Seychelles']",Artist,1876,78,61,1954
Austin Lyons,['Solomon Islands'],Theater director,1891,18,77,1909
Anthony Morales,['South Africa'],Artist,1907,44,40,1951
Hayley Crawford,['Haiti'],Politician,1924,28,69,1952
Kayla Graham,"['Saint Martin', 'Palau']",Artist,1872,78,47,1950
Larry Sherman,"['Costa Rica', 'Pitcairn Islands']",Artist,1873,35,17,1908
Carrie Wagner,['Reunion'],Artist,1878,23,1,1901
Trevor Garcia,"['Mauritania', 'Cook Islands']",Military personnel,1916,6,36,1922
Tara Woods,"['Afghanistan', 'Hungary']",Politician,1879,37,77,1916
Miranda Melendez,"['Algeria', 'Slovenia']",Artist,1916,18,42,1934
Katrina Brown,"['Armenia', 'Belarus']",Artist,1879,33,5,1912
Emily Hughes,"['Iceland', 'Luxembourg']",Artist,1899,70,70,1969
Matthew Mccormick,"['China', 'Guadeloupe']",Politician,1921,25,12,1946
Dylan Thompson,['Pitcairn Islands'],Politician,1876,48,71,1924
Megan Deleon,"['Argentina', 'Vanuatu']",Athlete,1888,38,67,1926
Crystal Edwards,['Bahamas'],Motorcycle racer,1910,11,3,1921
Julie Martin,"['Jamaica', 'British Virgin Islands']",Artist,1907,11,69,1918
Elizabeth Diaz,['Latvia'],Artist,1914,19,8,1933
Diamond Griffin,"['Cook Islands', 'Saint Martin']",Politician,1886,26,41,1912
Denise Scott,"['Central African Republic', 'Guatemala']",Businessperson,1907,82,22,1989
Scott Hall,['Fiji'],Artist,1919,21,80,1940
Jacob Hancock,['Mali'],Artist,1923,65,69,1988
Joel Lynch,['Fiji'],Artist,1886,48,89,1934
Erica Martin,"['Guatemala', 'Cuba']",Artist,1914,87,3,2001
Karen Evans,['American Samoa'],Entrepreneur,1909,60,66,1969
Christopher Johnson,['Turks and Caicos Islands'],Journalist,1883,15,40,1898
Jo Hall,['Gambia'],Mountaineer,1876,48,16,1924
Philip Franco,"['Slovakia (Slovak Republic)', 'Australia']",Politician,1870,83,61,1953
Pamela Hale,['Mexico'],Lawyer,1899,37,13,1936
Craig Curtis,"['Russian Federation', 'Sierra Leone']",Artist,1902,77,20,1979
Christopher Gonzalez,['New Zealand'],Politician,1916,4,3,1920
Thomas Dominguez,['Tokelau'],Politician,1894,32,86,1926
Bradley Monroe,"['Palestinian Territory', 'Montenegro']",Politician,1883,76,52,1959
Norman Newton,"['Korea', 'Myanmar']",Athlete,1888,28,72,1916
Spencer Valdez,['Georgia'],Artist,1919,78,25,1997
William Freeman,['Portugal'],Politician,1881,36,44,1917
David Rogers,['Colombia'],Film producer,1878,11,32,1889
Debra Huang,['Kyrgyz Republic'],Artist,1903,27,59,1930
Michael Ruiz,['Egypt'],Politician,1896,86,18,1982
Megan Guzman,"['Cape Verde', 'Japan']",Artist,1875,56,43,1931
Ashley Schneider,"['Armenia', 'Guadeloupe']",Politician,1888,44,87,1932
Barbara Oconnell,"['Martinique', 'Costa Rica']",Politician,1904,25,77,1929
Tina Morrison,"['Montenegro', 'Pitcairn Islands']",Athlete,1909,82,27,1991
Christine Cardenas,['Morocco'],Artist,1923,32,84,1955
Karen Johnson,"['Ukraine', 'North Macedonia']",Artist,1921,80,11,2001
Caitlin Kelly,['Benin'],Artist,1921,71,41,1992
Laura Prince,"['Congo', 'Brazil']",Artist,1910,2,65,1912
Wesley Hill,"['Antigua and Barbuda', 'Solomon Islands']",Journalist,1907,68,79,1975
Cody Cook,"['Indonesia', 'Estonia']",Artist,1921,14,8,1935
Jennifer Vasquez,['South Africa'],Artist,1886,47,42,1933
Angel Sanchez,"['Seychelles', 'Somalia']",Politician,1912,81,32,1993
Monica Jennings,['Yemen'],Weightlifter,1878,35,20,1913
Heather Shannon,['Belgium'],Artist,1917,21,35,1938
Roberto Murphy,['Zambia'],Religious figure,1904,27,27,1931
George Howell,"['Albania', 'Ukraine']",Artist,1882,36,84,1918
Yvette Anderson,"['Lithuania', 'Syrian Arab Republic']",Politician,1894,63,46,1957
Jennifer Roy,"['Serbia', 'Togo']",Researcher,1904,45,41,1949
Matthew Stephens,['Tajikistan'],Politician,1897,24,17,1921
David Vasquez,"['Seychelles', 'Turkey']",Military personnel,1878,10,41,1888
Matthew Clark,"['United States Virgin Islands', 'Malta']",Researcher,1880,19,45,1899
Amanda Chapman,['Saint Vincent and the Grenadines'],Researcher,1880,58,58,1938
Michael Cobb,['Cape Verde'],Teacher,1882,30,9,1912
William Austin,['Bouvet Island (Bouvetoya)'],Artist,1899,25,70,1924
Amber Figueroa,['Korea'],Artist,1893,6,14,1899
Rebecca Gonzalez,"['Barbados', 'Bolivia']",Politician,1883,88,81,1971
Brian Wood,"['Russian Federation', 'Guam']",Researcher,1892,57,53,1949
Elizabeth Gallagher,['Bahamas'],Military personnel,1878,39,23,1917
Angel Young,['Botswana'],Artist,1908,81,60,1989
Christine Gray,['Switzerland'],Politician,1900,66,35,1966
Christopher Swanson,['Turkmenistan'],Resistance fighter; spy,1880,62,15,1942
Christopher Oliver,['Turkmenistan'],Politician,1886,60,57,1946
Natasha Morgan,"['Samoa', 'Egypt']",Artist,1900,4,28,1904
Margaret Robles,"['French Polynesia', 'Jersey']",Artist,1874,57,35,1931
Cathy Fitzgerald,"['Bulgaria', 'Bangladesh']",Politician,1902,24,74,1926
Joseph Rivera,"['Tajikistan', 'Congo']",Religious figure,1885,89,53,1974
Dr. Ann Kennedy DDS,"['Saint Kitts and Nevis', 'Philippines']",Researcher,1901,54,16,1955
Tara Shea,['Guinea-Bissau'],Politician,1906,18,78,1924
Vanessa Rivera,"['Reunion', 'Saint Martin']",Researcher,1881,24,9,1905
Victoria Robbins,['Iraq'],Artist,1913,19,80,1932
Jamie Murray,"['Bangladesh', 'Faroe Islands']",Artist,1888,38,70,1926
Danielle Medina,"['Canada', 'Saint Martin']",Artist,1918,70,8,1988
Marie Gross,['Nigeria'],Athlete,1915,74,38,1989
Donald Meyer,['Wallis and Futuna'],Politician,1872,56,66,1928
Emily Smith,['Falkland Islands (Malvinas)'],Researcher,1905,18,38,1923
Jeffrey Yang,['Paraguay'],Artist,1922,20,7,1942
Kathy Clayton,"['Singapore', 'Cuba']",Engineer,1886,66,9,1952
Robert Jefferson,"['Tonga', 'Algeria']",Pedagogue,1889,73,49,1962
Matthew Miller,"['Marshall Islands', 'Pitcairn Islands']",Terrorism; warlord; drug trafficker,1915,20,83,1935
John Marquez,"['Greenland', 'Uzbekistan']",Politician,1895,65,34,1960
Jeremy Lynch,"['Equatorial Guinea', 'Trinidad and Tobago']",Artist,1878,0,29,1878
Evelyn Hobbs,"['Greenland', 'Slovakia (Slovak Republic)']",Torturer,1899,43,1,1942
Mrs. Megan Guzman,['Algeria'],Politician,1894,8,32,1902
Daniel Schultz,"['Egypt', 'Tanzania']",Artist,1883,72,45,1955
Dale Perez,"['Slovenia', 'Gabon']",Lawyer,1889,50,73,1939
Shannon Green,['Somalia'],Athlete,1901,54,0,1955
Wendy Bradley,['Singapore'],Artist,1886,82,47,1968
Jenna Robinson,"['Belarus', ""Cote d'Ivoire""]",Explorer,1887,27,59,1914
Brenda Adams MD,"['Indonesia', 'Mozambique']",Artist,1921,12,17,1933
Jane King,"['British Virgin Islands', 'Chad']",Artist,1897,49,20,1946
Kenneth Reed,"['Svalbard & Jan Mayen Islands', 'Malta']",Military personnel,1882,85,37,1967
Katherine Obrien,['Angola'],Politician,1888,43,68,1931
David Bates,"['Cape Verde', 'Moldova']",Artist,1891,68,69,1959
James Pineda,['Costa Rica'],Athlete,1890,52,18,1942
Karen Paul,['Slovenia'],Businessperson,1878,75,55,1953
Angela Brown,['Syrian Arab Republic'],Artist,1905,50,35,1955
Andrea Campbell,"['Grenada', 'Mongolia']",Military personnel,1902,78,82,1980
Amber Jones,['Timor-Leste'],Artist,1923,10,14,1933
Jennifer Hurst,['Macao'],Artist,1922,30,50,1952
Stephanie Gonzales,"['Peru', 'Colombia']",Artist,1891,38,4,1929
Elizabeth Simon,"['Dominican Republic', ""Lao People's Democratic Republic""]",Researcher,1871,64,11,1935
Carrie Duffy,['Switzerland'],Military personnel,1888,89,23,1977
Jessica Herman,['Papua New Guinea'],Artist,1917,28,13,1945
Alexander Alvarez,"['Hungary', 'Singapore']",Artist,1872,78,24,1950
Yolanda Rios,['Christmas Island'],Athlete,1900,19,76,1919
John Davis,"['Guinea', 'Armenia']",Artist,1921,39,17,1960
Robert Ingram,['Burundi'],Artist,1911,56,19,1967
Geoffrey Fernandez,"['Turkey', 'Vietnam']",Artist,1870,14,67,1884
Sheryl Rogers,"['Madagascar', 'Svalbard & Jan Mayen Islands']",Artist,1887,46,75,1933
William Dixon,"['Saint Pierre and Miquelon', 'Moldova']",Artist,1897,86,84,1983
Shannon Davila,"['Montserrat', 'Pakistan']",Artist,1870,68,66,1938
Joseph Johnston,['Uzbekistan'],Military personnel,1899,80,5,1979
Stephanie Jones,"['Niue', 'Ireland']",Collector,1900,46,15,1946
Kelly Ruiz,['Liberia'],Artist,1900,54,65,1954
Kevin Davis,['Azerbaijan'],Politician,1883,43,19,1926
Rebecca Harris,"['Cayman Islands', 'Saint Kitts and Nevis']",Athlete,1879,81,24,1960
Ashley Esparza,"['Palestinian Territory', 'Korea']",Athlete,1900,57,88,1957
Elizabeth Brown,"['Suriname', 'Iran']",Military personnel,1894,46,52,1940
Robert Beard,['Argentina'],Journalist,1908,19,77,1927
Christopher Harrison,"['Singapore', 'Qatar']",Domestic worker; prostitute,1919,30,3,1949
Edward Jimenez,"['Seychelles', 'Armenia']",Gangster,1902,10,0,1912
Amanda Kelley,"['India', 'Cook Islands']",Military personnel,1893,75,27,1968
Ryan Martin,"['Sudan', 'Mexico']",Teacher,1871,76,37,1947
John Merritt,['Cocos (Keeling) Islands'],Politician,1879,46,79,1925
Mary Farmer,"['Sudan', 'Macao']",Artist,1884,54,46,1938
Sarah Taylor,"['Eritrea', 'Germany']",Businessperson,1921,73,64,1994
Dustin Miller,['Andorra'],Military personnel,1887,69,35,1956
Mary Watson,['Aruba'],Artist,1882,44,54,1926
Monica Hayes,"['El Salvador', 'Barbados']",Artist,1896,35,28,1931
Linda Valencia,"[""Cote d'Ivoire"", 'United Arab Emirates']",Artist,1890,48,71,1938
Linda Mitchell,"['Serbia', 'Maldives']",Journalist,1882,69,16,1951
Ricky Russell,"['Iran', 'Spain']",Researcher,1883,8,51,1891
Jeremy Smith,['Cambodia'],Artist,1912,14,16,1926
Shane Porter,['Tanzania'],Researcher,1902,6,79,1908
Samuel Brown,"['Monaco', 'Latvia']",Politician,1922,1,40,1923
Mallory Faulkner,"['Korea', 'Qatar']",Politician,1898,10,37,1908
Briana Powers,['Djibouti'],Researcher,1878,47,73,1925
Deborah Collins,['San Marino'],Artist,1870,51,1,1921
John Moore,['Sao Tome and Principe'],Artist,1901,14,3,1915
Leslie Ball,"['Saudi Arabia', 'Cameroon']",Businessperson,1896,62,84,1958
Karen Jordan,['Somalia'],Politician,1876,76,44,1952
David Bryant,"['Northern Mariana Islands', 'Sao Tome and Principe']",Military personnel,1870,20,77,1890
Michael Rios,"['Guadeloupe', 'Burundi']",Entrepreneur,1915,44,10,1959
Jacob Horton,['Kuwait'],Military personnel,1893,57,47,1950
Martha Fritz,['Luxembourg'],Artist,1885,13,71,1898
Jennifer Gray,['Tunisia'],Artist,1878,77,12,1955
Amanda Smith,['Turkmenistan'],Artist,1923,22,0,1945
Cindy Thomas,['Holy See (Vatican City State)'],Sultan,1906,40,44,1946
William Hardin,['Bhutan'],Military personnel,1896,20,66,1916
Amy Thompson,"['France', 'Portugal']",Artist,1895,29,44,1924
Leah Yang,"[""Lao People's Democratic Republic""]",Politician,1911,60,74,1971
Robin Robinson,"['Antigua and Barbuda', 'Nicaragua']",Engineer,1912,71,58,1983
Nichole Gonzales,"['Nepal', 'New Caledonia']",Artist,1872,26,30,1898
Michael Thompson,"['Sao Tome and Principe', 'Paraguay']",Athlete,1900,1,3,1901
Nancy Garza,['Qatar'],Judge,1924,87,3,2011
Sarah Dorsey,"['Tanzania', 'Indonesia']",Artist,1883,51,88,1934
Lauren Hobbs,['Iran'],Artist,1892,22,46,1914
Heather Cowan,"['Mauritania', 'Solomon Islands']",Artist,1895,71,55,1966
Steven Cain,"['Vanuatu', 'Benin']",Artist,1891,57,57,1948
Kristen Jones,['Libyan Arab Jamahiriya'],Athlete,1899,52,17,1951
Joseph Manning,"['Dominican Republic', 'Korea']",Artist,1903,63,63,1966
Tammy Spencer,"['Andorra', 'Cook Islands']",Artist,1900,10,32,1910
Leslie Miller,['Bermuda'],Artist,1923,33,64,1956
Joseph Arnold,"['Cape Verde', 'New Caledonia']",Artist,1877,46,6,1923
Michael Gonzalez,"['Kenya', 'Papua New Guinea']",Athlete,1904,78,77,1982
Carla Hughes,"['Saint Lucia', 'Spain']",Artist,1879,63,89,1942
Linda Young,"['Egypt', 'Mali']",Politician,1900,2,6,1902
Connor Brown,['United States of America'],Artist,1883,70,74,1953
Tommy Wilson,['Taiwan'],Artist,1894,17,86,1911
Roger Walker MD,"['Korea', 'Russian Federation']",Artist,1921,89,7,2010
Brian Guerra,['Vietnam'],Athlete,1902,22,42,1924
Justin Higgins,['Turks and Caicos Islands'],Motorcycle racer,1882,47,46,1929
David Price,['Falkland Islands (Malvinas)'],Athlete,1917,25,35,1942
Cassandra Rios,"['Afghanistan', 'Gabon']",Religious figure,1916,83,43,1999
Kimberly Williams,"['Marshall Islands', 'New Caledonia']",Film producer,1911,77,79,1988
Deborah Cannon,"['Netherlands', 'Hong Kong']",Politician,1885,18,42,1903
Michael Brown,['Tunisia'],Artist,1872,39,3,1911
Richard Gibson,['Guatemala'],Researcher,1870,57,45,1927
Michelle Fisher,"['Bhutan', 'Niue']",Artist,1894,76,48,1970
Madison Collins,"['Taiwan', 'Haiti']",Artist,1910,59,7,1969
Jennifer Lewis,['Germany'],Politician,1900,21,21,1921
Lisa Lee,['Netherlands'],Politician,1875,88,55,1963
Andrea Horton,['Greece'],Politician,1906,32,53,1938
Tyler Ray,"['Taiwan', 'Hong Kong']",Artist,1879,43,60,1922
Joel Moore,"['Equatorial Guinea', 'Namibia']",Artist,1916,85,12,2001
Zachary Adams,"['Thailand', 'Cameroon']",Researcher,1899,44,4,1943
Mr. Kenneth Mcgee II,"['Guyana', 'Mali']",Artist,1874,48,0,1922
Cody Alexander,"['Italy', 'Slovenia']",Artist,1906,12,16,1918
Justin Mejia,"['Russian Federation', 'Vanuatu']",Professional wrestler,1901,34,86,1935
Traci Porter,['Philippines'],Religious figure,1907,72,36,1979
Michele Love,['Comoros'],Serial killer,1913,79,62,1992
Jason Perez PhD,['Congo'],Artist,1924,10,18,1934
Frank Johnson,"['Korea', 'Senegal']",Politician,1921,5,54,1926
Eric Myers,"['Jamaica', 'Antarctica (the territory South of 60 deg S)']",Researcher,1918,69,13,1987
Jeremy Madden,"['United Arab Emirates', 'Angola']",Athlete,1908,54,69,1962
Denise Mosley,"['Heard Island and McDonald Islands', 'Anguilla']",Artist,1922,3,34,1925
Brittany Lee,"['Uruguay', 'Chile']",Administrator of the government,1920,51,50,1971
Eric Morris,"['Egypt', 'Aruba']",Researcher,1881,55,54,1936
Julie Martinez,['Romania'],Artist,1875,28,39,1903
Taylor Cole,['Liberia'],Artist,1911,68,53,1979
Howard Smith,['Namibia'],Artist,1923,43,28,1966
Jody Leonard,['Sri Lanka'],Artist,1909,40,54,1949
Christopher Benson,"['Congo', 'Myanmar']",Disc jockey,1922,37,59,1959
Joseph Tanner,['Guatemala'],Politician,1885,33,31,1918
Hannah Mcdowell,['Puerto Rico'],Athlete,1890,5,80,1895
Kevin Mills,"['Guyana', 'Saint Kitts and Nevis']",Psychiatrist; psychoanalyst,1887,74,43,1961
Andrew Fletcher,['Belgium'],Artist,1915,60,7,1975
Joshua Caldwell,['United States Virgin Islands'],Artist,1912,76,27,1988
Karen Rivas,"['Pakistan', 'Saint Vincent and the Grenadines']",Artist,1917,63,13,1980
Shelby Eaton,['Honduras'],Artist,1877,64,9,1941
William Smith,"['Rwanda', 'Bolivia']",Researcher,1870,83,49,1953
Michael Melton,"['Singapore', 'Morocco']",Artist,1906,71,29,1977
Frederick Perez,['Jersey'],Researcher,1881,68,32,1949
Thomas Mcgee,['Malta'],Politician,1921,45,54,1966
Eric Edwards,['Switzerland'],Artist,1872,32,87,1904
Anthony Cruz,"['Thailand', 'Antigua and Barbuda']",Artist,1904,64,4,1968
Michael Daniels,['Canada'],Politician,1917,76,84,1993
Courtney Summers,"['Fiji', 'Kyrgyz Republic']",Politician,1895,5,12,1900
Wendy Garner,['Montenegro'],Artist,1910,72,77,1982
James Hopkins,['Cambodia'],Artist,1878,6,3,1884
Kara Jordan,['Syrian Arab Republic'],Politician,1886,11,61,1897
Anthony Jones,"['Luxembourg', 'Vanuatu']",Researcher,1909,64,63,1973
Christina Swanson,"['Ghana', 'Andorra']",Politician,1886,44,27,1930
Christian Martin,['Singapore'],Mangaka,1921,73,82,1994
Barbara Walker,['Kiribati'],Military personnel,1878,80,89,1958
Cynthia Hanson,"['Gambia', 'Morocco']",Artist,1899,54,8,1953
Caitlin Hart,['Greenland'],Artist,1876,34,24,1910
Samuel Mcdaniel,"['Sri Lanka', 'Papua New Guinea']",Artist,1881,27,40,1908
Kelly Valenzuela,['Ukraine'],Politician,1917,76,83,1993
Lori Arnold,['French Guiana'],Resistance fighter; submariner; intelligence officer; naval officer,1893,5,83,1898
Kenneth Burns,['Montserrat'],Artist,1904,61,74,1965
Jared Young,"['Tajikistan', 'Palau']",Politician,1917,51,77,1968
Mrs. Christina Gonzalez,"['Malaysia', 'Belize']",Researcher,1894,17,79,1911
Dwayne Gonzalez,['British Virgin Islands'],Politician,1901,69,18,1970
Stacy Ramirez,['Liechtenstein'],Artist,1885,60,86,1945
Kristen Bright,['Libyan Arab Jamahiriya'],Researcher,1872,62,7,1934
Kristen Avila DVM,['Indonesia'],Researcher,1904,5,75,1909
Matthew Long,"['Anguilla', 'Uruguay']",Disc jockey; rapper; music producer,1878,45,1,1923
Marvin Bernard,"['Qatar', 'Honduras']",Artist,1882,73,36,1955
William Mathews,['Bouvet Island (Bouvetoya)'],Physician,1882,81,29,1963
Yvette Clark,"['Somalia', 'Puerto Rico']",Artist,1921,86,26,2007
John Alexander,"['Djibouti', 'Belgium']",Artist,1918,11,47,1929
Aaron Harvey,"['Canada', 'Sudan']",Artist,1873,79,38,1952
Sherry Smith,"['Niue', 'Honduras']",Athlete,1902,80,2,1982
Shaun Sullivan,"['Panama', 'Martinique']",Researcher,1903,63,61,1966
Rachel Sanders,['Northern Mariana Islands'],Researcher,1899,15,43,1914
Carrie Hall,"['Nigeria', 'Finland']",Artist,1887,17,56,1904
Carrie Brooks,"['Anguilla', 'Lithuania']",Artist,1874,86,85,1960
Rodney Scott Jr.,"['Madagascar', 'Heard Island and McDonald Islands']",Artist,1894,42,20,1936
Michael Ingram,"['United States of America', 'New Caledonia']",Artist,1872,41,1,1913
Pamela Long,['France'],Athlete,1879,57,18,1936
David Thompson,"['Malta', 'China']",Researcher,1870,46,69,1916
Ronald Brown,"['Reunion', 'Jordan']",Sovereign,1898,5,81,1903
Catherine Castillo,['Madagascar'],Artist,1913,40,38,1953
Christopher Garcia,"['Cocos (Keeling) Islands', 'Saint Pierre and Miquelon']",Politician,1920,2,41,1922
Richard Reyes,['North Macedonia'],Artist,1879,40,77,1919
Richard Cole,['Burundi'],Artist,1871,35,49,1906
Brett Spencer,['Taiwan'],Athlete,1898,64,64,1962
Brian Webster,['New Caledonia'],Artist,1883,30,18,1913
Brad Madden,"[""Cote d'Ivoire""]",Politician,1918,12,14,1930
Veronica Sparks,['French Polynesia'],Politician,1916,19,83,1935
Patrick Barajas,['Venezuela'],Artist,1912,33,87,1945
Diane Reed MD,"['Australia', 'Saint Lucia']",Military personnel,1880,26,62,1906
Nicholas Barrera,['Tokelau'],Politician,1923,14,9,1937
Melinda Mccullough,['Antarctica (the territory South of 60 deg S)'],Artist,1880,19,53,1899
Stacey Vega,"['Singapore', 'Costa Rica']",Politician,1916,55,63,1971
Roger Pruitt,"['Colombia', 'Isle of Man']",Artist,1923,38,32,1961
Mark Davis,"[""Cote d'Ivoire""]",Politician,1916,57,53,1973
Kayla Acevedo,['Congo'],Artist,1894,89,44,1983
Julie Ramirez,"['Argentina', 'Chad']",Artist,1883,26,29,1909
Steven Rich,"['South Africa', 'Burundi']",Farmer; resistance fighter,1887,30,19,1917
Patrick Williams MD,"['Cape Verde', 'Sao Tome and Principe']",Housekeeper,1895,31,82,1926
Donald Briggs,['Greenland'],Artist,1885,87,34,1972
Andrew Gomez,"['Andorra', 'Uzbekistan']",Artist,1910,87,66,1997
Justin Garcia,"['Guyana', 'Turks and Caicos Islands']",Artist,1912,71,82,1983
Paul Lee,"['Romania', 'Afghanistan']",Politician,1923,51,2,1974
Jordan Moore,"['Saudi Arabia', 'Uzbekistan']",Artist,1876,83,38,1959
Carly Hayes,"['Indonesia', 'Macao']",Researcher,1921,66,24,1987
Shawn Taylor,"['New Zealand', 'Congo']",Artist,1914,14,83,1928
Sheila Williams,['Western Sahara'],Politician,1877,19,85,1896
Sharon Parsons,['Slovenia'],Artist,1877,52,84,1929
Jacqueline Ellis,"['French Guiana', 'Micronesia']",Artist,1924,74,80,1998
Derek Cruz,"['Dominican Republic', 'Angola']",Artist,1889,41,23,1930
Steven Washington,['Christmas Island'],Researcher,1911,0,18,1911
Kristina Gordon,['Egypt'],Artist,1889,6,72,1895
Mary Mendez,['Gabon'],Nurse; serial killer,1901,46,82,1947
Curtis Lopez,"['Saint Martin', 'Denmark']",Politician,1921,81,85,2002
Daniel Dominguez PhD,['Marshall Islands'],Artist,1871,3,32,1874
James Haynes,"['Micronesia', 'Solomon Islands']",Military personnel,1874,69,36,1943
Jim Robertson,['Korea'],Artist,1881,72,79,1953
Blake Scott,['Uganda'],Artist,1915,71,86,1986
William Cervantes,"['South Georgia and the South Sandwich Islands', 'Philippines']",Politician,1883,14,78,1897
Jillian Watson,['Cameroon'],Researcher,1871,9,29,1880
Matthew Clark,['Congo'],Professional wrestler,1900,27,41,1927
Aaron Schneider,"['Estonia', 'Mongolia']",Researcher,1916,45,81,1961
Whitney Collins,"['United States of America', 'Saint Pierre and Miquelon']",Artist,1912,28,33,1940
Tyrone Russell,"['Bosnia and Herzegovina', 'Cayman Islands']",Politician,1887,61,56,1948
Nathaniel Ramirez,"['Norway', 'Trinidad and Tobago']",Artist,1915,33,12,1948
David Callahan,['Panama'],Athlete,1908,14,3,1922
Amanda Stanton,"['Portugal', 'Lesotho']",Artist,1897,0,33,1897
Sarah Smith,['Bhutan'],Artist,1913,57,82,1970
Michael Miller,['Isle of Man'],Researcher,1897,34,73,1931
Dr. Aaron Collier,"['South Africa', 'Sao Tome and Principe']",Artist,1887,30,33,1917
Peter Pierce,['Turks and Caicos Islands'],Artist,1892,36,5,1928
Alicia Thomas,['Chad'],Military personnel,1921,29,41,1950
Danielle Schneider,"['Niue', 'Belarus']",Aristocrat,1908,89,46,1997
Kyle Walsh,['Martinique'],Artist,1913,7,45,1920
William Sloan,"['Iraq', 'Chile']",Spy,1912,29,0,1941
Annette King,['Sri Lanka'],Artist,1876,35,88,1911
Ryan Chung,['Guyana'],Artist,1922,84,5,2006
Karen Powers,"['Guinea-Bissau', 'Bolivia']",Artist,1902,42,28,1944
Rachel Lee,['Saint Martin'],Politician,1880,13,56,1893
Rebecca Graves,"['Ecuador', 'Anguilla']",Artist,1877,24,62,1901
Sarah Sanchez,"['Taiwan', 'Mali']",Artist,1901,76,2,1977
Cristina Sandoval,"['Faroe Islands', 'Belarus']",Artist,1899,2,73,1901
John Solomon,['Brunei Darussalam'],Artist,1889,45,66,1934
Nicole Reed,"['Ukraine', 'Brunei Darussalam']",Artist,1903,89,3,1992
Troy Perkins,['Greece'],Athlete,1877,8,50,1885
Donald Mccullough,['Greece'],Military personnel,1882,1,8,1883
Robert Greene,['Turks and Caicos Islands'],Artist,1893,74,79,1967
Sheryl Ward,['Faroe Islands'],Artist,1904,80,66,1984
April Howard,"['Liechtenstein', 'Guadeloupe']",Artist,1906,48,68,1954
Shelia Wright,['Qatar'],Artist,1891,70,20,1961
Donald Fischer,['Lebanon'],Artist,1892,74,17,1966
Brian Young,['Korea'],Artist,1920,70,64,1990
John Campbell,['South Africa'],Artist,1895,44,41,1939
Kimberly Hanson,"['Switzerland', 'Guyana']",Military personnel,1901,33,19,1934
Philip Wilson,['Montserrat'],Athlete,1921,36,38,1957
Jennifer Reid,"['China', 'Mayotte']",Military personnel,1871,32,76,1903
Samantha Alvarado,['Finland'],Artist,1899,4,2,1903
Barbara Roth,['Israel'],Artist,1900,86,55,1986
Cindy Dyer,"['Bouvet Island (Bouvetoya)', 'Denmark']",Artist,1916,72,2,1988
Mrs. Marie Austin MD,"['Greece', 'Solomon Islands']",Artist,1896,39,24,1935
Carrie Fry,"['Bouvet Island (Bouvetoya)', 'Greenland']",Researcher,1922,34,79,1956
Dr. Albert Bryan,"['South Georgia and the South Sandwich Islands', 'Albania']",Artist,1882,29,8,1911
Michael Smith,"['Uganda', 'Guam']",Art director,1905,2,18,1907
Tammy Craig,"['Kuwait', 'Liechtenstein']",Artist,1920,59,36,1979
Pamela Little,"['Oman', 'Mauritius']",Artist,1900,59,72,1959
Michael Gomez,['United States of America'],Revolutionary; terrorist,1898,36,56,1934
Katie Rodriguez,"['Nigeria', 'Zimbabwe']",Politician,1892,21,15,1913
Charles Gomez,"['Sao Tome and Principe', 'Chad']",Artist,1887,68,26,1955
Daryl Macias,['Poland'],Politician,1875,52,30,1927
John Reynolds,['Montenegro'],Artist,1900,9,31,1909
Alexa Ball,"['Belarus', 'Nicaragua']",Artist,1889,4,87,1893
Jeffrey Wilson,"['Suriname', 'Afghanistan']",Artist,1922,64,60,1986
Jennifer Robinson,['Jersey'],Impostor,1912,13,35,1925
Carol Rodriguez,"['Togo', 'Morocco']",Artist,1893,62,76,1955
Ashley Hughes,['Holy See (Vatican City State)'],Artist,1920,3,50,1923
Jeremiah Ramos,"['Congo', 'Ireland']",Athlete,1906,66,17,1972
James Rogers,['Kazakhstan'],Artist,1893,11,12,1904
Kevin Montgomery,['Cyprus'],Artist,1900,8,35,1908
William Guerrero,['Liberia'],Artist,1916,67,34,1983
Thomas Smith,['Svalbard & Jan Mayen Islands'],Researcher,1887,48,53,1935
Leslie Jones,"['Slovakia (Slovak Republic)', 'Eritrea']",Artist,1905,53,28,1958
Jacob Stevenson,['San Marino'],Nurse; torturer,1909,31,75,1940
Jonathan Berry,['Turks and Caicos Islands'],Teacher,1901,6,11,1907
Ronald Boyd,"['Montserrat', 'Jordan']",Politician,1920,0,15,1920
Carrie Ferguson,['Comoros'],Worker; spree killer,1870,88,78,1958
Devin Bates,"['Cayman Islands', 'British Virgin Islands']",Samurai,1905,53,6,1958
Chelsea Walker,['Italy'],Artist,1906,13,12,1919
David Walker,"['Dominican Republic', 'Antigua and Barbuda']",Artist,1899,55,58,1954
Sophia Pearson,['Hungary'],Artist,1899,42,59,1941
Ashley Rocha,['Turks and Caicos Islands'],Artist,1902,28,64,1930
Teresa Walker,['Austria'],Politician,1890,19,58,1909
Lori Ryan,['Pitcairn Islands'],Athlete,1878,21,24,1899
Amy Freeman,['Sri Lanka'],Artist,1921,36,1,1957
Nancy Andrews,"['Saint Barthelemy', 'Samoa']",Serial killer,1873,52,53,1925
Michelle Romero,['Japan'],Artist,1904,18,72,1922
Melissa Craig,['North Macedonia'],Artist,1897,20,69,1917
John Mccormick,['Trinidad and Tobago'],Artist,1924,16,76,1940
Amanda Morris,['Guinea'],Researcher,1894,0,68,1894
Veronica Price,['Timor-Leste'],Terrorism; terrorist,1897,75,70,1972
Regina Osborn,"['Niue', 'Austria']",Artist,1919,38,68,1957
Laura Larson,"[""Cote d'Ivoire""]",Artist,1876,27,32,1903
David Pittman,['Andorra'],Artist,1880,41,62,1921
Kathryn Neal,"['Argentina', 'Seychelles']",Artist,1884,9,1,1893
Isaac West,"['Cameroon', 'New Caledonia']",Activist,1918,39,74,1957
George Smith,['Poland'],Police officer; lumberjack,1875,49,33,1924
Alan Franklin,"['Brunei Darussalam', 'Colombia']",Artist,1921,49,11,1970
Tiffany Ellison,['Liechtenstein'],Politician,1891,87,17,1978
Jodi Ramirez,['Germany'],Artist,1885,50,49,1935
Jim Bennett,"['United Kingdom', 'Tokelau']",Artist,1914,27,63,1941
Tyler Hess,"['Kenya', 'United Arab Emirates']",Artist,1918,14,25,1932
Douglas Ward,"['Morocco', 'Kazakhstan']",Politician,1918,46,72,1964
Jose Serrano,['Comoros'],Religious figure,1890,74,78,1964
Andrea Walls,['Portugal'],Geodesist; explorer,1912,44,76,1956
David Flores,['Peru'],Artist,1904,14,34,1918
Donald Ortiz,['San Marino'],Weightlifter,1892,62,46,1954
Lisa Martin,"['Antigua and Barbuda', 'Lesotho']",Artist,1878,4,84,1882
Mary Ward,['Trinidad and Tobago'],Artist,1913,76,67,1989
Alexis Murphy,['Heard Island and McDonald Islands'],Artist,1901,23,2,1924
Elaine Byrd,"['Saint Barthelemy', 'Korea']",Artist,1902,66,2,1968
Donna Fleming,"['Nigeria', 'Guernsey']",Artist,1909,72,72,1981
Natalie Lara,['Macao'],Researcher,1923,39,64,1962
Jacqueline Turner,['Somalia'],Artist,1883,56,34,1939
Bruce Baker,"['Estonia', 'Cape Verde']",Artist,1906,49,20,1955
Tony Martinez,"['Myanmar', 'Paraguay']",Artist,1877,50,25,1927
Matthew Harrison,"['Ghana', 'Sao Tome and Principe']",Researcher,1899,59,80,1958
Ms. Sherri Smith,"['Tokelau', 'Chad']",Physician,1887,83,74,1970
Frank Dean,['Jordan'],Artist,1881,5,76,1886
Sharon Lucas,['Iraq'],Artist,1923,18,71,1941
Keith Jackson,"['Tanzania', 'Uzbekistan']",Athlete,1906,14,4,1920
Keith Daniels,"['Cameroon', 'Georgia']",Religious figure,1912,28,61,1940
Steven Watson,['United Arab Emirates'],Politician,1910,16,85,1926
Cameron Richards,"['South Africa', 'Belize']",Researcher,1901,56,45,1957
Dylan Evans,['Gabon'],Military personnel,1905,70,73,1975
John Mendoza,['Sao Tome and Principe'],Teacher,1909,16,70,1925
Richard Miller,"['Venezuela', 'Saint Vincent and the Grenadines']",Artist,1923,61,49,1984
Sabrina Mitchell,['Pitcairn Islands'],Artist,1874,40,78,1914
Jason Anthony,"['United Arab Emirates', 'South Africa']",Artist,1909,35,12,1944
Kevin Thomas,['Oman'],Artist,1922,34,6,1956
Ashley Fields,['Germany'],Artist,1882,55,24,1937
Nathan Mcdaniel,['Saint Lucia'],Athlete,1899,60,78,1959
Nancy Davis,"['Albania', 'Montserrat']",Artist,1895,1,43,1896
Shawn Hall,"['Saint Barthelemy', 'Mexico']",Artist,1875,52,70,1927
Dennis Grant,['Kyrgyz Republic'],Politician,1913,63,89,1976
Veronica Aguilar,['Czech Republic'],Artist,1919,49,81,1968
Mike Garza,"['Guadeloupe', 'Kyrgyz Republic']",Physician,1909,63,77,1972
Samantha Thompson,"['Morocco', 'Bulgaria']",Artist,1906,44,73,1950
Meghan Mccormick,['Zambia'],Athlete,1893,11,81,1904
Steven Bryan,"['Malta', 'Cuba']",Sailor,1895,82,56,1977
Sally Evans,"['Ghana', 'Ghana']",Heilpraktiker,1912,25,87,1937
Laura Hatfield,['Northern Mariana Islands'],Researcher,1903,0,53,1903
Samantha Meyer,['Togo'],Politician,1903,68,85,1971
Sabrina Wright DDS,['Nicaragua'],Artist,1907,2,39,1909
Kevin Bush,"['Lesotho', 'Indonesia']",Suffragette; suffragist; feminist,1914,25,47,1939
Raymond Stone,['Netherlands Antilles'],Politician,1873,4,84,1877
Jennifer Edwards,['Eritrea'],Artist,1877,48,3,1925
Steve George,['Central African Republic'],Entrepreneur,1889,52,72,1941
Lucas Ross,['Guadeloupe'],Artist,1901,63,44,1964
Kristen Smith,['Ecuador'],Artist,1889,33,32,1922
John Wiley,"['Djibouti', 'Svalbard & Jan Mayen Islands']",Artist,1912,84,46,1996
Melissa Jimenez,"['Greece', 'New Zealand']",Artist,1886,0,26,1886
Kristopher Clark,"['Puerto Rico', 'Congo']",Artist,1924,18,28,1942
Michael May,['Guam'],Politician,1870,11,86,1881
Debra Mosley,['Barbados'],Researcher,1903,33,15,1936
Kenneth Simmons,"['Bosnia and Herzegovina', 'Costa Rica']",Artist,1880,9,13,1889
Samantha Carter,['Djibouti'],Engineer,1901,6,50,1907
Michelle Rojas,"['Reunion', 'Saudi Arabia']",Artist,1898,32,55,1930
Douglas Johnson,"['Algeria', 'Italy']",Artist,1879,41,65,1920
Joseph Turner,"['Lithuania', 'Bangladesh']",Athlete,1889,63,69,1952
Jenny Larson,"['Sao Tome and Principe', 'Western Sahara']",Alpine skier,1877,20,49,1897
Randy Wells,"['Northern Mariana Islands', 'Saint Pierre and Miquelon']",Artist,1902,69,6,1971
Scott Molina,"['French Polynesia', 'Ghana']",Chairperson; organizational founder,1921,7,82,1928
Jacqueline Hudson,['Burkina Faso'],Politician,1907,8,27,1915
Wanda Perry,"['Brunei Darussalam', 'Austria']",Artist,1922,30,34,1952
Lindsey Hawkins,['Mauritius'],Artist,1874,42,89,1916
Amanda Lopez,"['Venezuela', 'Liechtenstein']",Athlete,1920,52,71,1972
Gloria Williams,['Argentina'],Religious figure,1873,66,80,1939
Terry Madden,['Turks and Caicos Islands'],Artist,1906,48,59,1954
Stephen Padilla,['Chad'],Politician,1908,14,41,1922
Geoffrey Rodriguez,['Guam'],Artist,1918,55,20,1973
William Phillips,['Korea'],Politician,1898,33,66,1931
Willie Porter,"['Italy', 'Netherlands Antilles']",Researcher,1881,27,85,1908
Peter Williams,"['Gibraltar', 'Malawi']",Politician,1903,42,22,1945
Michael Crawford,"['Saint Martin', 'China']",Politician,1872,43,36,1915
Steve Alexander,['Mauritius'],Politician,1904,11,47,1915
Michael Hardin,['Taiwan'],Athlete,1923,34,45,1957
Anthony Humphrey,"['Serbia', 'Peru']",Military personnel,1874,49,45,1923
Thomas Esparza,"['Dominican Republic', 'Luxembourg']",Politician,1870,28,43,1898
Tiffany Harmon,"['Iraq', 'Iceland']",Military personnel,1919,25,44,1944
Jennifer Baxter,['Lebanon'],Researcher,1914,35,10,1949
Katherine Cantu,['Marshall Islands'],Artist,1897,8,89,1905
Riley Gardner,"['Mozambique', 'Ecuador']",Alpine skier,1886,3,12,1889
Matthew Hamilton,['Argentina'],Athlete,1880,60,29,1940
Erin Reed,['Kuwait'],Fighter pilot,1871,81,39,1952
Jennifer Burch,"['Colombia', 'Bulgaria']",Artist,1888,72,89,1960
Holly Brooks,['Taiwan'],Jeweller; fashion designer; model,1921,26,5,1947
Michael Rogers,"['Senegal', 'Belarus']",Engineer,1915,53,15,1968
Shannon Parker,"['Oman', 'Bahrain']",Military personnel,1916,76,47,1992
Emily Chaney,['Kenya'],Politician,1908,2,85,1910
Stephanie Williams,"[""Cote d'Ivoire""]",Researcher,1871,45,8,1916
Nathan Farrell,"['Christmas Island', 'Palau']",Athlete,1892,59,3,1951
Philip Rodgers,['Grenada'],Artist,1896,70,35,1966
Shawn Crawford,"['Fiji', 'Falkland Islands (Malvinas)']",Businessperson,1882,52,24,1934
Jesse Kelley,['Sri Lanka'],Cowboy,1882,54,46,1936
Taylor Melton,"['Belize', 'Cape Verde']",Researcher,1873,81,49,1954
Charles Hernandez,['Tuvalu'],Researcher,1883,85,86,1968
Amanda Harris,"['Honduras', 'Norfolk Island']",Politician,1886,49,45,1935
Bryan Mercado,"['Jordan', 'Tanzania']",Religious figure,1912,54,61,1966
Tyler Smith,"['Montenegro', 'Bermuda']",Politician,1881,79,5,1960
Cody Ellis,"['Brazil', 'Libyan Arab Jamahiriya']",Artist,1884,74,1,1958
Patricia Flores,"['Pitcairn Islands', 'Trinidad and Tobago']",Cook,1920,83,84,2003
Rachel Hudson,"['Panama', 'Finland']",Researcher,1904,46,84,1950
Andrea Adams,['Saint Barthelemy'],Businessperson,1918,62,44,1980
Frederick Baker,['Bangladesh'],Military personnel,1914,59,56,1973
Rebecca Guerra,['Philippines'],Politician,1874,39,3,1913
Stephen Manning,"['Guinea-Bissau', 'Denmark']",Military personnel,1923,27,71,1950
Kathleen Gonzalez,"['Antarctica (the territory South of 60 deg S)', 'Samoa']",Researcher,1923,14,6,1937
Thomas Valenzuela,"['Svalbard & Jan Mayen Islands', 'Mozambique']",Aristocrat,1904,67,31,1971
Lee Ramirez,['Syrian Arab Republic'],Artist,1921,72,82,1993
Lisa Campbell,['Mauritius'],Businessperson,1923,12,28,1935
Jennifer Cox,"['Vanuatu', 'Sao Tome and Principe']",Athlete,1894,60,20,1954
Laura Wilson,"['Hungary', 'Samoa']",Businessperson,1883,80,18,1963
Jennifer Miller,"['New Caledonia', 'American Samoa']",Athlete,1903,35,72,1938
Michael Mason,"['Antarctica (the territory South of 60 deg S)', 'Reunion']",Suffragette; rhetorician; suffragist,1902,18,21,1920
Maria Escobar,['Antigua and Barbuda'],Researcher,1871,76,47,1947
Lisa Adams,['Reunion'],Politician,1878,87,14,1965
Samuel Humphrey,"['Guatemala', 'Niger']",Artist,1910,14,2,1924
Jason Duncan,['Syrian Arab Republic'],Artist,1873,56,83,1929
Meghan Farrell,['Bouvet Island (Bouvetoya)'],Artist,1887,28,45,1915
Phillip Rodriguez,['San Marino'],Artist,1911,64,50,1975
Cheryl Price,['Kyrgyz Republic'],Artist,1893,18,42,1911
Amber Garcia,['Guernsey'],Artist,1901,86,47,1987
Maria Nolan,['Mexico'],Artist,1874,69,37,1943
Marcus Mcdonald,['Saint Helena'],Artist,1879,77,45,1956
Cassandra Lopez,['Isle of Man'],Lawyer,1893,80,56,1973
Emily Hall DDS,"['Cocos (Keeling) Islands', 'Anguilla']",Artist,1882,25,4,1907
Joseph Jones,"['Maldives', 'Cameroon']",Artist,1882,86,12,1968
Cathy Wells,['Guam'],Politician,1883,0,19,1883
Cory Knox,['Faroe Islands'],Artist,1876,38,84,1914
Yesenia Franklin,"['Cook Islands', 'Iraq']",Artist,1919,5,39,1924
Christopher Allen,['Macao'],Politician,1902,28,28,1930
Dr. Micheal Johnson,"['San Marino', 'Northern Mariana Islands']",Artist,1918,56,40,1974
Nicholas Camacho,['South Georgia and the South Sandwich Islands'],Politician,1894,0,67,1894
Samuel Gonzalez,"['Liechtenstein', 'Singapore']",Journalist,1896,81,17,1977
Mark Lee,"['Anguilla', 'Albania']",Politician,1876,89,0,1965
Robert Martinez,"['Samoa', 'Cape Verde']",Artist,1873,88,65,1961
James Ashley,"['Israel', 'Timor-Leste']",Athlete,1919,5,34,1924
Ryan Warren,['Nicaragua'],Artist,1921,71,46,1992
Stefanie Whitney,"['Cape Verde', 'Nepal']",Politician,1919,14,7,1933
Harold Armstrong,"['United States Minor Outlying Islands', 'Uruguay']",Researcher,1904,44,9,1948
Johnny James,"['Afghanistan', 'Grenada']",Researcher,1891,56,55,1947
Ariel Curtis,"['Palestinian Territory', 'Holy See (Vatican City State)']",Politician,1879,48,76,1927
Ivan Roberts,['Mongolia'],Artist,1917,15,35,1932
Elizabeth Kirby,['Djibouti'],Athlete,1898,36,55,1934
Todd Thomas,"['Myanmar', 'Belarus']",Artist,1895,29,28,1924
Anne Vaughn,"['Finland', 'Turkey']",Athlete,1920,55,8,1975
Teresa Ayala,"['Israel', 'Serbia']",Artist,1888,23,78,1911
James Weber,"['Fiji', 'Kazakhstan']",Researcher,1901,21,3,1922
Amanda Graham,"['Mozambique', 'Hong Kong']",Researcher,1901,38,13,1939
Nancy Davis,"['Paraguay', 'Libyan Arab Jamahiriya']",Artist,1923,7,11,1930
Thomas Carpenter,['Greenland'],Researcher,1892,87,3,1979
Brandon Smith,['Sierra Leone'],Resistance fighter; interpreter,1890,87,45,1977
Jonathan Vargas,['Ireland'],Artist,1895,68,83,1963
Thomas Peterson,['Spain'],Artist,1911,46,8,1957
Miss Elizabeth Eaton,"['Iraq', 'Antarctica (the territory South of 60 deg S)']",Artist,1923,60,60,1983
Jared Lyons,['Brazil'],Artist,1924,40,81,1964
Lori Rangel,['Belize'],Artist,1881,48,15,1929
Mark Humphrey,['Cameroon'],Religious figure,1887,36,84,1923
Justin Smith,['Nigeria'],Artist,1872,58,19,1930
Jason Powers,['Slovenia'],Psychologist; anthropologist,1885,25,39,1910
Eugene Young,"['Uganda', 'French Guiana']",Politician,1917,76,34,1993
Sean Carroll,['Bermuda'],Artist,1903,27,3,1930
Nathan Delgado,['Sudan'],Artist,1913,56,44,1969
Anthony Scott,['Tonga'],Religious figure,1915,73,75,1988
Tracy Harmon,"['Saint Martin', 'Ecuador']",Entrepreneur,1879,43,74,1922
Taylor Payne,['Denmark'],Athlete,1906,22,4,1928
Nancy Stewart,['Iceland'],Artist,1904,26,21,1930
Michael Mccoy,['China'],Artist,1910,88,69,1998
Robert Williams,['Israel'],Artist,1915,17,4,1932
Kelly Chandler,['Togo'],Politician,1873,32,81,1905
Nathan Baker,"['Eritrea', 'Singapore']",Artist,1919,75,71,1994
Alec Hinton,"['Ghana', 'Saudi Arabia']",Artist,1889,87,26,1976
Nathan Zimmerman,"['Nigeria', 'Fiji']",Politician,1892,21,73,1913
Erin Mclean,['Russian Federation'],Politician,1871,46,4,1917
Wendy Farmer,"['Croatia', 'Guatemala']",Artist,1875,67,7,1942
Ashley Chung,"['Uzbekistan', 'Tunisia']",Artist,1915,27,78,1942
Tiffany Trujillo,"['Iraq', 'Tokelau']",Military personnel,1923,22,55,1945
Karen Harper,['Saint Kitts and Nevis'],Artist,1890,85,63,1975
Michael Jones,['Gibraltar'],Politician,1909,63,13,1972
Taylor Mueller,['Oman'],Serial killer; manual worker,1882,65,65,1947
Austin Yang,"['Gibraltar', 'Chad']",Athlete,1910,73,26,1983
Christopher Spears,['Cuba'],Politician,1915,32,32,1947
Dustin Moon,"['Albania', 'Palestinian Territory']",Researcher,1913,66,86,1979
James Garcia,"['Lithuania', 'Benin']",Artist,1885,16,33,1901
Amy Wood,"['Albania', 'Solomon Islands']",Artist,1919,16,80,1935
Crystal Murphy,['San Marino'],Politician,1897,45,60,1942
Rachel Garcia,['Chad'],Athlete,1902,43,35,1945
Brandy Meyers,['Guyana'],Drawer; gallerist,1875,1,69,1876
Latoya Young,"['Faroe Islands', 'Mali']",Artist,1923,48,16,1971
Mr. James Maldonado,['Qatar'],Athlete,1871,54,7,1925
Aaron Daniels,['Guam'],Religious figure,1924,11,75,1935
Donna Riley,['Yemen'],Artist,1890,18,33,1908
Parker Woodard,['Luxembourg'],Artist,1923,27,58,1950
Thomas Miller,"['Saint Barthelemy', 'Saint Helena']",Secretary,1923,72,71,1995
Andre Simmons,"['Mali', 'New Zealand']",Artist,1884,7,74,1891
Michael Burch,['Western Sahara'],Politician,1921,43,1,1964
Ashley Warren,['Holy See (Vatican City State)'],Artist,1920,23,48,1943
Terry Cline,['Madagascar'],Artist,1870,57,3,1927
Melissa Barber,['Vietnam'],Artist,1888,74,5,1962
Anthony Gregory,['Ethiopia'],Researcher,1919,57,89,1976
Joshua Morrow,"['Lithuania', 'British Indian Ocean Territory (Chagos Archipelago)']",Artist,1924,6,65,1930
Yolanda Davis,['Australia'],Religious figure,1872,81,70,1953
Johnathan Martinez,"['Togo', 'Tanzania']",Judge,1894,42,81,1936
Dr. Lori Wood,"['French Polynesia', 'Saint Martin']",Sovereign,1917,49,68,1966
Marcus Vazquez,"['Netherlands Antilles', 'Equatorial Guinea']",Artist,1904,69,7,1973
Luis Williams,['Martinique'],Artist,1896,50,85,1946
Abigail Kirby,['Burkina Faso'],Cook; restaurateur; chef,1912,26,2,1938
Ashley Elliott,"['Malawi', 'Poland']",Engineer,1874,22,51,1896
Roy Estrada,['Rwanda'],Artist,1905,9,86,1914
Jordan Snyder,['Svalbard & Jan Mayen Islands'],Politician,1921,62,7,1983
Darlene Leblanc,"['Liberia', 'Djibouti']",Politician,1917,30,55,1947
Michael Jackson,['Kiribati'],Athlete,1880,23,39,1903
Amanda Guzman,['Spain'],Artist,1885,28,6,1913
Laurie Garcia,['Senegal'],Artist,1911,78,3,1989
Courtney Lowery MD,['Saint Kitts and Nevis'],Monarch,1898,69,84,1967
Cory Holder,['Oman'],Artist,1879,8,78,1887
Brian Thomas,['Philippines'],Artist,1913,0,36,1913
Melissa Moore,"['Svalbard & Jan Mayen Islands', 'United States Minor Outlying Islands']",Artist,1881,56,84,1937
Casey Martinez,"['Maldives', 'Tunisia']",Physiologist; ethologist,1883,48,56,1931
Veronica Bell,['Tuvalu'],Artist,1871,10,41,1881
Christopher Sims,"['Rwanda', 'Peru']",Journalist,1870,89,76,1959
Rodney Li,"['Chile', 'Portugal']",Athlete,1903,25,48,1928
Stacy Hart,['Malaysia'],Artist,1898,76,19,1974
Karen Conway,['Swaziland'],Politician,1918,60,38,1978
Wyatt Perry,"['Niue', 'Nepal']",Artist,1891,88,0,1979
Cody Williams,['Armenia'],Artist,1894,20,2,1914
Renee Johnson,"['Somalia', 'Portugal']",Politician,1900,37,57,1937
Stephen Collins,"['Kiribati', 'Faroe Islands']",Journalist,1915,81,60,1996
Dr. Janet White MD,"['Nigeria', 'Anguilla']",Artist,1888,36,80,1924
Larry Harris,['Benin'],Artist,1891,0,60,1891
Amanda Johnson,"['Niue', 'Poland']",Artist,1896,63,2,1959
Michele Mccormick,['Colombia'],Explorer,1909,24,64,1933
Anthony Stewart,['Saint Helena'],Military personnel,1918,65,49,1983
Linda Ruiz,['Kenya'],Artist,1922,67,1,1989
Tony Evans,['Gabon'],Athlete,1906,53,85,1959
Connie Salazar,['Monaco'],Researcher,1917,70,67,1987
Philip Webb,['Senegal'],Artist,1870,45,17,1915
Audrey Shelton,['Chile'],Artist,1910,48,12,1958
Alex Reed,"['Turkey', 'Mauritius']",Researcher,1909,56,79,1965
Karen Olsen,['Svalbard & Jan Mayen Islands'],Artist,1898,65,38,1963
Matthew Sullivan,"['Rwanda', 'Saudi Arabia']",Athlete,1872,60,39,1932
Michael Shepherd,"['Germany', 'Montserrat']",Journalist,1916,77,36,1993
Justin Holt,['Macao'],Artist,1905,41,13,1946
Tracey Adams,"['Liechtenstein', 'Peru']",Teacher,1879,18,50,1897
Christopher Berg,['Ghana'],Researcher,1897,3,69,1900
Kiara Goodman,"['Barbados', 'Bahrain']",Politician,1914,12,48,1926
Roy Wilkins,['Cyprus'],Politician,1912,15,82,1927
Frank Harris,"['Tunisia', 'Uganda']",Artist,1916,48,22,1964
Stephanie Nelson,"['Bermuda', 'Montenegro']",Artist,1893,53,40,1946
John Baker,['Palau'],Teacher,1887,20,37,1907
Dustin Lam,"['Cambodia', 'India']",Athlete,1889,32,29,1921
Aaron Foster,"['Yemen', 'Italy']",Physician,1887,73,49,1960
Autumn Wilson,"['Burundi', 'Gabon']",Artist,1910,70,12,1980
Amy Gutierrez DDS,"['Belarus', 'South Africa']",Artist,1889,39,46,1928
Patrick Figueroa,"['Latvia', 'Estonia']",Artist,1873,42,61,1915
Robert Carlson,"['Anguilla', 'Tunisia']",Artist,1895,51,46,1946
Vanessa Moore,"['El Salvador', 'Uzbekistan']",Athlete,1924,50,38,1974
Kelly Rodriguez,['Kenya'],Athlete,1921,53,73,1974
Tiffany Herrera,['Cape Verde'],Politician,1914,75,14,1989
Paul Santana,['Thailand'],Politician,1881,45,9,1926
Heather Lewis,['Ghana'],Artist,1886,51,23,1937
Meredith Grant,['Anguilla'],Researcher,1912,86,89,1998
Stephanie Gonzalez,['Swaziland'],Researcher,1904,87,50,1991
Catherine Manning,['Turks and Caicos Islands'],Researcher,1902,53,5,1955
Samantha Bullock,"['British Indian Ocean Territory (Chagos Archipelago)', 'Montenegro']",Politician,1923,62,70,1985
Scott Mccormick,['Benin'],Artist,1891,4,19,1895
Samuel Figueroa,"['Turkey', 'Bangladesh']",Politician,1912,34,87,1946
Colton Carpenter,['Syrian Arab Republic'],Servant of god,1873,39,34,1912
Sydney Cox,"['Saudi Arabia', 'Liechtenstein']",Athlete,1903,45,74,1948
Traci Evans,"['Mauritius', 'Grenada']",Artist,1908,16,59,1924
Lynn Burke,['United Arab Emirates'],Researcher,1913,10,39,1923
Douglas Mills,['Greenland'],Researcher,1915,73,37,1988
Debra Brown,"['Azerbaijan', 'Korea']",Artist,1910,67,37,1977
Jose Kim,"['Tokelau', 'Saint Kitts and Nevis']",Artist,1889,45,75,1934
Kimberly Richardson,['Portugal'],Military personnel,1907,32,77,1939
Brandon Nelson,['Gabon'],Artist,1922,45,49,1967
Courtney Henson,"['Switzerland', 'Cyprus']",Researcher,1891,27,81,1918
Jonathan Valdez,['Germany'],Artist,1896,35,87,1931
Juan Jones,"['Jordan', 'Marshall Islands']",Researcher,1884,24,36,1908
Jennifer Peterson,['Isle of Man'],Athlete,1906,10,44,1916
Deborah Cole,"['Mauritania', 'Peru']",Artist,1876,48,59,1924
Sean Sutton,"['Brazil', 'Saint Helena']",Artist,1891,41,49,1932
Pam Pham,['Panama'],Artist,1871,67,30,1938
Rachel Wilson,['Cocos (Keeling) Islands'],Artist,1919,33,88,1952
Lauren Ford,['Norway'],Artist,1876,83,38,1959
Marcus Conner,['Svalbard & Jan Mayen Islands'],Serial killer; criminal,1876,64,39,1940
Johnny Lee,"['Niger', 'North Macedonia']",Politician,1883,61,2,1944
Antonio Nielsen,"['Tunisia', 'Aruba']",Researcher,1921,83,67,2004
Rebecca Anderson,['Germany'],Researcher,1922,76,4,1998
Mark Davis,"['Netherlands Antilles', 'Croatia']",Researcher,1875,33,50,1908
Denise Marquez,['Monaco'],Politician,1921,51,17,1972
Nicole Anderson,"['Libyan Arab Jamahiriya', 'Qatar']",Engineer,1877,47,69,1924
Bradley Johnson,"['Solomon Islands', 'San Marino']",Researcher,1920,21,46,1941
Dr. Laura Hernandez,['Bangladesh'],Artist,1920,31,62,1951
Melissa Robinson,"['Guam', 'Oman']",Artist,1874,64,20,1938
Daniel Frank,['Ecuador'],Politician,1895,62,2,1957
Denise Navarro,"['Norfolk Island', 'Central African Republic']",Artist,1911,67,76,1978
Lynn Booth,"['Norfolk Island', 'Saint Martin']",Freestyle skier,1897,45,86,1942
Mrs. Nicole Olsen,"['Fiji', 'Equatorial Guinea']",Artist,1893,47,8,1940
Kayla Lyons,"['Myanmar', 'British Indian Ocean Territory (Chagos Archipelago)']",Journalist,1872,6,10,1878
Monica Jones,['Martinique'],Politician,1883,87,9,1970
Heidi Hebert,"['Papua New Guinea', 'Suriname']",Artist,1902,63,85,1965
Eric Collins,['Afghanistan'],Samurai,1922,57,21,1979
Shannon Thompson,"['Trinidad and Tobago', 'Ethiopia']",Artist,1903,53,47,1956
Rachel Turner,"['Lesotho', 'Jersey']",Researcher,1891,86,65,1977
Susan Parker,"['Saint Barthelemy', 'Bulgaria']",Lawyer,1893,81,65,1974
Amanda Winters,['Falkland Islands (Malvinas)'],Artist,1871,7,26,1878
Michelle Brooks,['Latvia'],Artist,1918,53,33,1971
Crystal Singh,['Kiribati'],Researcher,1880,57,9,1937
Jonathan Bartlett,['Libyan Arab Jamahiriya'],Politician,1912,53,69,1965
Adrian Montgomery,"['North Macedonia', 'American Samoa']",Artist,1915,64,45,1979
Micheal Mccarthy,['Slovakia (Slovak Republic)'],Artist,1918,13,26,1931
James Campbell,"['Bolivia', ""Lao People's Democratic Republic""]",Artist,1890,0,13,1890
Susan Monroe,"['New Caledonia', 'Argentina']",Politician,1891,36,17,1927
Kimberly Jenkins,['Georgia'],Artist,1879,0,66,1879
Ryan Stevens,['Antigua and Barbuda'],Artist,1871,76,1,1947
Julie Murphy,['Singapore'],Artist,1886,26,22,1912
Timothy Giles,"['Rwanda', 'Jamaica']",Artist,1919,48,89,1967
Christine Roberts,"['Monaco', 'Niger']",Researcher,1908,75,50,1983
Melissa Evans,"['Iran', 'Holy See (Vatican City State)']",Military personnel,1904,74,2,1978
Jennifer Matthews,['Puerto Rico'],Artist,1875,71,18,1946
Kyle Forbes,['Saint Martin'],Artist,1894,74,48,1968
Michael Davidson,"['Australia', 'Guinea']",Artist,1889,6,45,1895
Stacey Sutton,['Kuwait'],Artist,1873,88,37,1961
Kimberly Griffin,"['Israel', 'Tunisia']",Artist,1906,50,83,1956
Ashley Aguilar,"['Guatemala', 'Palestinian Territory']",Artist,1899,14,69,1913
Laura Gutierrez,"[""Cote d'Ivoire"", 'Nauru']",Artist,1900,87,37,1987
Sandra Cohen,['Zambia'],Artist,1898,32,45,1930
Dr. Joseph Cook,['Grenada'],Religious figure,1909,63,60,1972
Carol Bradley,"['Anguilla', 'Colombia']",Artist,1886,89,70,1975
John Rivera,['Dominican Republic'],Artist,1890,15,67,1905
James Beasley,"['Suriname', 'Madagascar']",Researcher,1873,41,36,1914
Robert Johnson,"['French Guiana', 'Ukraine']",Politician,1904,50,71,1954
Carrie Nelson,['Zimbabwe'],Athlete,1911,46,22,1957
Derrick Hill,['Libyan Arab Jamahiriya'],Artist,1900,13,72,1913
Joel Martin,['Brunei Darussalam'],Astronomer,1879,19,27,1898
Larry Tanner,"['Wallis and Futuna', 'Georgia']",Social work; clinical nurse specialist; social worker; social activist; activist,1906,87,44,1993
Deborah Hill,"['Myanmar', 'Mauritania']",Artist,1900,74,43,1974
Veronica Davila,['Poland'],Researcher,1880,60,19,1940
Jonathan Stanley,"['Azerbaijan', 'Bermuda']",Artist,1890,57,4,1947
Michael Tucker,['Sao Tome and Principe'],Researcher,1916,72,24,1988
Ruth Harris,['Samoa'],Artist,1884,59,46,1943
Tommy Morris,"['Malaysia', 'Myanmar']",Politician,1914,61,71,1975
Andrew Wilson,"['Ghana', 'Latvia']",Artist,1905,76,25,1981
Jodi Harris,"['Finland', 'Azerbaijan']",Artist,1922,77,69,1999
Jose Chavez,"['Saint Martin', 'British Virgin Islands']",Artist,1910,77,50,1987
Jeffery Anderson,"['Cook Islands', 'British Virgin Islands']",Artist,1919,63,62,1982
Amber Green,['Gambia'],Artist,1893,22,11,1915
Caleb Jordan,"['Brazil', 'Lesotho']",Customs officer; beekeeper,1889,31,13,1920
Mr. Steven Moore,"['Mauritania', 'Monaco']",Artist,1897,70,77,1967
Crystal Gonzalez,"['Mauritius', 'Hong Kong']",Athlete,1915,57,20,1972
Shannon Morgan,"['Mauritania', 'Tajikistan']",Gangster; mobster,1899,71,37,1970
Deborah Austin,['Hong Kong'],Politician,1905,34,84,1939
Tracy King,"['Tonga', 'Dominican Republic']",Artist,1873,15,39,1888
Sabrina Lynn,"['Angola', 'Luxembourg']",Artist,1890,23,10,1913
Shaun Garrett,"['Rwanda', 'Turks and Caicos Islands']",Artist,1912,60,85,1972
James Fernandez,"['Nepal', 'French Guiana']",Religious figure,1871,75,18,1946
Eduardo Lewis,"['Tanzania', 'India']",Artist,1898,51,67,1949
Ashley Wright,"['Italy', 'Cyprus']",Artist,1888,55,76,1943
Jennifer Banks,"['Netherlands Antilles', 'South Africa']",Artist,1919,65,1,1984
Jennifer Powell,['Oman'],Artist,1906,35,63,1941
Natasha Vasquez,['United States of America'],Politician,1918,21,49,1939
Theresa Huff,"['Somalia', 'South Georgia and the South Sandwich Islands']",Military personnel,1911,40,20,1951
Mark Campos DVM,"['Mayotte', 'Albania']",Artist,1901,28,84,1929
Annette Galloway,['Saint Vincent and the Grenadines'],Artist,1887,12,41,1899
Darius Garcia,"['Macao', 'Solomon Islands']",Artist,1890,68,29,1958
Steven Conner,['Saint Vincent and the Grenadines'],Politician,1895,57,47,1952
John Davis,"['Korea', 'Tonga']",Researcher,1892,74,87,1966
Wendy Mcdonald,['Mozambique'],Artist,1886,19,83,1905
Alexandra Murray,['United States Virgin Islands'],Revolutionary; terrorist,1872,78,19,1950
Darren Ellis,['Morocco'],Artist,1893,17,22,1910
Ryan Reyes,['Suriname'],Artist,1908,73,48,1981
Theresa Myers PhD,"['Oman', 'Gibraltar']",Fencer,1894,87,10,1981
Donna Adams,"['Montserrat', 'Colombia']",Artist,1870,22,5,1892
Julia Knox,['Somalia'],Researcher,1910,62,65,1972
David Jimenez,['Turkmenistan'],Researcher,1920,67,24,1987
Martin Krause,['Gibraltar'],Artist,1895,75,88,1970
Regina Williams,['Morocco'],Artist,1901,23,8,1924
Julie Jones,['Chad'],Artist,1876,58,50,1934
Kristin Schmidt,['Mozambique'],Artist,1886,77,28,1963
Mr. Dale Montgomery,"['Iraq', 'Finland']",Artist,1908,38,53,1946
Tiffany Coleman,['Maldives'],Designer; car designer,1916,54,1,1970
Cynthia Parks,['Palestinian Territory'],Politician,1903,6,8,1909
Greg Sims,"['Bulgaria', 'Portugal']",Military personnel,1913,31,44,1944
Annette Brock,['Armenia'],Politician,1878,24,46,1902
Matthew Herring,"['Congo', 'Norfolk Island']",Military personnel,1898,34,10,1932
Thomas Diaz,"['South Africa', 'Mayotte']",Athlete,1872,76,64,1948
Meghan Cole,['Finland'],Artist,1875,51,79,1926
Nicole Nelson,['Guadeloupe'],Politician,1915,84,81,1999
Adam Gross,"['Dominican Republic', 'French Southern Territories']",Artist,1923,74,32,1997
Rhonda Garcia,['Papua New Guinea'],Artist,1887,14,17,1901
Lance Smith MD,['Vanuatu'],Criminal,1879,69,42,1948
Christopher Gillespie,['India'],Racing automobile driver,1901,77,15,1978
Karl Murphy,['Switzerland'],Artist,1899,78,75,1977
Ryan Johnston,['North Macedonia'],Researcher,1911,0,28,1911
Martin Turner,['British Indian Ocean Territory (Chagos Archipelago)'],Socialite,1924,7,9,1931
Andrew Gates,"['Hungary', 'Dominican Republic']",Artist,1913,80,64,1993
Scott Walsh,['Bahrain'],Artist,1905,41,65,1946
Deborah Perez,"['Iran', 'Equatorial Guinea']",Politician,1890,7,11,1897
Matthew Martinez,['Anguilla'],Artist,1885,67,23,1952
Timothy Sharp,['Iceland'],Artist,1908,54,57,1962
Scott White,['Qatar'],Politician,1886,71,66,1957
James Jones,"['Morocco', 'Bouvet Island (Bouvetoya)']",Physician,1909,73,7,1982
Patrick Watkins,['Colombia'],Politician,1906,69,72,1975
Jeremy Guerrero MD,"['Slovenia', 'Saint Lucia']",Politician,1913,19,88,1932
Priscilla Willis,"['Iran', 'Peru']",Artist,1901,33,65,1934
Katherine Lee,['Anguilla'],Artist,1909,26,16,1935
Tina Ross,"['Svalbard & Jan Mayen Islands', 'Pakistan']",Artist,1909,19,76,1928
Jon Romero,"['Jersey', 'Haiti']",Researcher,1918,11,22,1929
Stephanie Richardson,"['Iran', 'Iran']",Artist,1897,2,68,1899
Kimberly Ramsey,"['Albania', 'Jordan']",Researcher,1898,6,4,1904
Travis Stevens,['Serbia'],Researcher,1922,1,86,1923
Dawn White,['Congo'],Researcher,1876,56,85,1932
Shannon Torres,"['Saint Lucia', 'Slovenia']",Artist,1902,20,52,1922
Megan Campbell,"['Turkey', 'Pakistan']",Politician,1920,81,23,2001
Marcus Williamson,"['Bhutan', 'Argentina']",Artist,1915,78,17,1993
Kelly Gutierrez,['Cook Islands'],Politician,1881,67,88,1948
Julie Camacho,['Australia'],Teacher,1904,70,36,1974
Charles Jones,"['Slovakia (Slovak Republic)', 'Monaco']",Artist,1908,76,88,1984
Jamie Novak,['Azerbaijan'],Artist,1881,19,28,1900
Michele Hatfield,"['Switzerland', 'San Marino']",Athlete,1903,26,41,1929
Christie Thompson,"['Libyan Arab Jamahiriya', 'Argentina']",Artist,1902,77,11,1979
Victoria Austin,"['Nepal', 'Norway']",Politician,1918,78,81,1996
Ryan Garcia,['Puerto Rico'],Researcher,1873,34,67,1907
Amber Grant,"['Turkey', 'Micronesia']",Artist,1916,58,53,1974
Manuel Tyler,['Algeria'],Politician,1917,20,40,1937
Scott Torres,"['Norfolk Island', 'Korea']",Athlete,1885,72,33,1957
Kirk Stone,"['Greece', 'Qatar']",Military personnel,1870,66,36,1936
Randy Wilkins,"['Namibia', 'Malta']",Athlete,1875,85,1,1960
Stacy Reynolds,"['Netherlands', 'Dominican Republic']",Artist,1909,60,75,1969
Joshua Sharp,"['Bulgaria', 'Macao']",Athlete,1911,6,6,1917
William Hernandez,['Korea'],Artist,1897,60,77,1957
Brian Henderson,['Antarctica (the territory South of 60 deg S)'],Athlete,1884,71,56,1955
Gabrielle Cook,['Bosnia and Herzegovina'],Military personnel,1915,85,10,2000
Jason Hawkins,"['Malawi', 'Bangladesh']",Politician,1908,45,25,1953
David Guerrero,"['Falkland Islands (Malvinas)', ""Cote d'Ivoire""]",Artist,1897,62,63,1959
George Jackson,"['United States of America', 'Panama']",Parson,1922,31,72,1953
Jacob White,"['Cambodia', 'Falkland Islands (Malvinas)']",Artist,1905,72,84,1977
Dr. Amy Howard,"['Greece', 'Singapore']",Artist,1905,13,12,1918
Richard Johnson,"['Saint Pierre and Miquelon', 'Belarus']",Artist,1877,23,45,1900
Brittany Mendoza,['United States Minor Outlying Islands'],Researcher,1899,63,43,1962
Dylan Weaver,['Dominica'],Motorcycle racer; racing automobile driver,1913,47,67,1960
Amber Romero,"['Grenada', 'American Samoa']",Politician,1918,59,84,1977
Melissa Hughes,['Pakistan'],Artist,1884,50,40,1934
Joshua Barrett,"['Poland', 'British Virgin Islands']",Politician,1919,38,33,1957
Carlos Coffey,"['Montserrat', 'Comoros']",Artist,1899,54,59,1953
Monica West,"['Tajikistan', 'Senegal']",Politician,1900,65,5,1965
Sandra Phillips,"['Rwanda', 'Sierra Leone']",Researcher,1898,12,38,1910
Brooke Robles,"['Egypt', 'Saint Martin']",Businessperson,1910,9,25,1919
Timothy Nicholson,['Burundi'],Artist,1871,75,16,1946
Tiffany Orozco,['Malta'],Politician,1913,24,27,1937
Travis Cox,['United Kingdom'],Artist,1915,37,89,1952
Alexander Smith,"['Portugal', 'Albania']",Military personnel,1924,39,39,1963
Brent King,['Iceland'],Politician,1879,66,85,1945
Ashley Wright,['Belarus'],Criminal,1917,37,3,1954
Patricia Stanley,"['Croatia', 'Seychelles']",Artist,1885,54,62,1939
Amy Lopez,['Lebanon'],Artist,1918,34,16,1952
Lori Davidson,"['Bangladesh', 'Argentina']",Acrobat; circus performer,1886,10,20,1896
Erin Delgado,"['Sweden', 'Albania']",Politician,1884,68,13,1952
Steven Brooks,['Cocos (Keeling) Islands'],Military personnel,1923,59,40,1982
Daniel Bryant,"['Nigeria', 'Mayotte']",Artist,1894,77,76,1971
Robert Rose,"['Kazakhstan', 'Guyana']",Artist,1901,85,55,1986
Sharon Jones,"['San Marino', 'Tunisia']",Politician,1918,56,37,1974
Douglas Griffin Jr.,['Christmas Island'],Athlete,1872,58,75,1930
Adam Monroe,"['Rwanda', 'Montserrat']",Athlete,1911,39,26,1950
Anna Moody,['Northern Mariana Islands'],Politician,1922,70,70,1992
Kevin Sanchez,['Luxembourg'],Physician,1888,38,10,1926
Anthony Jones,"['Ireland', 'Azerbaijan']",Artist,1891,23,65,1914
Brian King,"['Saint Helena', 'Faroe Islands']",Journalist,1918,5,44,1923
Daniel Poole,"['Slovenia', 'Anguilla']",Researcher,1909,23,9,1932
Ronald Cummings,['Paraguay'],Politician,1887,17,31,1904
Donna Nguyen,['Monaco'],Artist,1872,76,86,1948
Paula Bryan,"['Mayotte', 'Peru']",Artist,1874,34,0,1908
Bryan Cole,"['Greece', 'Belize']",Artist,1874,78,23,1952
Angela Miller,['American Samoa'],Artist,1885,7,56,1892
William Sanchez,['Iran'],Military personnel,1919,2,8,1921
Gregory Cooper,"['Swaziland', 'Argentina']",Artist,1877,60,16,1937
Amanda Garner,['Switzerland'],Researcher,1877,67,85,1944
Phillip Nicholson,"['Uganda', 'Brazil']",Researcher,1879,8,75,1887
Daniel Smith,['Heard Island and McDonald Islands'],Artist,1880,34,45,1914
Katelyn Schwartz,['Greece'],Athlete,1923,60,17,1983
Craig Wagner DDS,['Jamaica'],Artist,1892,8,0,1900
Shawn Simpson,['Saint Kitts and Nevis'],Monarch,1902,62,86,1964
Jaclyn Jones,['Algeria'],Researcher,1891,82,71,1973
Kathleen Robinson,"['United States Virgin Islands', 'Ethiopia']",Artist,1897,39,42,1936
Caitlin Fitzgerald,"['Liechtenstein', 'Togo']",Politician,1888,82,68,1970
David Clark,['Trinidad and Tobago'],Artist,1913,59,49,1972
Allison Merritt,['Nigeria'],Artist,1871,74,70,1945
Elizabeth Escobar,['Andorra'],Artist,1884,75,27,1959
Jonathan Burke,['Antigua and Barbuda'],Politician,1888,50,78,1938
Jacqueline Curtis,['Hong Kong'],Athlete,1905,25,82,1930
Dawn Ellis,"['Belgium', 'Guadeloupe']",Politician,1870,52,72,1922
John Hughes,['Jersey'],Artist,1920,37,33,1957
Teresa White,"['Myanmar', 'Myanmar']",Researcher,1879,38,38,1917
Karen Leon,['Equatorial Guinea'],Religious figure,1888,72,71,1960
William Russo,['Kuwait'],Artist,1910,81,28,1991
Stephanie Livingston,"['United Arab Emirates', 'Algeria']",Artist,1920,52,14,1972
Cody Bentley,['Jamaica'],Athlete,1899,59,26,1958
Antonio Stevens,['Bhutan'],Artist,1912,11,52,1923
Hannah Howell,"['Sierra Leone', 'Liberia']",Politician,1901,12,82,1913
Cheryl Allen,"['Panama', 'Czech Republic']",Researcher,1871,57,54,1928
Kristina Mccall,['Moldova'],Explorer,1911,26,67,1937
Thomas Coleman,['Saint Pierre and Miquelon'],Artist,1916,17,84,1933
David Young,"['Bahrain', 'Kiribati']",Athlete,1873,65,61,1938
Tracy Terry,['China'],Artist,1902,27,13,1929
Judy Patterson,['Ireland'],Artist,1919,0,70,1919
Steven Pena,['Liechtenstein'],Monarch,1877,8,45,1885
Laura Martinez,['Cyprus'],Politician,1921,11,62,1932
Sarah Clayton,"['Guernsey', 'Niger']",Lawyer,1903,49,83,1952
Bradley Morgan,['Comoros'],Artist,1877,7,8,1884
Brittney Ingram,['Gibraltar'],Artist,1918,79,40,1997
Alan Johns,"['Macao', 'Ghana']",Artist,1880,1,84,1881
Amanda Barnes,"['Congo', 'Western Sahara']",Artist,1889,65,69,1954
Micheal Sheppard,['Turkey'],Teacher,1892,75,1,1967
Melissa Roberts,"['Cocos (Keeling) Islands', 'Italy']",Artist,1917,25,67,1942
Haley Barrett,['Grenada'],Politician,1921,65,64,1986
Matthew Bowman,['Argentina'],Politician,1919,60,39,1979
April Alvarez,['Anguilla'],Athlete,1909,70,35,1979
Justin Becker,"['Thailand', 'Australia']",Artist,1887,64,25,1951
Brent Delgado,"['Norway', 'Azerbaijan']",Politician,1899,66,0,1965
Adrian Acosta,['Bermuda'],Artist,1893,35,34,1928
Leslie Brown,"['Antigua and Barbuda', 'Philippines']",Artist,1913,26,86,1939
Lisa Nelson,['Guinea'],Artist,1897,54,53,1951
Jeff Wright,['Mozambique'],Athlete,1870,84,26,1954
Joann Preston,"['British Indian Ocean Territory (Chagos Archipelago)', 'Timor-Leste']",Artist,1921,88,9,2009
Bryan Pena,['Togo'],Artist,1878,18,21,1896
Noah Fisher,['Kuwait'],Artist,1883,14,12,1897
Michael Williams,['Macao'],Engineer,1876,32,49,1908
Kathleen Richards,['United States Minor Outlying Islands'],Politician,1902,31,30,1933
Jennifer Taylor,['Greece'],Teacher,1900,67,79,1967
Donna Stone,['Qatar'],Artist,1904,82,77,1986
Tasha Perkins,"['Guinea-Bissau', 'Angola']",Politician,1921,34,52,1955
Donna Contreras,"['South Africa', 'Finland']",Artist,1896,42,84,1938
Gary Mays,"['Bhutan', 'Oman']",Researcher,1914,6,23,1920
James Torres,['Palau'],Artist,1912,29,84,1941
Claire Vargas,['Moldova'],Artist,1902,14,11,1916
Kenneth Mercer,['Barbados'],Politician,1902,1,15,1903
Anthony Gould,['Liberia'],Politician,1910,65,17,1975
Nancy Vaughn,['Congo'],Artist,1903,87,78,1990
Alex Jefferson,"['Swaziland', 'Turks and Caicos Islands']",Politician,1892,50,20,1942
Kristen Solis,['Romania'],Researcher,1898,68,15,1966
Heather Dominguez,"['Malawi', 'Turkmenistan']",Researcher,1919,8,34,1927
Claire Gonzalez,['Bulgaria'],Artist,1921,54,41,1975
Mary Cox,['Yemen'],Artist,1886,48,50,1934
Thomas Green,"['Armenia', 'Kuwait']",Politician,1894,11,40,1905
Laura Lee,['San Marino'],Military personnel,1907,60,7,1967
Russell Montgomery,"['Antigua and Barbuda', 'Guernsey']",Artist,1879,47,15,1926
Melanie Stanton,['Ghana'],Artist,1922,21,62,1943
James Rose,"['French Southern Territories', 'Senegal']",Artist,1884,24,33,1908
Dennis Kirby,"['Senegal', 'Malaysia']",Military personnel,1916,71,5,1987
Robert Evans,['Myanmar'],Artist,1918,64,71,1982
Sara Benton,['Finland'],Researcher,1898,58,66,1956
Jessica Anderson,['Pakistan'],Long-distance runner,1906,59,11,1965
Joseph Costa,"['Tajikistan', 'Sweden']",Politician,1909,65,50,1974
Michelle Simmons,['Pakistan'],Artist,1898,88,20,1986
David Chavez,"['Madagascar', 'Fiji']",Researcher,1883,43,67,1926
Jeffery Russell,"['Senegal', 'Trinidad and Tobago']",Politician,1887,40,71,1927
Stephanie Hunter,"['Argentina', 'Senegal']",Politician,1906,15,60,1921
Sara Neal,"['American Samoa', 'Bermuda']",Researcher,1879,67,76,1946
Eric Jones,"['Iceland', 'Palau']",Artist,1890,65,40,1955
Kari White,"['Afghanistan', 'Bhutan']",Sprinter,1882,89,74,1971
Mr. Derrick Ballard,['New Zealand'],Politician,1909,31,61,1940
James Williams,"['Palestinian Territory', 'United States Virgin Islands']",Political activist,1893,13,13,1906
Paul Reed,['Sweden'],Athlete,1915,58,34,1973
Dr. Nicholas Esparza,"['Armenia', 'Venezuela']",Physician,1902,48,55,1950
Marc Berry,"['British Indian Ocean Territory (Chagos Archipelago)', 'Saint Kitts and Nevis']",Artist,1910,23,76,1933
Heather Torres,['Korea'],Artist,1882,47,18,1929
Courtney Bentley,['Gambia'],Artist,1884,69,21,1953
Melanie Williams,['Albania'],Artist,1885,62,46,1947
Heidi Rich,['Armenia'],Artist,1905,18,24,1923
David Daniel,"['Northern Mariana Islands', 'Palestinian Territory']",Artist,1885,74,41,1959
Amy Reyes,['Brunei Darussalam'],Researcher,1877,53,65,1930
Joshua Martin,['India'],Artist,1888,74,79,1962
Kathy Murphy,['Saint Barthelemy'],Politician,1870,79,80,1949
George Smith,"['South Africa', 'Sweden']",Artist,1890,79,19,1969
Kevin Brown,"['Comoros', 'Malaysia']",Researcher,1886,38,9,1924
Tara Clark,['Guadeloupe'],Politician,1905,47,89,1952
Dana Buckley PhD,['Central African Republic'],Flight attendant; nurse,1913,34,75,1947
Ashley Smith,['Western Sahara'],Politician,1915,42,78,1957
Mandy Walker,"['Antarctica (the territory South of 60 deg S)', 'Honduras']",Artist,1907,4,11,1911
Kristina Smith,"['Papua New Guinea', 'Timor-Leste']",Athlete,1897,75,48,1972
Tiffany Cline,"['Burkina Faso', 'Andorra']",Artist,1875,72,65,1947
Steve Harris,['Guadeloupe'],Artist,1875,77,16,1952
Curtis Wyatt,"['Poland', 'Aruba']",Marathon runner,1881,86,4,1967
Laura Hanson,['Australia'],Politician,1879,53,79,1932
Rose Stark,['Mauritius'],Politician,1916,14,48,1930
Joseph Huerta,['Saint Barthelemy'],Military personnel,1899,76,61,1975
Judy Delgado,['Angola'],Researcher,1909,61,38,1970
Michael Meadows,['Austria'],Artist,1887,60,14,1947
Tammy Harvey,['Netherlands'],Artist,1913,28,27,1941
Tiffany Clay,['Iceland'],Artist,1892,21,31,1913
Karen Garcia,"['Tonga', 'El Salvador']",Stand-up comedian,1892,7,16,1899
Brandon Knight,['Burkina Faso'],Athlete,1922,39,53,1961
Jennifer Gardner,['Vietnam'],Artist,1887,45,4,1932
Brenda Thomas,"['Ukraine', 'Sweden']",Publisher,1909,40,71,1949
Travis Turner,['Liechtenstein'],Military personnel,1879,50,23,1929
Erika Rodriguez,"['Congo', 'Honduras']",Artist,1883,5,16,1888
Mark Mooney,['North Macedonia'],Politician,1912,50,26,1962
Dylan Parker,"['Holy See (Vatican City State)', 'Tunisia']",Politician,1874,45,26,1919
Carmen Hull,"['Cape Verde', 'Cuba']",Politician,1900,28,34,1928
Gregory Roy,"['Cambodia', 'Pakistan']",Artist,1876,85,81,1961
Brian Wilcox,['Saint Kitts and Nevis'],Artist,1919,71,14,1990
Troy Bray,"['Cambodia', 'Martinique']",Artist,1903,63,89,1966
Alexis Holt,"['Papua New Guinea', 'Tunisia']",Artist,1897,82,9,1979
Sandra Morgan,['Ecuador'],Artist,1899,62,25,1961
Cody Mitchell,['Austria'],Researcher,1905,10,60,1915
Michael Zimmerman,"['Mongolia', 'Papua New Guinea']",Artist,1898,48,64,1946
Andres Smith,['Antarctica (the territory South of 60 deg S)'],Artist,1913,54,62,1967
Kimberly Ferguson,['Bhutan'],Athlete,1914,79,18,1993
Aaron Gonzalez,['Andorra'],Artist,1924,85,44,2009
Nicole Lopez,"['Ecuador', 'Trinidad and Tobago']",Artist,1870,54,58,1924
Michael Ryan,['Hong Kong'],Journalist,1914,61,75,1975
Michelle Palmer,['Libyan Arab Jamahiriya'],Artist,1909,76,51,1985
Sarah Torres,['Mauritius'],Revolutionary,1876,3,23,1879
Debra Hopkins,"['El Salvador', 'Ireland']",Athlete,1924,84,47,2008
Heather Golden,['Somalia'],Artist,1892,36,27,1928
David Ward,"['United States Virgin Islands', 'Indonesia']",Artist,1871,17,61,1888
Gary Dunlap,"['Kuwait', 'Mali']",Artist,1896,42,8,1938
Daniel Sanders,"['Eritrea', 'Montserrat']",Politician,1875,58,18,1933
Christian Mcgee,"['Botswana', 'Congo']",Serial killer; criminal,1887,26,64,1913
Jerry Schmidt,"['Cuba', 'Singapore']",Researcher,1875,23,77,1898
David Chambers,"['Nigeria', 'British Indian Ocean Territory (Chagos Archipelago)']",Politician,1914,62,0,1976
Daniel Hill,"['Marshall Islands', ""Cote d'Ivoire""]",Politician,1896,85,36,1981
Becky Henderson,"['Central African Republic', 'Fiji']",Artist,1882,25,82,1907
Damon Hart,"['France', 'Ethiopia']",Artist,1913,74,86,1987
Timothy Mcguire,"['Thailand', 'Netherlands Antilles']",Politician,1888,18,52,1906
Susan Montgomery,"['Algeria', 'Burundi']",Artist,1910,45,5,1955
Corey Carrillo,"['Guinea-Bissau', 'Puerto Rico']",Researcher,1870,16,14,1886
Patricia Hall,['American Samoa'],Politician,1918,82,11,2000
Melinda Pena,"['Congo', 'Solomon Islands']",Military personnel,1919,68,67,1987
Shawn Meadows,['Mayotte'],Artist,1887,37,11,1924
Jordan Gross,['Croatia'],Politician,1893,17,80,1910
Jesse Garner MD,"['Brunei Darussalam', 'Greece']",Researcher,1900,39,88,1939
Samuel Vance,['Tonga'],Artist,1913,70,69,1983
Brandon Walsh,"['Croatia', 'Chile']",Artist,1877,15,52,1892
Jade Lucas,"['Saint Barthelemy', 'Botswana']",Artist,1888,76,16,1964
Paul Thomas,['Finland'],Artist,1912,28,16,1940
Erik King,"['Suriname', 'Nicaragua']",Researcher,1900,3,43,1903
Jennifer Roberts,['Cocos (Keeling) Islands'],Politician,1870,70,32,1940
Jesse Lawson,['Latvia'],Athlete,1885,37,85,1922
David Walsh,"['Armenia', 'Portugal']",Athlete,1915,43,41,1958
Randall Leonard,['France'],Politician,1870,49,62,1919
David Moore,['Greece'],Politician,1877,70,7,1947
Elizabeth Miller,"['British Virgin Islands', 'Macao']",Politician,1909,5,31,1914
Tara Anderson,['United States Virgin Islands'],Military personnel,1914,9,8,1923
Jennifer Young,"['Kazakhstan', 'Russian Federation']",Artist,1891,22,13,1913
Bianca Mcintosh,['New Zealand'],Artist,1919,59,52,1978
Craig Lee,['Heard Island and McDonald Islands'],Artist,1901,64,52,1965
Jerry Brown,"['Bhutan', 'Latvia']",Entrepreneur,1907,49,78,1956
Timothy Wade,"['Costa Rica', 'Palau']",Artist,1875,33,12,1908
James Hoffman,['Panama'],Artist,1886,37,4,1923
Benjamin Andrews,"['Panama', 'Tonga']",Artist,1880,41,76,1921
Madison Cowan,"['Pakistan', 'Tuvalu']",Politician,1903,88,56,1991
Tanya Sharp,['Dominica'],Artist,1898,2,45,1900
Deborah Edwards,['Turkmenistan'],Researcher,1870,67,34,1937
Leslie Bennett,['France'],Artist,1909,23,54,1932
Jason Hines,['Burkina Faso'],Politician,1883,75,6,1958
Ryan Love,['Czech Republic'],Mangaka,1881,31,32,1912
Debra Weaver,['Saudi Arabia'],Researcher,1885,79,19,1964
Mr. Robert Harris,['Bosnia and Herzegovina'],Politician,1878,83,65,1961
James Brown,['Luxembourg'],Researcher,1899,3,18,1902
Bradley Gray,"['Andorra', 'Burundi']",Artist,1881,28,13,1909
Catherine Livingston,['Croatia'],Aristocrat,1914,16,24,1930
Jessica Hester,"['Serbia', 'Western Sahara']",Artist,1898,51,87,1949
Raymond Logan,"['France', 'Holy See (Vatican City State)']",Researcher,1905,24,54,1929
Alexis Taylor,"['Paraguay', 'Uganda']",Athlete,1921,54,88,1975
Charles Palmer,"['Australia', 'Central African Republic']",Artist,1889,58,8,1947
Ryan Huff,"['Liberia', 'French Southern Territories']",Artist,1879,38,5,1917
Jason Richardson,['Palau'],Military personnel,1918,39,81,1957
Jessica Rodriguez,"['Italy', 'Qatar']",Athlete,1913,74,18,1987
Anna Payne,['Ukraine'],Researcher,1919,0,59,1919
Emily Fernandez,['Congo'],Artist,1889,24,79,1913
Wendy Wilkins,"['Portugal', 'Slovenia']",Politician,1909,7,72,1916
Kim Castillo,"['United States of America', 'French Southern Territories']",Artist,1872,16,64,1888
Allison Rodriguez,"['Singapore', 'Moldova']",Artist,1903,83,39,1986
Karen Jimenez,['Moldova'],Politician,1898,15,75,1913
Kathy Brewer,"['Mauritania', 'Mayotte']",Artist,1906,67,29,1973
Kathleen Bonilla,"['French Polynesia', 'Timor-Leste']",Aristocrat,1870,37,48,1907
Adam Waller,"['Papua New Guinea', 'Egypt']",Politician,1901,22,73,1923
Jason Chavez,['Korea'],Politician,1880,69,66,1949
Ryan Taylor,['Italy'],Politician,1888,72,75,1960
Ariel Meyer,['Tunisia'],Researcher,1892,51,63,1943
Melanie Aguilar,['Bouvet Island (Bouvetoya)'],Entrepreneur,1870,74,82,1944
Joseph Hayden,"['Latvia', 'Honduras']",Military personnel,1886,15,26,1901
Ana Ramirez,['Heard Island and McDonald Islands'],Artist,1892,28,27,1920
Mariah Fritz,['Antigua and Barbuda'],Artist,1882,13,67,1895
Mary Griffith,['Monaco'],Artist,1893,16,55,1909
Jeffrey Perry,['Netherlands Antilles'],Athlete,1885,3,67,1888
Amanda Nguyen,"['Azerbaijan', 'Nicaragua']",Artist,1912,63,49,1975
Tony Fitzpatrick,['Nauru'],Athlete,1906,59,0,1965
Shaun Hutchinson,['Faroe Islands'],Politician,1910,44,3,1954
Brian Wilson,['Cameroon'],Artist,1921,71,5,1992
Nicholas Howell,"[""Lao People's Democratic Republic""]",Motorcycle racer; racing automobile driver,1879,65,87,1944
Melanie Jensen,['Afghanistan'],Artist,1910,64,26,1974
Eric Jordan,['Eritrea'],Researcher,1891,20,1,1911
Dana Burgess,['Pitcairn Islands'],Artist,1875,72,79,1947
Monica Carter,['French Polynesia'],Athlete,1890,11,85,1901
Andrea Gonzales,"['Pakistan', 'Mauritius']",Journalist,1876,51,86,1927
Mary Potter,['Guinea-Bissau'],Artist,1898,75,10,1973
Kevin Rowland,"['British Indian Ocean Territory (Chagos Archipelago)', 'Guatemala']",Artist,1920,80,45,2000
Cody Prince,"['Grenada', 'Guinea-Bissau']",Religious figure,1912,50,86,1962
Lauren Elliott,"['Bulgaria', 'Holy See (Vatican City State)']",Artist,1895,11,67,1906
Megan Harvey,['Greece'],Researcher,1883,36,49,1919
Renee Long,"['San Marino', 'Seychelles']",Researcher,1914,7,0,1921
Nancy Riddle,"['Antarctica (the territory South of 60 deg S)', 'Suriname']",Athlete,1908,24,77,1932
Richard Nguyen,"['Equatorial Guinea', 'Honduras']",Artist,1921,8,55,1929
Janet Brown,['Tanzania'],Artist,1914,18,30,1932
Leslie Moran,['Montserrat'],Politician,1891,20,16,1911
Angela Huerta,"['Guadeloupe', 'Sri Lanka']",Engineer,1888,10,47,1898
Matthew Davis,['Vanuatu'],Guitarist,1892,76,2,1968
Michele Edwards,['Saint Kitts and Nevis'],Politician,1896,70,47,1966
Michael Huerta,"['Isle of Man', 'Pitcairn Islands']",Architect,1887,5,60,1892
Stephanie Thomas,['Dominican Republic'],Artist,1906,11,36,1917
Kelly Arroyo,['Syrian Arab Republic'],Artist,1909,74,70,1983
Brittany Nguyen,"['Portugal', 'Greece']",Politician,1921,8,38,1929
Tracy Cooper,['Somalia'],Artist,1915,70,12,1985
Timothy Pena,"['Nicaragua', 'Kenya']",Cinematographer,1920,55,15,1975
Donna King,"['Antarctica (the territory South of 60 deg S)', 'Taiwan']",Politician,1903,36,24,1939
James Gomez,['Nigeria'],Businessperson,1883,61,12,1944
Joshua Lawrence,"['Afghanistan', 'Bhutan']",Artist,1877,37,30,1914
Peter Jacobs,"['Bangladesh', 'United States Minor Outlying Islands']",Researcher,1880,13,37,1893
Kenneth Pena,"['Denmark', 'Samoa']",Politician,1906,58,43,1964
Jeffery Andrade,"['Jersey', 'Iraq']",Athlete,1903,37,3,1940
Mark Ayala,['Marshall Islands'],Artist,1878,21,80,1899
Jennifer Carpenter,"['Sweden', 'Malawi']",Military personnel,1870,2,81,1872
Lauren Brown,['Thailand'],Racing automobile driver; formula one driver,1893,63,18,1956
Amber Martin,"['Venezuela', 'Uruguay']",Researcher,1899,64,85,1963
Craig Hernandez,['Nauru'],Military personnel,1919,62,42,1981
Brittany Barr,['Burkina Faso'],Politician,1899,51,63,1950
Christopher Smith,"['Puerto Rico', 'Iceland']",Politician,1885,22,13,1907
Alexander Thompson DVM,"['Hungary', 'Hong Kong']",Politician,1902,0,74,1902
Pamela Hutchinson,"['Micronesia', 'Tuvalu']",Artist,1870,77,60,1947
David Cameron,['Martinique'],Artist,1917,12,78,1929
Patricia Guzman,['Zimbabwe'],Artist,1877,47,44,1924
Miguel Lewis,['El Salvador'],Artist,1881,35,70,1916
Dawn Woods,['Central African Republic'],Athlete,1895,59,30,1954
Mark Taylor,['Azerbaijan'],Artist,1891,65,67,1956
Caitlin Davis,"['Estonia', 'Rwanda']",Artist,1924,68,72,1992
Cheryl Clark,['Rwanda'],Military personnel,1911,76,10,1987
Carlos Carter,"['Uganda', 'Cuba']",Politician,1894,49,8,1943
Maria Brown,"['Singapore', 'Macao']",Artist,1895,48,25,1943
John Thomas,"['Solomon Islands', 'Pitcairn Islands']",Artist,1915,59,89,1974
Jared Aguilar,"['Barbados', 'French Polynesia']",Researcher,1880,17,10,1897
Micheal Wilson,['Slovakia (Slovak Republic)'],Military personnel,1915,9,75,1924
Mary Martinez,['Bermuda'],Pirate,1914,20,24,1934
Walter Sanchez,['Madagascar'],Sovereign,1913,40,14,1953
Eric Floyd,"['Rwanda', 'El Salvador']",Artist,1897,58,31,1955
Amy Torres,['France'],Artist,1882,48,40,1930
Brian Sanchez,['France'],Researcher,1897,3,75,1900
Sheila Miller,"['Seychelles', 'Hungary']",Artist,1899,27,58,1926
Sara Garcia,"['United States Minor Outlying Islands', 'Gabon']",Teacher,1875,20,29,1895
Dr. Jennifer King DDS,"['Netherlands Antilles', 'Guyana']",Athlete,1891,8,46,1899
John Gallegos,['Maldives'],Artist,1884,36,65,1920
James Kramer,['Niue'],Military personnel,1873,71,58,1944
Brooke Thomas,['Kyrgyz Republic'],Politician,1895,87,63,1982
Brandon Thomas,"['Turkey', 'Svalbard & Jan Mayen Islands']",Researcher,1918,37,69,1955
Jon White,"['Sierra Leone', 'Honduras']",Athlete,1874,44,19,1918
Tanner Long,['Lithuania'],Politician,1916,15,62,1931
Cristina Scott,"['United States of America', 'Congo']",Artist,1911,22,52,1933
Cynthia Johnson,['United Arab Emirates'],Artist,1922,57,34,1979
Danny Smith,['Heard Island and McDonald Islands'],Politician,1872,64,64,1936
Michael Phillips,['Panama'],Artist,1870,55,86,1925
David Perez,"['Antarctica (the territory South of 60 deg S)', 'Slovakia (Slovak Republic)']",Athlete,1916,89,57,2005
Joshua Payne,"['Japan', 'Georgia']",Artist,1923,51,58,1974
Sean Ross,['Bouvet Island (Bouvetoya)'],Politician,1890,33,89,1923
Jennifer Clarke,"['Djibouti', 'Bolivia']",Politician,1877,84,31,1961
Malik Farmer,"['Malta', 'Singapore']",Artist,1908,26,77,1934
Timothy Pugh,"['United States Minor Outlying Islands', 'Northern Mariana Islands']",Military personnel,1921,67,67,1988
Nichole Reynolds,['Wallis and Futuna'],Artist,1921,15,85,1936
Anthony Leach,"['Saint Barthelemy', 'New Caledonia']",Researcher,1888,54,85,1942
Alan Cole,"['Armenia', 'Bolivia']",Artist,1919,46,70,1965
Seth Roman,['Netherlands Antilles'],Artist,1904,9,14,1913
Christopher Tate,"['Austria', 'Tonga']",Researcher,1909,21,32,1930
Jesus Jackson,"['Pakistan', 'Norway']",Politician,1889,77,35,1966
Katie Terry,"['Trinidad and Tobago', 'Japan']",Artist,1918,51,88,1969
Chad Vaughn,"['Oman', 'Denmark']",Athlete,1887,48,28,1935
Rebecca Garrett,['Romania'],Artist,1908,30,14,1938
Jessica Long,['British Indian Ocean Territory (Chagos Archipelago)'],Researcher,1895,11,82,1906
Mr. Cory Rubio,['Central African Republic'],Artist,1896,54,78,1950
Patricia Martin,"['Cook Islands', 'Paraguay']",Artist,1890,54,20,1944
Alex Carlson,"['Zimbabwe', 'Palau']",Architect,1872,44,20,1916
Jeanne Allen,['Mongolia'],Pedagogue,1908,2,12,1910
Michael Walters,"['Azerbaijan', 'Tajikistan']",Politician,1913,68,63,1981
Sarah Collins,"['Reunion', 'Vietnam']",Artist,1885,87,26,1972
Angela Ayala,"['Estonia', 'Sweden']",Artist,1883,46,0,1929
Randy Bauer,"['Spain', ""Lao People's Democratic Republic""]",Explorer,1904,22,5,1926
Brittney Brown,"['Kuwait', 'France']",Athlete,1917,74,25,1991
Rhonda Wright,['Monaco'],Artist,1906,88,9,1994
Aaron Vaughan,['Barbados'],Artist,1903,25,73,1928
Lori Wood,"['Qatar', 'Burundi']",Ruler,1893,48,3,1941
Brenda Jones,['Greenland'],Artist,1916,79,31,1995
Morgan Reyes,['Turks and Caicos Islands'],Artist,1900,78,38,1978
Judy Lopez,"['Congo', 'Jordan']",Artist,1890,9,19,1899
Michael Thomas,"['Lesotho', 'Kenya']",Athlete,1891,73,30,1964
Desiree Little,['British Indian Ocean Territory (Chagos Archipelago)'],Artist,1895,62,25,1957
Nicole Duran,"['Comoros', 'France']",Artist,1881,7,38,1888
Tracey Howell,['Mauritius'],Politician,1890,1,39,1891
Tina Doyle,"['Cyprus', 'Iceland']",Artist,1870,26,49,1896
Bruce Rowland,['South Africa'],Artist,1910,70,50,1980
Megan Rojas,['Barbados'],Researcher,1872,88,16,1960
Jose Russell,['Libyan Arab Jamahiriya'],Politician,1899,29,29,1928
Lisa Johnson,"['Heard Island and McDonald Islands', 'Micronesia']",Artist,1897,24,62,1921
Megan Weiss,['Bhutan'],Politician,1890,20,62,1910
Jessica Barnes,"['Namibia', 'Togo']",Journalist,1905,66,48,1971
Elizabeth Harris,"['Sweden', 'Thailand']",Artist,1914,42,47,1956
Jeremy Mendez,"['Iraq', 'Cyprus']",Engineer,1872,89,57,1961
Jessica Hansen,"['Antigua and Barbuda', 'Netherlands Antilles']",Artist,1898,0,34,1898
Tonya Lane,['Equatorial Guinea'],Artist,1891,30,23,1921
Jacqueline Brown,['Guadeloupe'],Chef,1876,1,64,1877
Raymond Mitchell,['Hong Kong'],Politician,1892,17,77,1909
Jennifer Cole,"['Holy See (Vatican City State)', 'Haiti']",Artist,1880,45,86,1925
Ms. April Peterson DVM,['Bulgaria'],Artist,1901,82,19,1983
Andrew Foster,"['Czech Republic', 'Kazakhstan']",Artist,1889,73,73,1962
Tyler Ochoa,['Guernsey'],Researcher,1883,87,55,1970
Mary Haynes,"['Singapore', 'Honduras']",Military personnel,1888,78,71,1966
Janice King,['Switzerland'],Artist,1895,73,34,1968
Anthony Chapman,['San Marino'],Weightlifter,1908,22,56,1930
Nicole Whitney,"['Gibraltar', 'Kazakhstan']",Courtesan; exotic dancer; dancer; spy,1904,36,49,1940
Gabriel Cisneros,['Jersey'],Researcher,1878,0,33,1878
Melissa Santos,"['American Samoa', 'Cocos (Keeling) Islands']",Teacher,1874,64,86,1938
Joshua Williams DDS,"['United Kingdom', 'Uruguay']",Javelin thrower,1915,20,63,1935
Julia Ward,"['Gabon', 'Ecuador']",Artist,1915,21,76,1936
Sydney Ware,['Togo'],Politician,1874,81,28,1955
Kevin Murray,"['Malaysia', 'Bouvet Island (Bouvetoya)']",Monarch,1879,71,76,1950
Kayla Brown,['Tunisia'],Politician,1908,45,43,1953
Gordon Carney,"['South Georgia and the South Sandwich Islands', 'Congo']",Art director; production designer,1918,55,68,1973
Stacie Garrett,"['Liberia', 'Montserrat']",Explorer,1885,50,33,1935
Mr. Chris Irwin,"['Russian Federation', 'Norfolk Island']",Athlete,1914,51,53,1965
James Flores,"['Germany', ""Cote d'Ivoire""]",Entrepreneur,1911,17,14,1928
Alison Hodges,"['Somalia', 'Norway']",Politician,1920,46,72,1966
Justin Larsen,['United Arab Emirates'],Artist,1878,15,80,1893
Charles Combs,"['Cocos (Keeling) Islands', 'India']",Politician,1923,71,75,1994
Rebecca Villanueva,['Dominican Republic'],Athlete,1894,14,66,1908
Nathan Love,['Hong Kong'],Artist,1895,43,64,1938
Jason Brennan,"['Ghana', 'Iran']",Artist,1912,35,55,1947
Laura Mcfarland,['Oman'],Politician,1902,37,87,1939
Anna Schroeder,['Antigua and Barbuda'],Artist,1894,81,43,1975
Anthony Howell,['Western Sahara'],Artist,1886,81,20,1967
Tyler Burton,"['Samoa', 'Macao']",Artist,1909,46,10,1955
Timothy Morrison,['North Macedonia'],Geodesist; explorer,1911,9,70,1920
Jason Reed,"['Australia', 'French Southern Territories']",Student; spree killer; mass murderer,1901,53,72,1954
Christian Howell,['Mexico'],Artist,1873,63,22,1936
Courtney Smith,"['Saudi Arabia', 'Malaysia']",Athlete,1906,38,33,1944
Jake Hall,['Togo'],Artist,1916,65,22,1981
Tammie Brown,['Congo'],Artist,1907,56,74,1963
Erika Dougherty,"['Guernsey', 'Montenegro']",Artist,1903,25,38,1928
William Davis,"['Yemen', 'Trinidad and Tobago']",Politician,1889,86,73,1975
Joshua Day,['Bulgaria'],Artist,1924,47,63,1971
Michelle Clay,"['Heard Island and McDonald Islands', 'Italy']",Artist,1897,77,27,1974
Nathaniel Walker,"['Malta', 'Nauru']",Artist,1883,88,25,1971
Rebecca Harmon,['Saint Martin'],Politician,1896,24,27,1920
Richard Wilson,"['Marshall Islands', 'Spain']",Religious figure,1897,31,48,1928
Thomas Brown,"['Gabon', 'Cuba']",Student; revolutionary,1923,51,83,1974
Jennifer Bruce,"['Iceland', 'New Caledonia']",Stand-up comedian,1877,52,88,1929
Jason White,"['Georgia', 'Dominica']",Artist,1918,10,29,1928
Jessica Rodriguez,"['Norfolk Island', 'Lebanon']",Researcher,1873,23,87,1896
Manuel Juarez,['Denmark'],Researcher,1891,12,66,1903
Faith Pearson,['Zambia'],Politician,1883,69,76,1952
James Smith,['French Southern Territories'],Artist,1870,12,33,1882
Jackie Mann,['Argentina'],Show jumper,1898,85,19,1983
Michele Rodriguez,"['Saudi Arabia', 'Senegal']",Artist,1878,67,4,1945
Angela Robinson,['Andorra'],Researcher,1915,18,42,1933
Kimberly Howard,"['Gambia', 'Hong Kong']",Artist,1876,59,15,1935
Grant Lee,"['Palau', 'Azerbaijan']",Athlete,1912,48,2,1960
Alexandria Leach,['Uruguay'],Professional wrestler,1903,39,48,1942
Sue King,['Maldives'],Religious figure,1905,43,48,1948
Sean Compton,"['Greece', 'Sweden']",Journalist,1914,59,63,1973
Brittany Villegas,['Paraguay'],Social reformer,1870,60,36,1930
Brooke Mcintosh,"['Saint Barthelemy', 'Equatorial Guinea']",Military personnel,1896,80,76,1976
David Williams,"['Korea', 'Saint Pierre and Miquelon']",Explorer,1877,25,89,1902
William Hansen,['Saint Lucia'],Artist,1910,30,89,1940
Joseph Allen,['Vanuatu'],Businessperson,1889,62,80,1951
Christina Wilcox,['Madagascar'],Artist,1887,65,52,1952
Desiree Tate,['Suriname'],Religious figure,1901,33,12,1934
Javier Cooper,"['Armenia', 'Burkina Faso']",Artist,1887,58,48,1945
Cody Goodman,['Mongolia'],Artist,1908,1,27,1909
Christopher Contreras,['British Virgin Islands'],Athlete,1887,68,37,1955
Brenda Conner,"['Rwanda', 'Papua New Guinea']",Military personnel,1904,56,63,1960
Jesse Hicks,['Micronesia'],Researcher,1873,1,35,1874
Ernest Paul,['Taiwan'],Artist,1880,89,55,1969
Michael Bell,"['New Zealand', 'Poland']",Racing automobile driver,1902,45,16,1947
Jordan Thornton,"['Turks and Caicos Islands', 'Ethiopia']",Politician,1882,65,57,1947
Anthony Green,"['Sierra Leone', 'Saint Vincent and the Grenadines']",Artist,1879,21,7,1900
Luis Manning,['Vietnam'],Researcher,1910,48,26,1958
Joel Lewis,['Czech Republic'],Athlete,1890,24,6,1914
Brooke Williams MD,"['Somalia', 'Botswana']",Artist,1910,45,52,1955
Cindy Garcia,['Mongolia'],Artist,1900,40,68,1940
Lindsey Russell,['Mongolia'],Artist,1921,82,89,2003
Ashley Richardson,['Papua New Guinea'],Businessperson,1874,80,28,1954
Kelsey Mata,"['Haiti', 'Lebanon']",Athlete,1873,8,11,1881
Kelly Murphy,"['Philippines', 'Ireland']",Artist,1899,78,34,1977
Angela Shaw,['Sri Lanka'],Politician,1882,38,49,1920
Kelly Francis,"['Singapore', 'Brazil']",Artist,1923,26,16,1949
Jason Ramsey,"['Congo', 'Egypt']",Politician,1871,47,10,1918
Nicole Long,"['French Southern Territories', 'Portugal']",Artist,1872,48,61,1920
Steven Zuniga,['Cambodia'],Artist,1910,17,67,1927
Larry Bray,['Hungary'],Athlete,1907,69,59,1976
Kathryn Haynes,['Bhutan'],Artist,1887,30,31,1917
Heidi Howell,['Tajikistan'],Artist,1907,19,34,1926
Nancy Graves,['Saint Vincent and the Grenadines'],Researcher,1914,50,10,1964
Donna Hernandez,['Antigua and Barbuda'],Politician,1882,86,5,1968
Matthew Edwards,['Saint Vincent and the Grenadines'],Artist,1921,4,68,1925
Phillip Hernandez,"['Nauru', 'French Polynesia']",Athlete,1870,67,15,1937
Anthony Mclaughlin,"['Lebanon', 'Jamaica']",Athlete,1889,22,38,1911
Brandi Bray,"['Niue', 'Japan']",Researcher,1880,3,75,1883
Nicole Ward,['Nicaragua'],Politician,1883,29,46,1912
Tanya Jones,['Martinique'],Artist,1889,58,60,1947
Emily Olson,['Dominican Republic'],Researcher,1898,25,68,1923
Ricky Roberts,"['Saint Lucia', 'Greenland']",Artist,1876,57,11,1933
Jimmy Cannon,"['Andorra', 'South Africa']",Artist,1878,70,89,1948
Lucas Foley Jr.,['Venezuela'],Artist,1876,68,58,1944
Lauren Barker,['Burkina Faso'],Artist,1908,69,54,1977
Jeffrey Fernandez,['Congo'],Film producer,1890,0,13,1890
Robert Kemp,['Albania'],Artist,1914,64,50,1978
Monica Morales,"['Turks and Caicos Islands', 'United Kingdom']",Artist,1920,29,32,1949
Daniel Peterson,"['American Samoa', 'Cook Islands']",Artist,1904,41,87,1945
Michael Young,['Namibia'],Researcher,1870,86,16,1956
Tammy Weaver,"['Western Sahara', 'Bermuda']",Athlete,1912,8,61,1920
Alfred Ruiz,['Western Sahara'],Athlete,1917,52,40,1969
John Hickman,"['Mali', 'Reunion']",Artist,1882,11,50,1893
James Cervantes,"['Mauritania', 'Madagascar']",Artist,1896,81,13,1977
Karen Wright,"['American Samoa', 'United States of America']",Artist,1919,87,38,2006
Kenneth Jones,['Finland'],Politician,1891,71,22,1962
John Costa,['Congo'],Politician,1877,22,77,1899
Dr. Sandra Patterson MD,['Trinidad and Tobago'],Politician,1895,60,85,1955
John Costa,"['Belize', 'Guyana']",Artist,1923,87,67,2010
Nathan Hinton,['Guyana'],Artist,1897,65,36,1962
Todd Garrison,"['Kiribati', 'Portugal']",Athlete,1893,7,65,1900
Hannah Nguyen,['Slovenia'],Artist,1912,46,60,1958
Tony Young,['Brazil'],Artist,1893,19,60,1912
Molly Young,['Mexico'],Researcher,1884,21,77,1905
Dawn Warren,"['Cuba', 'Yemen']",Military personnel,1904,29,65,1933
Jorge Wood,['Haiti'],Racing automobile driver,1878,47,84,1925
Jessica Brewer,['Sao Tome and Principe'],Artist,1891,3,38,1894
Tiffany Johnson,"[""Cote d'Ivoire""]",Athlete,1914,47,89,1961
Sarah Rodgers,['Iceland'],Athlete,1913,48,67,1961
Helen Perez,['Christmas Island'],Artist,1874,78,23,1952
Kim West,['Romania'],Artist,1921,19,5,1940
Austin Rivera,"['Vanuatu', 'Angola']",Military personnel,1908,74,17,1982
Kimberly Estrada MD,['Portugal'],Teacher,1890,18,61,1908
Brittany Kim,['Guernsey'],Politician,1905,42,1,1947
Erika James,['Iraq'],SalonniÃ¨re,1911,50,86,1961
Barbara Griffin,"['Lebanon', 'Saint Vincent and the Grenadines']",Athlete,1895,9,68,1904
Tammy Burton,"['Bolivia', 'Western Sahara']",Aristocrat,1914,62,14,1976
Sean Riley,"['Hong Kong', 'Andorra']",Artist,1915,37,70,1952
Kimberly Foster,"['Mali', 'New Caledonia']",Military personnel,1900,19,73,1919
Kathleen Franklin,"['Kazakhstan', 'Nigeria']",Religious figure,1884,10,35,1894
Keith Navarro,"['United States Virgin Islands', 'Mongolia']",Researcher,1892,43,77,1935
Michael Hicks,['Seychelles'],Artist,1922,65,52,1987
Nathan Franco,['Christmas Island'],Artist,1891,49,86,1940
Robert Murphy,"['American Samoa', 'Reunion']",Artist,1883,17,44,1900
Lindsey Obrien,"['Bosnia and Herzegovina', 'Mali']",Amateur wrestler,1880,23,41,1903
Eric Dennis,['Honduras'],Politician,1882,40,70,1922
John Daniels,"['Niger', 'French Southern Territories']",Artist,1880,55,33,1935
Adam Hutchinson,['Sierra Leone'],Artist,1904,87,44,1991
Jason Gutierrez,['United Arab Emirates'],Artist,1882,85,33,1967
Melinda Brewer,"['Latvia', 'Ukraine']",Artist,1888,84,44,1972
Debra King,"['Malawi', 'Mali']",Researcher,1878,70,10,1948
Sabrina Pena,['Jamaica'],Athlete,1887,53,57,1940
David Martin,['Malawi'],Racing automobile driver; formula one driver,1914,46,41,1960
David Schwartz,"['Angola', 'Chile']",Artist,1924,76,69,2000
Scott Petersen,['Grenada'],Athlete,1899,78,79,1977
Mrs. Melinda Hale,['Cuba'],Politician,1889,80,23,1969
Deborah Huynh,"['Turks and Caicos Islands', 'Guatemala']",Artist,1900,50,14,1950
Kayla Saunders,['Montserrat'],Artist,1878,15,49,1893
Brenda Peterson,"['Kuwait', 'France']",Politician,1910,11,9,1921
Kristina Sullivan,"['Germany', 'Mayotte']",Researcher,1906,86,38,1992
Joseph Sutton,"['Swaziland', 'Oman']",Politician,1895,55,11,1950
Sarah Randolph,"['Luxembourg', 'Luxembourg']",Artist,1897,38,22,1935
Harold Pruitt,['Saint Helena'],Artist,1913,54,38,1967
John White,"['South Georgia and the South Sandwich Islands', 'Philippines']",Artist,1890,35,61,1925
Brian White,['Romania'],Politician,1906,85,18,1991
William Wright,['Azerbaijan'],Politician,1874,12,75,1886
Matthew Webb,['Czech Republic'],Athlete,1874,20,45,1894
Shawn Casey,['Cook Islands'],Racing automobile driver; formula one driver,1881,0,86,1881
Mitchell Miller,"['Isle of Man', 'Brunei Darussalam']",Artist,1896,33,46,1929
Shannon Diaz,"['Central African Republic', 'Yemen']",Artist,1888,18,48,1906
Amy Taylor,"['Australia', 'Cocos (Keeling) Islands']",Artist,1874,80,23,1954
Morgan Osborne,['Liberia'],Artist,1924,28,89,1952
Thomas Knight,['Morocco'],Artist,1903,86,74,1989
Kristopher Davis,['Paraguay'],Politician,1920,0,53,1920
Nathan Rhodes,"['Russian Federation', 'Jordan']",Advocate; resistance fighter,1921,87,59,2008
Lauren Mcdonald,['French Southern Territories'],Artist,1895,74,27,1969
Stephen Mills,['Israel'],Politician,1891,26,37,1917
Jeremy Collins,['Cyprus'],Military personnel,1877,66,77,1943
April Holloway,['Saint Helena'],Researcher,1892,83,4,1975
Claudia Proctor,['Greenland'],Film producer,1881,15,13,1896
Mark Strong,"['Malta', 'French Guiana']",Athlete,1873,7,16,1880
Wanda Bond,['India'],Artist,1912,26,10,1938
Michael Moreno,['Armenia'],Teacher,1894,80,68,1974
Daniel Reyes,"['Papua New Guinea', 'Macao']",Cinematographer; camera operator,1876,61,63,1937
Paul Castro,['Angola'],Cross-country skier,1913,26,51,1939
Carolyn Knight,"['Guinea', 'Zambia']",Athlete,1881,31,7,1912
Kevin Johnson,"['Tuvalu', 'Israel']",Artist,1888,75,66,1963
Kenneth Edwards,"['Spain', 'Saint Helena']",Artist,1883,55,19,1938
Robert Watts,['Afghanistan'],Athlete,1879,47,75,1926
Joann Russell,['Bulgaria'],Researcher,1870,0,34,1870
Jennifer Marks,['Madagascar'],Military personnel,1878,11,87,1889
Jacqueline White,"['Luxembourg', 'Macao']",Artist,1923,50,4,1973
Katelyn Everett,['Uzbekistan'],Teacher,1906,81,10,1987
Aaron Serrano,"['Czech Republic', 'Turks and Caicos Islands']",Artist,1895,71,33,1966
Randy Zimmerman,['Uzbekistan'],Artist,1923,30,71,1953
Ann Hanson,['Cook Islands'],Businessperson,1922,19,56,1941
Ann Rodriguez,"['Sri Lanka', 'South Africa']",Athlete,1879,52,72,1931
Gregory Jackson,"['Azerbaijan', 'Comoros']",Politician,1877,59,42,1936
Andrea Carter,['Reunion'],Artist,1909,54,66,1963
Katherine Chandler,['British Indian Ocean Territory (Chagos Archipelago)'],Artist,1912,67,37,1979
Douglas Moody,['Monaco'],Politician,1902,46,5,1948
Michelle Martin,"['Mali', 'United Arab Emirates']",Jeweller; fashion designer; model,1898,76,12,1974
Rachel Smith,['Mongolia'],Artist,1911,17,45,1928
Jeffery West,['Saudi Arabia'],Politician,1900,39,78,1939
William King,['Saint Lucia'],Athlete,1923,47,82,1970
Eric Oconnell,"['Slovakia (Slovak Republic)', 'Luxembourg']",Researcher,1912,84,59,1996
Rhonda Brown,"['Zambia', 'Norfolk Island']",Artist,1905,53,55,1958
Kimberly Yates,['Brunei Darussalam'],Judge,1888,10,23,1898
Carolyn Phillips,['Bosnia and Herzegovina'],Artist,1910,31,12,1941
Robert Taylor,['Jordan'],Politician,1922,83,38,2005
Shane Mcclure,"['United Kingdom', 'British Virgin Islands']",Artist,1896,52,6,1948
Christine Suarez,['Solomon Islands'],Artist,1892,17,23,1909
Adam Howard,"['Burundi', 'Morocco']",Politician,1920,26,29,1946
Jennifer Armstrong,"['Nigeria', 'Taiwan']",Politician,1914,60,9,1974
Priscilla Brown,"['Guernsey', 'China']",Religious figure,1923,53,64,1976
Theresa Chase,['Uzbekistan'],Socialite,1896,81,84,1977
Jordan Miller,['Namibia'],Artist,1898,19,25,1917
Andrew Mason,['Solomon Islands'],Artist,1888,53,47,1941
Omar Carroll,['France'],Artist,1916,31,83,1947
Megan Martin,['Jordan'],Criminal,1920,47,46,1967
Dean George,"['Switzerland', 'Bahrain']",Researcher,1888,22,2,1910
Troy Collins,['Montserrat'],Athlete,1916,11,40,1927
Christina Miller,['Bulgaria'],Researcher,1917,40,27,1957
Cristina Harper,['New Caledonia'],Superior general,1904,21,8,1925
Jose Gonzalez,"['Mali', 'Nicaragua']",Artist,1882,80,10,1962
Lee Weber,['Palestinian Territory'],Politician,1886,26,31,1912
Michael Garcia,['Bahrain'],Politician,1903,47,75,1950
Neil Price,"['Vietnam', 'Jersey']",Researcher,1887,58,32,1945
Samantha Stewart,"['Canada', 'United States Virgin Islands']",Artist,1885,50,51,1935
Brian Watson,['Hungary'],Artist,1913,85,11,1998
Angela Jimenez,['Togo'],Artist,1873,70,28,1943
Curtis Price,"['Slovenia', 'Kazakhstan']",Athlete,1876,78,59,1954
Garrett Price,"['American Samoa', 'Djibouti']",Artist,1903,49,89,1952
Sheri Johnson MD,"['Cocos (Keeling) Islands', 'Anguilla']",Athlete,1911,43,71,1954
Teresa Clements,"['Sao Tome and Principe', 'Ukraine']",Artist,1909,57,15,1966
Kevin Little,['French Guiana'],Artist,1874,77,23,1951
Marcus Steele,"['Romania', 'Ecuador']",Politician,1892,24,73,1916
Heather Serrano,"['Croatia', 'Barbados']",Politician,1888,8,8,1896
Julia Martin,"['Taiwan', 'Solomon Islands']",Politician,1890,56,50,1946
Chris Hill,['Egypt'],Military personnel,1920,61,14,1981
Sara Hall,"['Netherlands Antilles', 'Malta']",Politician,1873,43,14,1916
Sarah Thomas,"['Spain', 'Congo']",Artist,1905,34,19,1939
Leslie Henderson,"['British Indian Ocean Territory (Chagos Archipelago)', 'Bangladesh']",Artist,1894,40,24,1934
Stephen Adams,['Finland'],Artist,1887,1,64,1888
Brandy Gardner,['Malaysia'],Athlete,1877,69,58,1946
Brian Curtis,"['Palestinian Territory', 'Western Sahara']",Artist,1896,27,70,1923
Peter Bautista,['Heard Island and McDonald Islands'],Journalist,1899,71,27,1970
Ana Martinez,['Pakistan'],Artist,1899,30,58,1929
Cindy Taylor,['Haiti'],Artist,1906,65,45,1971
Adam Smith,['Portugal'],Researcher,1895,71,2,1966
Ryan Simmons,"['Namibia', 'Eritrea']",Military personnel,1922,64,74,1986
Thomas Daniel,['Lesotho'],Artist,1898,26,63,1924
Aaron Ramos,"['Papua New Guinea', 'Dominican Republic']",Politician,1907,56,65,1963
Jason Williams,"['Armenia', 'Dominican Republic']",Gangster; extortion,1902,8,36,1910
Melissa Carter,"['China', 'Pitcairn Islands']",Artist,1876,30,21,1906
Mark Bryan,['Wallis and Futuna'],Military personnel,1871,8,36,1879
Sharon Middleton,"['Nauru', 'Niue']",Researcher,1913,30,60,1943
Donald Johnston,"['Mali', 'United States Minor Outlying Islands']",Artist,1911,5,63,1916
Alexander Jones,['Andorra'],Explorer,1896,6,10,1902
Michael Wilson,"['Tunisia', 'Iran']",Researcher,1907,45,21,1952
Nancy Cabrera,['Uzbekistan'],Artist,1919,86,69,2005
Clifford Williamson,"['Faroe Islands', 'Netherlands Antilles']",Military personnel,1909,31,71,1940
Nicole Maldonado,['Cyprus'],Politician,1903,18,48,1921
Michael Lee MD,['Saudi Arabia'],Long-distance runner; marathon runner,1870,88,85,1958
Taylor Smith,['Turkmenistan'],Artist,1900,77,3,1977
Jessica Howard,['Antarctica (the territory South of 60 deg S)'],Artist,1895,35,79,1930
Angela Hobbs,"['Tonga', 'Reunion']",Engineer,1871,20,83,1891
Michael Baker,['Trinidad and Tobago'],Artist,1921,19,33,1940
Michael Clark,"['Swaziland', 'Dominica']",Researcher,1904,48,82,1952
Jose Hart,['Philippines'],Teacher,1910,76,4,1986
Joel Pearson DDS,"['Jordan', 'Micronesia']",Artist,1881,86,55,1967
David Macias,"['Zambia', 'Liechtenstein']",Military personnel,1920,77,25,1997
John Scott,['Haiti'],Athlete,1870,48,51,1918
Beth Kerr,"['Zimbabwe', 'Jordan']",Artist,1887,81,44,1968
Diane Mitchell,"['Vietnam', 'Iran']",Racing automobile driver,1901,69,61,1970
Tyler Stanton,"['Congo', 'Burkina Faso']",Politician,1901,36,41,1937
Cody Robinson,['Cook Islands'],Entrepreneur,1885,69,56,1954
Todd Fisher,['Djibouti'],Artist,1906,33,34,1939
Sean Cameron,"['Nicaragua', 'New Zealand']",Artist,1908,1,62,1909
Edward Mendez,['Kuwait'],Politician,1893,23,38,1916
Andrew Jensen,['Georgia'],Athlete,1901,41,10,1942
Jason Choi,['Canada'],Military personnel,1916,81,66,1997
Jason Barber,"['Brunei Darussalam', 'Tuvalu']",Artist,1892,26,82,1918
Alicia Allen,"['Mongolia', 'Saint Kitts and Nevis']",Artist,1904,67,50,1971
David Shaw,['Afghanistan'],Artist,1902,7,76,1909
Austin Chen,"['French Polynesia', 'Vanuatu']",Politician,1900,47,41,1947
Curtis Williams,['Antarctica (the territory South of 60 deg S)'],Religious figure,1919,16,8,1935
Christopher Simmons,"['Korea', 'Rwanda']",Religious figure,1883,83,2,1966
Tony Hanson,"['Angola', 'Cape Verde']",Businessperson,1900,70,51,1970
Cynthia Thomas,['Belgium'],Researcher,1903,49,75,1952
Michael Chapman,['Algeria'],Politician,1911,25,11,1936
Kenneth Santos MD,"['Vietnam', 'Uganda']",Politician,1896,4,53,1900
Amy Kerr,['Sudan'],Artist,1886,2,43,1888
Theresa Hensley,['Cameroon'],Artist,1890,32,78,1922
Mary Smith,['Burkina Faso'],Artist,1919,83,22,2002
Michael Bell,"['Panama', 'British Virgin Islands']",Military personnel,1892,10,45,1902
Brittany Phillips,['Micronesia'],Politician,1885,9,56,1894
Madison Barton,"['Peru', 'Ireland']",Artist,1887,62,36,1949
Kevin Shaw,['Aruba'],Artist,1894,43,3,1937
Kevin Potter,['Bermuda'],Artist,1903,59,0,1962
James Perez,"['Netherlands Antilles', 'Lebanon']",Artist,1921,69,76,1990
Zachary Savage,['Thailand'],Military personnel,1923,23,47,1946
Kristie Carpenter,['Nicaragua'],Artist,1911,30,9,1941
Brooke Rodriguez,['Ecuador'],Politician,1909,68,22,1977
David Andrews,"['Andorra', 'Lesotho']",Artist,1894,22,53,1916
Joseph Baker,['Lesotho'],Fashion designer; personal stylist; designer,1878,84,29,1962
Allen Jones,"['South Georgia and the South Sandwich Islands', 'Afghanistan']",Researcher,1891,26,81,1917
Stephen Hunt,['Korea'],Artist,1918,48,56,1966
Alexis Wilson,['Kazakhstan'],Artist,1911,79,48,1990
Michelle Harris,"['Chad', ""Lao People's Democratic Republic""]",Artist,1912,57,65,1969
Taylor Flowers,['Belarus'],Politician,1894,61,0,1955
Nicholas Rodriguez,['Spain'],Sailor,1919,55,55,1974
Christine Campos,['Mali'],Politician,1915,81,51,1996
Matthew Griffith,"[""Cote d'Ivoire""]",Fashion designer,1880,43,28,1923
Ellen Scott,['Azerbaijan'],Aikidoka,1921,83,61,2004
Bradley Williams,"['Philippines', 'Barbados']",Artist,1886,11,71,1897
Jennifer Bridges,"['French Southern Territories', 'Angola']",Athlete,1923,44,36,1967
Jason Carroll,['Netherlands Antilles'],Artist,1893,64,14,1957
Mackenzie Jackson,['Guatemala'],Artist,1885,18,84,1903
Anthony Jordan,['Micronesia'],Artist,1908,19,7,1927
Margaret Marquez,['Burundi'],Military personnel,1870,6,36,1876
Zachary Palmer,"['Indonesia', 'Cape Verde']",Politician,1892,57,57,1949
Joshua Mason,['Serbia'],Tribal chief,1908,72,55,1980
Patrick Vazquez,"['Russian Federation', 'Albania']",Researcher,1894,1,8,1895
Tamara Williams,['Luxembourg'],Artist,1916,72,40,1988
Tammy Graham,['Uganda'],Athlete,1898,21,29,1919
Brittany Davenport,['Bouvet Island (Bouvetoya)'],Military personnel,1912,41,57,1953
Andrew Davis,['Saint Pierre and Miquelon'],Artist,1884,68,64,1952
Jonathan Bates,['Taiwan'],Businessperson,1889,0,77,1889
Valerie Lara,"['Liechtenstein', 'Hungary']",Researcher,1895,39,65,1934
William Roberts,['Sri Lanka'],Military personnel,1892,75,72,1967
David Moyer,['Senegal'],Artist,1898,4,13,1902
Dale Walker,['Guernsey'],Artist,1906,58,2,1964
Juan Hendrix,"['Niger', 'Iceland']",Artist,1903,59,72,1962
Traci Mack,['French Southern Territories'],Athlete,1873,4,67,1877
Heather Burke,['Martinique'],Artist,1919,20,59,1939
Philip Martin,"['Guatemala', 'French Guiana']",Politician,1923,36,45,1959
Travis Flores,"['Samoa', 'Uruguay']",Artist,1910,38,47,1948
Marcia Garcia,['Kazakhstan'],Politician,1902,22,23,1924
Kristina Kim,"['China', 'Kyrgyz Republic']",Artist,1893,69,39,1962
Sarah Cook,['Mali'],Religious figure,1913,22,63,1935
Stephen Bean,"['Saint Lucia', 'San Marino']",Artist,1877,35,62,1912
Autumn Davidson,['Macao'],Politician,1920,21,52,1941
Kathleen Murray,['Sudan'],Athlete,1889,85,18,1974
Amber Vazquez,['Cape Verde'],Religious figure,1877,15,33,1892
Connie Berry,['Tonga'],Artist,1909,80,48,1989
Randall Huff MD,['Lesotho'],Politician,1923,13,48,1936
Christopher Jordan PhD,['Papua New Guinea'],Sovereign,1913,84,21,1997
Randy Chandler Jr.,"['Gambia', 'Netherlands']",Artist,1871,14,65,1885
Theresa Porter,['Denmark'],Athlete,1920,6,24,1926
Justin Coleman,"['United States of America', 'San Marino']",Professional wrestler; amateur wrestler,1909,55,68,1964
Brenda Glenn,['Guadeloupe'],Journalist,1898,50,63,1948
Janice Reynolds,"['San Marino', 'Singapore']",Politician,1923,30,82,1953
Jeffrey Kerr,"['Oman', 'Honduras']",Artist,1907,32,23,1939
Kelsey Carpenter,"['Iraq', 'Liberia']",Artist,1890,73,70,1963
Allison Lynch,"['Lithuania', 'Turks and Caicos Islands']",Artist,1875,5,45,1880
Kevin Hernandez,['Burundi'],Politician,1887,1,53,1888
Matthew Gonzales,"['Central African Republic', 'French Polynesia']",Racing driver; motorcycle racer; racing automobile driver,1871,11,16,1882
Brooke Moore,['San Marino'],Politician,1874,65,89,1939
Danielle Mendez,['Senegal'],Engineer,1889,86,16,1975
Christopher Bonilla,"['Saint Vincent and the Grenadines', 'Ecuador']",Athlete,1916,30,88,1946
Amanda Bailey,['Afghanistan'],Artist,1913,46,10,1959
Kenneth Stewart,['Saint Helena'],Researcher,1872,22,65,1894
Diamond Barnett,"['Ireland', 'Botswana']",Politician,1880,29,33,1909
Natalie Lozano,"['Madagascar', 'Slovakia (Slovak Republic)']",Artist,1887,71,24,1958
Tracy Mckinney,['Malta'],Religious figure,1894,73,78,1967
Cindy Huffman,"['Guyana', 'Luxembourg']",Artist,1907,0,50,1907
Austin Burns,['Bahamas'],Politician,1915,70,2,1985
Nathan Hamilton Jr.,"['Switzerland', 'Mali']",Politician,1884,68,26,1952
Pamela Bartlett,"[""Cote d'Ivoire"", 'Timor-Leste']",Researcher,1912,41,81,1953
Michael Carr,"['Madagascar', 'United Arab Emirates']",Artist,1885,55,60,1940
Jacqueline Hoffman,"['Chile', 'Isle of Man']",Artist,1883,24,81,1907
Mark Owen,"['Haiti', 'Guam']",Politician,1893,2,8,1895
Gregory Rodriguez,"['Congo', 'Sweden']",Artist,1914,86,60,2000
Michelle Patterson,"['Chile', 'Faroe Islands']",Artist,1892,63,46,1955
Ronald Montes,"['Micronesia', 'Bahrain']",Artist,1889,3,71,1892
Jessica Young,"['Uruguay', 'Congo']",Artist,1906,38,26,1944
Christopher Diaz,"['Georgia', 'Iraq']",Politician,1899,84,46,1983
Cynthia Bates,['Japan'],Athlete,1895,53,6,1948
Wendy Morgan,['Spain'],Artist,1874,16,13,1890
Debra Gallagher,"['Armenia', 'Rwanda']",Athlete,1892,57,72,1949
Dr. Lauren Hansen,"['New Caledonia', 'Israel']",Artist,1916,9,47,1925
Peter Sullivan,"['Ecuador', 'Fiji']",Artist,1896,56,70,1952
Stephen Huang,['Sao Tome and Principe'],Artist,1876,64,67,1940
Daniel Holden,"['Iraq', 'Guinea']",Military personnel,1917,13,20,1930
Brittany Jones,"['Moldova', 'Brazil']",Politician,1909,19,48,1928
Rebecca King,"['Uzbekistan', 'San Marino']",Artist,1877,86,24,1963
Keith West,['Cuba'],Student; revolutionary,1871,26,86,1897
Peter Hood,['Isle of Man'],Artist,1873,9,27,1882
Emily Mclean,"['Kazakhstan', 'Denmark']",Politician,1917,21,1,1938
Christopher Evans,"['Namibia', 'India']",Politician,1875,64,16,1939
Richard Robbins,['French Polynesia'],Artist,1912,33,47,1945
Dana Wall,['Zimbabwe'],Politician,1892,24,56,1916
Ashley Woods,['Korea'],Artist,1922,20,49,1942
Timothy Lee,"['Korea', 'Bhutan']",Researcher,1906,33,48,1939
Mr. Jeffrey Lee,['North Macedonia'],Politician,1914,29,5,1943
Robyn Dunn DDS,"['Bahrain', 'Nigeria']",Artist,1913,60,19,1973
Andrea Singleton,"['Tonga', 'Sierra Leone']",Military personnel,1900,49,9,1949
Jeffrey Noble,"['Somalia', 'Canada']",Politician,1910,49,33,1959
Tiffany Campbell,"['Thailand', 'Bermuda']",Athlete,1899,11,39,1910
Bryan Cox,['Cyprus'],Artist,1897,84,64,1981
Amanda Jones,['Tajikistan'],Artist,1909,29,19,1938
Christopher Butler,"['Belgium', 'Mali']",Artist,1921,82,0,2003
Lisa Gaines,['Eritrea'],Politician,1896,89,19,1985
Brandon Gardner,['Eritrea'],Politician,1911,70,7,1981
Sara Mitchell,"['Sudan', 'Uruguay']",Warlord; archer,1900,49,64,1949
Dominic Stephens,['Myanmar'],Artist,1905,51,57,1956
Anthony Williams,"['Western Sahara', 'Poland']",Artist,1920,40,72,1960
Renee Jackson,['Paraguay'],Artist,1875,70,18,1945
Mitchell Carey,"['Norfolk Island', 'United Arab Emirates']",Artist,1921,63,49,1984
Austin Arnold,"['Norway', 'Malta']",Athlete,1903,22,25,1925
Trevor Lopez,['Cuba'],Artist,1880,4,87,1884
Robert Ray,"['Poland', 'Rwanda']",Aristocrat,1884,9,37,1893
Adam Roberts,['Niger'],Military personnel,1891,36,78,1927
Tammy Bean,['Antarctica (the territory South of 60 deg S)'],Military personnel,1885,66,70,1951
Paul Garrett,['Namibia'],Athlete,1893,45,33,1938
Patricia Black,"['United Kingdom', 'Burkina Faso']",Artist,1902,77,0,1979
James Smith,['Italy'],Politician,1924,26,4,1950
Michael Townsend,['Spain'],Athlete,1913,57,6,1970
Kathryn Smith,['Mongolia'],Politician,1885,79,29,1964
Darius Jones,"['United States Virgin Islands', 'Saint Martin']",Politician,1900,86,63,1986
Nancy Reilly,['United Arab Emirates'],Artist,1887,39,54,1926
Stephanie White,"[""Lao People's Democratic Republic""]",Artist,1906,25,59,1931
Autumn Carney,"['South Georgia and the South Sandwich Islands', 'Kuwait']",Military personnel,1881,29,68,1910
April Nichols,['Guernsey'],Researcher,1924,58,12,1982
Adrian Bradley,['Cayman Islands'],Artist,1880,13,4,1893
Matthew Hall,['Germany'],Artist,1879,22,36,1901
Jason Munoz,"[""Cote d'Ivoire"", 'Finland']",Politician,1909,55,62,1964
David Smith,['Italy'],Artist,1896,18,50,1914
Amy Gomez,['Isle of Man'],Artist,1924,16,11,1940
Charles Richard,['Saint Pierre and Miquelon'],Researcher,1902,77,61,1979
Julie Martinez,['Isle of Man'],Artist,1878,12,72,1890
Sandra Todd,['Czech Republic'],Artist,1889,84,39,1973
Jacob Gonzales,['United States Minor Outlying Islands'],Artist,1870,3,11,1873
Travis Anderson,['Russian Federation'],Military personnel,1873,3,18,1876
Whitney Martinez,['Gambia'],Teacher,1917,63,41,1980
Samantha Roberts,"['Andorra', 'Iran']",Artist,1915,67,88,1982
James Gallagher,['Falkland Islands (Malvinas)'],Politician,1877,65,24,1942
Ann Beck,['Brunei Darussalam'],Artist,1870,63,69,1933
Lisa Fitzgerald,['British Virgin Islands'],Artist,1887,27,30,1914
Felicia Ortiz,"['Kiribati', 'Korea']",Motorcycle racer; racing automobile driver; formula one driver; rally driver,1908,28,68,1936
Theresa Holland,['North Macedonia'],Artist,1898,53,20,1951
Bradley King,['Namibia'],Artist,1878,89,33,1967
Justin Davis,"['Saint Martin', 'Qatar']",Teacher,1875,18,46,1893
Maria Obrien,"['Rwanda', 'Niger']",Artist,1917,9,83,1926
Tamara Smith,['Saint Martin'],Artist,1884,41,76,1925
Michelle Smith,"['Cuba', 'Malaysia']",Researcher,1878,67,81,1945
Anita Trujillo,['Kuwait'],Artist,1902,3,71,1905
Tim Lewis,['Slovenia'],Jeweller; fashion designer; model,1874,5,55,1879
Barbara Bass,['Saint Lucia'],Artist,1899,4,63,1903
Jennifer Montgomery,"['Palestinian Territory', 'Western Sahara']",Artist,1896,70,64,1966
Cathy Bentley,['Kyrgyz Republic'],Teacher,1889,46,1,1935
Kelly Kelly,['United States Minor Outlying Islands'],Teacher,1912,24,0,1936
Oscar Rodriguez,['Andorra'],Artist,1892,3,19,1895
Michele Dillon,['Uzbekistan'],Politician,1903,49,55,1952
Anna Chang,"['Burkina Faso', 'Bermuda']",Artist,1885,67,52,1952
Kyle Russell,['Nauru'],Researcher,1896,42,60,1938
Whitney Lowe,['United Kingdom'],Artist,1896,69,8,1965
Zachary Colon,['Oman'],Artist,1895,52,0,1947
Victoria Ferguson,"['Nicaragua', 'Mali']",Artist,1907,85,35,1992
Audrey Scott,['Thailand'],Artist,1900,71,87,1971
James Crawford,['Argentina'],Politician,1896,75,75,1971
Emily Perez,['Guatemala'],Artist,1870,14,87,1884
Charles Fuller,"['Maldives', 'Gibraltar']",Engineer,1893,36,8,1929
Kaitlyn Thompson,['Turkmenistan'],Artist,1899,78,1,1977
Joseph Jones,"['Puerto Rico', ""Cote d'Ivoire""]",Artist,1911,5,69,1916
Christopher Cervantes,"['Somalia', 'Costa Rica']",Politician,1916,79,85,1995
Kevin Welch,['Eritrea'],Artist,1916,58,17,1974
Tyler Jackson,"['Nauru', 'Swaziland']",Military personnel,1894,55,77,1949
Henry Hurley,['Portugal'],Religious figure,1888,23,76,1911
Donald Baker,"['Angola', 'Hong Kong']",Artist,1876,0,57,1876
Theresa White,"['Brunei Darussalam', 'Faroe Islands']",Athlete,1877,4,69,1881
David Vargas,['Cayman Islands'],Artist,1921,36,54,1957
Shawn Stevens,['Gibraltar'],Politician,1893,73,46,1966
Madison Macdonald,"['Belgium', 'Denmark']",Artist,1922,81,83,2003
Marc Smith,"['Saint Barthelemy', 'Saudi Arabia']",Artist,1874,60,69,1934
Dawn Delgado,"['Saint Vincent and the Grenadines', 'Pakistan']",Researcher,1882,45,15,1927
Brian Porter,['Nicaragua'],Artist,1892,34,36,1926
Natasha Duffy DVM,['Hungary'],Artist,1880,53,13,1933
Megan Martin,['Netherlands Antilles'],Politician,1905,67,84,1972
Albert Hess,"['Tuvalu', 'Northern Mariana Islands']",Researcher,1916,20,51,1936
Amber Macias,['Rwanda'],Artist,1870,44,62,1914
Erica Johnson,['Turks and Caicos Islands'],Artist,1873,59,75,1932
Amy Allen,"['Switzerland', 'Venezuela']",Athlete,1899,61,36,1960
Joanna Sims,"['Russian Federation', 'Congo']",Formula one driver,1916,41,24,1957
Tammy Leonard,['Slovakia (Slovak Republic)'],Athlete,1902,24,64,1926
Megan Sosa,['San Marino'],Teacher,1896,36,5,1932
Trevor Freeman,['Paraguay'],Politician,1911,35,73,1946
Mary Carter,['Bangladesh'],Military personnel,1904,79,6,1983
Tina Perez,['Zambia'],Military personnel,1914,47,56,1961
Heather Lamb,['Jordan'],Politician,1880,62,35,1942
Kristy Mccoy,['Finland'],Artist,1904,60,2,1964
Kimberly Gallegos,['Andorra'],Artist,1902,21,19,1923
Edward Jackson,['Greenland'],Artist,1883,64,66,1947
Edward Hodges,"['Christmas Island', 'New Caledonia']",Religious figure,1923,2,47,1925
Jennifer Ellis,['Uganda'],Military personnel,1892,33,63,1925
Dennis Young,['Sweden'],Athlete,1902,10,24,1912
Amanda Weber,"['El Salvador', 'Western Sahara']",Businessperson,1922,89,1,2011
Ashley Ferguson,"['Guinea-Bissau', 'Saint Helena']",Religious figure,1918,86,34,2004
Laura Arroyo,['Tajikistan'],Politician,1883,21,0,1904
Jerry Chaney,"['Albania', 'Philippines']",Artist,1898,29,50,1927
Jesus Williams,['Cape Verde'],Politician,1898,17,27,1915
Donald Mckee,"['Rwanda', 'Marshall Islands']",Artist,1916,10,24,1926
Brian Harmon,['Benin'],Artist,1884,81,59,1965
Peggy Ferrell DDS,['South Georgia and the South Sandwich Islands'],Anthropologist,1920,14,54,1934
Taylor Cox,['Lithuania'],Athlete,1894,71,37,1965
Jane Robles,['Slovenia'],Artist,1903,56,57,1959
Jennifer Coffey,"['Guadeloupe', 'Montserrat']",Athlete,1915,58,36,1973
Andres Dunlap,['Canada'],Playwright; author; novelist,1915,2,33,1917
Kristin Martin,['French Guiana'],Psychic,1891,41,72,1932
Edward Rodriguez,"['Burundi', 'Saint Helena']",Artist,1872,21,27,1893
Vincent Peterson,"['Niger', 'Pakistan']",Politician,1890,56,62,1946
Miguel Warren,"['Dominican Republic', 'Kazakhstan']",Artist,1895,50,22,1945
Mrs. Katherine Lambert,"['Zambia', 'Togo']",Artist,1901,8,50,1909
Lori Martinez,['Argentina'],Politician,1884,47,56,1931
Lisa Roberts,"['Germany', 'Dominican Republic']",Athlete,1912,53,18,1965
Kelly Sutton,['Saint Barthelemy'],Athlete,1900,37,18,1937
Patrick Anderson,"['Kuwait', 'Guyana']",Artist,1879,29,2,1908
Martha Fletcher,['Germany'],Artist,1885,17,55,1902
Amy Phillips,"['Angola', 'Antigua and Barbuda']",Artist,1903,72,27,1975
Gordon Harding,['Norway'],Artist,1874,39,12,1913
Jacqueline Johnson,['Greenland'],Artist,1913,50,1,1963
Shawn Reyes,"['Chad', 'Latvia']",Politician,1923,49,33,1972
Diana Henson,"['Cayman Islands', 'Ethiopia']",Politician,1871,57,48,1928
Paul Edwards,['Uzbekistan'],Artist,1872,21,86,1893
Mrs. Sheila Conner MD,['United Arab Emirates'],Researcher,1880,60,59,1940
Emily Klein,['New Caledonia'],Artist,1871,66,80,1937
Christine Hodge,"['Vietnam', 'Uzbekistan']",SalonniÃ¨re,1901,40,39,1941
John Rogers,['Oman'],Socialite,1909,52,69,1961
Jack Scott,['British Indian Ocean Territory (Chagos Archipelago)'],Athlete,1906,80,75,1986
Rebecca Davis,"['Kiribati', 'Saint Lucia']",Politician,1922,28,68,1950
James Gonzalez,['Saint Pierre and Miquelon'],Artist,1893,63,64,1956
Chad Lopez,['Slovenia'],Artist,1914,82,33,1996
John Palmer,"['Switzerland', 'Haiti']",Athlete,1900,15,3,1915
Corey Dean,['Greece'],Engineer,1906,35,87,1941
Anthony Wiggins,['South Georgia and the South Sandwich Islands'],Entrepreneur,1888,27,7,1915
Jeffrey Cook,"['Jamaica', 'New Caledonia']",Artist,1872,18,70,1890
Alan Mcclain,"['Korea', 'Sri Lanka']",Businessperson,1908,82,9,1990
Cynthia Fox,['Madagascar'],Amateur wrestler,1878,40,50,1918
Caroline Bush,"['Slovenia', 'Cambodia']",Politician,1880,79,40,1959
Jeremiah Anderson,"['United States of America', 'El Salvador']",Architect,1895,2,75,1897
Dr. Brittany Cox,"['San Marino', 'Malawi']",Astronomer,1922,2,22,1924
Daniel Hoffman,['Oman'],Military personnel,1896,21,79,1917
Michele Morse,"['Afghanistan', 'Cambodia']",Athlete,1903,69,40,1972
Anthony Rodriguez,['Niger'],Athlete,1892,52,6,1944
Sherry Bryant,"['North Macedonia', 'Canada']",Artist,1923,35,56,1958
Kendra Pierce,"['Haiti', 'Indonesia']",Politician,1902,6,78,1908
Ricky Thompson,"['Falkland Islands (Malvinas)', 'United States Minor Outlying Islands']",Artist,1901,61,12,1962
Dana Scott,['Angola'],Politician,1915,81,78,1996
Mrs. Jill Estrada,['Bahamas'],Artist,1913,44,74,1957
John Park,"['Equatorial Guinea', 'Finland']",Politician,1919,20,85,1939
Jeremy Rogers,['Nepal'],Athlete,1921,11,36,1932
Scott Baker,"['Dominica', 'Solomon Islands']",Politician,1892,13,85,1905
Christina Vincent,['Israel'],Artist,1888,77,56,1965
Maria Smith,['Ukraine'],Physician,1894,2,75,1896
Stephanie Melton,"['Czech Republic', 'El Salvador']",Artist,1871,48,28,1919
Gabrielle Lewis,['Vanuatu'],Religious figure,1871,60,81,1931
Jason Jones,"['Marshall Islands', 'American Samoa']",Politician,1903,66,2,1969
Michael Lane,['Kyrgyz Republic'],Resistance fighter,1885,73,40,1958
Denise Martinez,"['Belize', 'Guernsey']",Christians jehovahâ€™s witnesses,1883,50,39,1933
Johnathan Shea,"['Botswana', 'Dominica']",Artist,1902,80,69,1982
Bryan Macias,"['Ukraine', 'Vietnam']",Researcher,1870,29,17,1899
Damon Petty,['Hungary'],Artist,1903,76,18,1979
Ryan Porter,['Denmark'],Athlete,1917,43,47,1960
Blake Hall,"['British Virgin Islands', 'Bosnia and Herzegovina']",Artist,1897,17,15,1914
Bradley Williams,"['Slovakia (Slovak Republic)', 'Cape Verde']",Researcher,1873,70,85,1943
Angela White,"['Finland', 'Saudi Arabia']",Artist,1922,43,73,1965
John Haynes,"[""Cote d'Ivoire""]",Artist,1921,65,28,1986
Patrick Moore,['Russian Federation'],Sovereign,1875,0,65,1875
Sharon Welch,"['Madagascar', 'South Georgia and the South Sandwich Islands']",Journalist,1879,30,35,1909
Sherry Craig,"['Russian Federation', 'Dominican Republic']",Artist,1910,86,16,1996
Adam Holland MD,['Liberia'],Artist,1915,8,71,1923
Dorothy Fisher,"['Libyan Arab Jamahiriya', 'Cameroon']",Ruler,1875,37,43,1912
Mark Skinner,['Dominican Republic'],Athlete,1894,17,82,1911
Richard Smith,"['Malawi', 'Liberia']",Artist,1876,10,27,1886
Kelly Scott,"['United States Minor Outlying Islands', 'Zambia']",Artist,1890,82,44,1972
Travis May,"['Saint Pierre and Miquelon', 'Cayman Islands']",Artist,1883,40,11,1923
Sandra Coleman,['Botswana'],Artist,1906,84,11,1990
Robert Espinoza,"[""Cote d'Ivoire""]",Artist,1878,68,61,1946
Sarah Bryant,"['Colombia', 'Chad']",Politician,1914,72,60,1986
Rodney Williams,['Indonesia'],Athlete,1882,65,62,1947
Megan Smith,['Mauritius'],Military personnel,1880,79,15,1959
Stanley Daugherty,"['Saint Pierre and Miquelon', 'Antigua and Barbuda']",Politician,1916,23,53,1939
Natalie Moore,['Portugal'],Artist,1888,29,38,1917
Sherry Vargas,['Mongolia'],Politician,1879,50,46,1929
Nicole Mcdonald,"['Jamaica', 'Belize']",Researcher,1886,83,12,1969
Michelle Dawson,"['Turks and Caicos Islands', 'Argentina']",Politician,1879,59,87,1938
Laura Carlson,"['Sudan', 'Jordan']",Artist,1871,67,10,1938
Nathan Mays,"['French Polynesia', 'Russian Federation']",Conductor,1891,35,22,1926
Aaron Yang,"['Liechtenstein', 'Australia']",Racing automobile driver; formula one driver,1918,62,59,1980
Zachary Fitzgerald,['Martinique'],Artist,1919,4,88,1923
Marisa Carey,['Cayman Islands'],Entrepreneur,1895,66,79,1961
Jose Wright,['Tonga'],Artist,1887,27,50,1914
Jared Griffin,['Tajikistan'],Artist,1898,24,14,1922
Thomas Cruz,['Tonga'],Researcher,1902,69,87,1971
Sean Harris,"['Jersey', 'Monaco']",Artist,1902,10,51,1912
Vanessa Moore,['Armenia'],Artist,1898,59,69,1957
Nicole Cruz,['Jersey'],Athlete,1923,89,4,2012
Marissa Sims,"[""Lao People's Democratic Republic"", 'North Macedonia']",Artist,1884,2,56,1886
Ryan Conway,"['Guyana', 'Svalbard & Jan Mayen Islands']",Athlete,1880,19,15,1899
Shawn Garcia,"['Wallis and Futuna', 'French Guiana']",Artist,1874,85,51,1959
Mrs. Audrey Parker,"['Tonga', 'Nepal']",Artist,1908,49,17,1957
Jeffrey Murphy,['Azerbaijan'],Artist,1902,88,67,1990
Shelly Kennedy,['Liberia'],Athlete,1909,18,78,1927
David Smith,"['Afghanistan', 'Cape Verde']",Artist,1896,73,66,1969
Tammy Harris,"['Czech Republic', 'French Southern Territories']",Politician,1904,11,25,1915
Emily Brown,['New Caledonia'],Canoeist; kayaker,1912,9,52,1921
Thomas Kelly,"['Ghana', 'Chad']",Religious figure,1917,1,58,1918
Jason Norman,"['Iceland', 'Sweden']",Artist,1910,43,59,1953
Kathy Moore,['Bahrain'],Artist,1877,50,48,1927
Benjamin Kelley,"['Qatar', 'Jordan']",Politician,1873,17,68,1890
Amanda Ward,['Iraq'],Businessperson,1893,33,39,1926
Jasmine Thomas,['French Southern Territories'],Politician,1896,42,85,1938
Lee Vasquez,['Norway'],Artist,1920,34,15,1954
April Jordan,"['Turkey', 'Vietnam']",Artist,1872,72,32,1944
Lisa Campbell,['Tunisia'],Athlete,1889,87,33,1976
William Patterson,"['Nigeria', 'Tokelau']",Artist,1895,81,65,1976
Andrea Hines,"['Croatia', 'Saint Lucia']",Monk,1872,55,35,1927
Dustin Michael,['Afghanistan'],Politician,1884,19,87,1903
Brenda Allen,"['Barbados', 'United States Minor Outlying Islands']",Politician,1886,3,33,1889
Christopher Walker,"['Spain', 'Western Sahara']",Artist,1902,7,25,1909
Eduardo Le,"['Austria', 'Aruba']",Politician,1892,86,11,1978
Jane Pineda,"['Malaysia', 'Palestinian Territory']",Researcher,1919,65,76,1984
Briana Holt,['Latvia'],Magician,1913,79,7,1992
Jennifer Mahoney,"['United States Virgin Islands', 'Italy']",Politician,1921,1,43,1922
Mary Ford,"['Sierra Leone', 'United States Minor Outlying Islands']",Artist,1872,41,15,1913
Brittany Adkins,"['Trinidad and Tobago', 'Panama']",Researcher,1916,69,38,1985
Nicole Williams,['Algeria'],Artist,1878,70,27,1948
James Maxwell,['Colombia'],Athlete,1872,70,89,1942
William Johnson,"['Fiji', 'Saint Barthelemy']",Military personnel,1914,45,18,1959
Sarah Myers,"['Palestinian Territory', 'Israel']",Conductor,1882,13,83,1895
Lori Randolph,['Somalia'],Street vendor,1893,17,67,1910
Alicia Nelson,['Liberia'],Artist,1916,30,83,1946
Jessica Daniels,"['Luxembourg', 'Somalia']",Politician,1889,31,69,1920
Christopher Cabrera,['Japan'],Artist,1876,88,58,1964
Cody Murillo,"['Portugal', 'Bouvet Island (Bouvetoya)']",Artist,1892,40,28,1932
Debra Martinez,"['Tonga', 'Chad']",Athlete,1884,28,14,1912
Phyllis Perez,['Sudan'],Presbyter,1885,0,53,1885
Denise Ponce,['Denmark'],Politician,1915,78,38,1993
David Carter,['Norway'],Artist,1922,21,47,1943
Justin Stevens,"['Sri Lanka', 'Gabon']",Journalist,1870,34,23,1904
Wendy Yates,['Sierra Leone'],Military personnel,1909,17,3,1926
Rachel Johnson,['United States Minor Outlying Islands'],Artist,1905,30,13,1935
Raymond Randolph,"['Barbados', 'Bangladesh']",Researcher,1880,35,75,1915
Juan Carroll,"['Cyprus', 'Cook Islands']",Artist,1917,39,8,1956
Robert Robinson,"['Botswana', 'Mauritania']",Researcher,1915,89,82,2004
Nathan Perez,['Comoros'],Researcher,1870,80,31,1950
Joseph Holden,['Vietnam'],Journalist,1883,48,12,1931
Vanessa Williams,['Malawi'],Politician,1880,65,35,1945
Amanda Fitzpatrick,['Lithuania'],Artist,1919,75,54,1994
Ryan Black Jr.,"['Belgium', 'Albania']",Athlete,1882,36,59,1918
Kathryn Mathews,['Sri Lanka'],Artist,1870,30,88,1900
Logan Barron,"['Seychelles', 'Bosnia and Herzegovina']",Serial killer; criminal,1918,55,79,1973
Jacqueline Vargas,"['Rwanda', 'Antarctica (the territory South of 60 deg S)']",Artist,1891,86,84,1977
Regina Jackson,"['Guadeloupe', 'Solomon Islands']",Criminal,1889,20,48,1909
Sandra Blair,['Tajikistan'],Artist,1887,89,25,1976
Chloe Grant,['Isle of Man'],Artist,1899,20,0,1919
Tony Crawford,['Cocos (Keeling) Islands'],Functionary,1905,7,77,1912
Rick Johnson,['Korea'],Researcher,1916,49,28,1965
Jacqueline Mack,['Canada'],Artist,1878,53,56,1931
Jennifer Rodriguez,"['Benin', 'Brazil']",Researcher,1918,4,28,1922
Jason Williams,"['Senegal', 'Macao']",Politician,1890,42,89,1932
Thomas Mason,['Timor-Leste'],Artist,1906,87,0,1993
Shannon Cox,"['Antarctica (the territory South of 60 deg S)', 'Mauritania']",Athlete,1923,82,19,2005
Denise Ballard,['Saint Vincent and the Grenadines'],Artist,1898,39,32,1937
Jill Long,"['Mexico', 'Ecuador']",Athlete,1880,75,56,1955
Juan Wilson,['Uzbekistan'],Artist,1906,85,38,1991
Maria Hughes,"['Chile', 'Mozambique']",Artist,1913,13,86,1926
Mary Thompson,"['Djibouti', 'Greenland']",Artist,1903,44,37,1947
Barbara Phillips,['Philippines'],Artist,1872,72,28,1944
Ryan Garza,['Honduras'],Artist,1902,51,49,1953
Roberto Thompson,['Grenada'],Engineer,1909,6,56,1915
Edward Martinez,['Guatemala'],Artist,1917,13,78,1930
Thomas Johnson,['Dominica'],Athlete,1906,24,70,1930
Samantha Alvarez,"['Slovakia (Slovak Republic)', 'Barbados']",Artist,1896,45,56,1941
Jose Smith,['Holy See (Vatican City State)'],Artist,1901,32,31,1933
Holly Scott,"['Spain', 'Gibraltar']",Criminal,1894,85,79,1979
Carrie Flores,"['Hungary', 'Guyana']",Politician,1881,47,32,1928
James Martin,['Saint Kitts and Nevis'],Artist,1904,60,26,1964
Joanna Bailey,['Serbia'],Artist,1921,64,74,1985
Douglas Atkinson,['Heard Island and McDonald Islands'],Statesperson,1874,51,57,1925
Nichole Hatfield,['Uruguay'],Artist,1917,59,2,1976
Nicholas Stephenson,"['Norfolk Island', 'Tonga']",Artist,1924,88,25,2012
Karen Lane,"['Congo', 'Cyprus']",Military personnel,1906,69,57,1975
Danielle Moore,"['Latvia', 'Nicaragua']",Politician,1906,21,13,1927
Patricia Aguirre,"['Cyprus', 'France']",Artist,1916,39,49,1955
Courtney Donovan,['Costa Rica'],Researcher,1885,36,71,1921
Isaiah Frazier,"['Jamaica', 'United Kingdom']",Politician,1889,20,73,1909
Michael Castro,['Saint Barthelemy'],Entrepreneur,1911,16,58,1927
Lindsay Hamilton,"['Mali', 'Kenya']",Politician,1916,50,39,1966
Allison Wright,['Egypt'],Artist,1911,7,8,1918
Donna Clay,"['China', 'Nauru']",Businessperson,1913,49,84,1962
Justin Hardy,"['Madagascar', 'Tokelau']",Artist,1890,3,77,1893
Anthony Buck,['Kuwait'],Artist,1914,17,39,1931
Gina Hernandez,"['Jamaica', 'Uganda']",Artist,1888,3,15,1891
Jose Archer,['Guadeloupe'],Politician,1878,79,23,1957
Brian Evans,"['Uruguay', 'Niue']",Artist,1882,83,14,1965
Robert Morris,"['Argentina', 'Greece']",Artist,1877,63,4,1940
Jeffrey Long,"['Niue', 'Saint Pierre and Miquelon']",Architect,1905,24,25,1929
Amanda Riggs,"['Israel', 'Malta']",Athlete,1920,42,35,1962
Shawn Richards,['Martinique'],Researcher,1911,65,8,1976
Erika Jarvis,['Portugal'],Politician,1879,30,35,1909
Sandy Campbell,"['Bahrain', 'Sweden']",Researcher,1908,32,58,1940
Taylor Valdez,"['Argentina', 'Tonga']",Artist,1878,50,12,1928
Steven Atkins,"['Malaysia', 'Bolivia']",Politician,1898,88,20,1986
Kenneth Klein,"['Nepal', 'Saudi Arabia']",Artist,1914,46,21,1960
Peter Smith,['Romania'],Motorcycle racer; racing automobile driver; rally driver,1922,32,5,1954
Carla Mcdonald,['Monaco'],Artist,1876,56,74,1932
Alexander Wyatt,"['Slovenia', 'Denmark']",Artist,1875,67,30,1942
Daniel Robinson,['Libyan Arab Jamahiriya'],Researcher,1907,47,77,1954
Pamela Franco,"['Cyprus', 'Libyan Arab Jamahiriya']",Artist,1895,53,22,1948
Brittany Walker,"['Angola', 'Maldives']",Politician,1922,17,85,1939
Christopher Lucas,"['Indonesia', 'Togo']",Artist,1914,55,5,1969
Cynthia Larsen,['Denmark'],Military personnel,1871,38,18,1909
Dr. Sonia Gray,['Georgia'],Artist,1917,8,22,1925
Eddie Kane,"['Equatorial Guinea', 'Svalbard & Jan Mayen Islands']",Artist,1898,18,32,1916
Christopher Rogers,['Switzerland'],Artist,1890,54,12,1944
Eric Robbins,['Azerbaijan'],Artist,1878,55,18,1933
Gary Thomas,['Montserrat'],Spy,1914,57,40,1971
Jessica Suarez,['Yemen'],Military personnel,1918,43,36,1961
Anne Davis,['Saint Vincent and the Grenadines'],Artist,1874,82,15,1956
David Patterson,['Austria'],Politician,1893,74,35,1967
Kelly Jones,['United Kingdom'],Artist,1876,31,39,1907
Jay Leblanc,['Vietnam'],Artist,1884,32,87,1916
Joe Phillips,"['Monaco', 'Montserrat']",Artist,1882,8,37,1890
Bryan Johnson,['Uruguay'],Military personnel,1885,22,87,1907
Kyle May,"['Venezuela', 'French Polynesia']",Athlete,1896,26,8,1922
Heather Oneal,['British Virgin Islands'],Politician,1871,69,74,1940
Adam Medina,['Cocos (Keeling) Islands'],Journalist,1876,39,34,1915
Katherine Meyers,['Samoa'],Artist,1912,3,66,1915
Jennifer Byrd,['San Marino'],Artist,1896,39,73,1935
Nicholas Monroe,['Venezuela'],Politician,1921,32,24,1953
Linda Bryant,"['Solomon Islands', 'Palestinian Territory']",Artist,1871,71,2,1942
Rebecca Black,"['Portugal', 'Australia']",Flower seller; prostitute; crocheter,1893,44,64,1937
Andrea Frey,"['Sri Lanka', 'Ecuador']",Military personnel,1908,58,41,1966
Bonnie Schmidt,['Turkey'],Politician,1873,80,62,1953
Lindsay Vaughan,['Bolivia'],Religious figure,1901,66,30,1967
Vanessa Castillo,['Jordan'],Artist,1920,53,37,1973
Ryan Greene DDS,['Congo'],Artist,1915,11,3,1926
Michael Cooper,['Qatar'],Artist,1905,19,82,1924
Michael Cervantes,['Myanmar'],Nurse; serial killer; criminal,1884,63,67,1947
Kathryn Hawkins,"['Macao', 'Wallis and Futuna']",Artist,1882,46,71,1928
Michelle Strickland,"['Saint Pierre and Miquelon', 'Italy']",Politician,1887,49,64,1936
Mackenzie Galvan,"['Heard Island and McDonald Islands', 'Slovakia (Slovak Republic)']",Jurist,1897,22,35,1919
Marissa Diaz,['Georgia'],Artist,1892,22,8,1914
Mr. John Walker,"['Tonga', 'Montenegro']",Artist,1896,51,76,1947
Anthony Davis,['Svalbard & Jan Mayen Islands'],Artist,1907,66,25,1973
Todd Johnson,['Dominica'],Artist,1917,4,44,1921
Jackson Jones,['Luxembourg'],Researcher,1904,27,17,1931
Bailey Austin,['Uzbekistan'],Politician,1870,80,68,1950
Michael Russell,['Paraguay'],Artist,1891,56,27,1947
Kimberly Burgess,['Rwanda'],Artist,1912,59,68,1971
Brett Smith,['Nigeria'],Artist,1920,59,73,1979
Breanna Wilson,"['Saint Lucia', 'Argentina']",Artist,1888,47,41,1935
Shelly Wise,"['Gabon', 'British Virgin Islands']",Aristocrat,1889,4,88,1893
Mary Lamb,['Turkmenistan'],Politician,1885,15,16,1900
Dominic Bryan,['Belarus'],Artist,1910,59,47,1969
Thomas Morris,"['Kenya', 'Puerto Rico']",Artist,1910,48,42,1958
Colleen Collins,"['Myanmar', 'Guyana']",Artist,1910,24,22,1934
Julia Marks,['Northern Mariana Islands'],Athlete,1912,7,46,1919
Jennifer Martinez DDS,"['Fiji', 'Venezuela']",Artist,1915,46,50,1961
Fernando Wallace,['South Georgia and the South Sandwich Islands'],Artist,1877,21,66,1898
Jessica Woodard,"['Belize', 'Bolivia']",Architect,1908,76,89,1984
Alexander Wang,['Botswana'],Researcher,1920,25,60,1945
Alexander Black,['Tuvalu'],Artist,1878,27,35,1905
Rebecca Mccormick,"['Estonia', 'British Indian Ocean Territory (Chagos Archipelago)']",Politician,1914,58,44,1972
Morgan Simon,['Togo'],Athlete,1921,13,47,1934
Robert Allen,['Namibia'],Artist,1888,86,38,1974
Elizabeth Hill,['Faroe Islands'],Lady-in-waiting,1875,23,23,1898
Jacqueline Gardner,['Myanmar'],Production designer,1914,14,86,1928
Yvette Lawrence,['Sweden'],Artist,1912,66,78,1978
Jordan Boyd,"['Vietnam', 'Lithuania']",Judge,1903,34,68,1937
Jennifer Cunningham,['Angola'],Artist,1909,67,65,1976
Juan Sloan,"['Ireland', 'Netherlands Antilles']",Athlete,1907,68,63,1975
Michelle Harvey,"['Mozambique', 'Montserrat']",Politician,1881,14,13,1895
Christopher Mccarthy,"['Micronesia', 'Timor-Leste']",Politician,1911,82,67,1993
Michele Reese,['Brazil'],Researcher,1893,10,72,1903
Raymond Perry,"['Cayman Islands', 'New Caledonia']",Religious figure,1888,35,82,1923
Felicia Figueroa,['Iceland'],Researcher,1891,30,51,1921
Yvonne Boyle,['Austria'],Athlete,1896,3,53,1899
Juan Anderson,"['Greece', 'Georgia']",Artist,1898,68,83,1966
Gary Morris,['Isle of Man'],Artist,1870,29,32,1899
Kathryn Bradley,['Andorra'],Artist,1900,12,44,1912
Donna Garcia,['Saint Kitts and Nevis'],Artist,1921,42,58,1963
Dana Aguirre,"['Montenegro', 'Lithuania']",Military personnel,1903,0,15,1903
Linda Oneill,['Zimbabwe'],Artist,1899,37,3,1936
Jill Hernandez,['New Caledonia'],Artist,1892,36,22,1928
Benjamin Rice,['Palau'],Artist,1885,54,15,1939
Kevin Roberts,"['Greenland', 'Brazil']",Artist,1882,10,6,1892
Timothy Lee,['Australia'],Military personnel,1908,83,64,1991
Daniel Ballard,"['Poland', 'Svalbard & Jan Mayen Islands']",Artist,1900,31,85,1931
Erin Haas,"['Guatemala', 'Senegal']",Artist,1894,55,48,1949
Molly Martinez,"['Congo', 'Micronesia']",Military personnel,1899,76,5,1975
Jennifer Morris,['Afghanistan'],Politician,1904,74,28,1978
Sherry Davis,['Burundi'],Artist,1895,65,29,1960
Gloria Mason,['Haiti'],Artist,1905,87,18,1992
Scott Aguilar,['Chad'],Artist,1923,65,23,1988
Stephanie Pierce,"['Cameroon', 'Guatemala']",Artist,1882,48,20,1930
Gina Vasquez,['Guadeloupe'],Researcher,1910,44,78,1954
Jeffrey Lowe,"['Sierra Leone', 'Marshall Islands']",Serial killer; criminal,1882,59,43,1941
Jeffrey Johnson,"['Mayotte', 'South Africa']",Artist,1919,61,29,1980
James Garrett,"['Portugal', 'United States of America']",Military personnel,1903,79,22,1982
Martin Sanchez,"['Nauru', 'Venezuela']",Artist,1900,78,75,1978
Robert Mays,['Nicaragua'],Researcher,1872,41,48,1913
Mary Lang,['Bahamas'],Artist,1908,83,59,1991
James Hughes,"['Taiwan', 'United States Virgin Islands']",Military personnel,1889,26,72,1915
Jeffrey Gonzalez,"['Cyprus', 'Australia']",Politician,1912,87,24,1999
Courtney Lopez,"['Peru', 'Bangladesh']",Criminal,1875,44,78,1919
Sarah Cooke,['Lithuania'],Costume designer; fashion designer,1920,52,33,1972
Nicholas Castillo,['Tonga'],Dressage rider,1909,23,62,1932
Donna Daniels,['Brunei Darussalam'],Artist,1879,81,17,1960
Robert Mason,"['Sudan', 'Argentina']",Cardiologist,1909,75,1,1984
John Burton,"['Cape Verde', 'Malaysia']",Costume designer; grand couturier,1886,43,65,1929
Jacob Travis,"[""Cote d'Ivoire"", 'Burkina Faso']",Military personnel,1904,63,5,1967
Cody Carroll,['Sri Lanka'],Maid,1908,0,6,1908
Amanda Hernandez,['Qatar'],Researcher,1888,51,51,1939
Timothy Rodriguez,"['French Southern Territories', 'Dominican Republic']",Journalist,1912,40,21,1952
Jerry Cunningham,"['Montenegro', 'Mongolia']",Artist,1872,21,58,1893
Brooke Martin,['Hong Kong'],Athlete,1871,60,5,1931
William Berger,"['Libyan Arab Jamahiriya', 'Uruguay']",Athlete,1873,71,87,1944
Deanna Lewis,['Spain'],Artist,1895,30,52,1925
Jamie Richardson,"[""Cote d'Ivoire""]",Artist,1897,27,64,1924
Megan Barker,['Holy See (Vatican City State)'],Artist,1892,1,58,1893
Brett Miller,"['Suriname', 'United States Virgin Islands']",Artist,1893,64,74,1957
John Blanchard,['Faroe Islands'],Artist,1910,57,67,1967
Manuel Brown PhD,"['Vietnam', 'Iceland']",Artist,1886,83,75,1969
Susan Matthews,"['Reunion', 'Burkina Faso']",Businessperson,1874,42,34,1916
Tamara Clark,"['Armenia', 'Malaysia']",Politician,1882,20,52,1902
Lonnie Padilla,['Uzbekistan'],Artist,1902,70,9,1972
Theresa Paul,['Burundi'],Military personnel,1890,6,68,1896
Ashley Garcia,['Oman'],Artist,1871,88,41,1959
Randall Benson,['Palau'],Politician,1892,5,15,1897
Andrew Parker,"['Aruba', 'Malawi']",Politician,1887,37,6,1924
Danielle Johnson,['Jersey'],Artist,1907,32,49,1939
Heather Nash,"['Bolivia', 'Tokelau']",Artist,1924,60,20,1984
Michelle Pierce,"['Montenegro', 'Niger']",Artist,1889,21,42,1910
Michael Baker,['Ireland'],Artist,1918,81,43,1999
Gerald Walker,['Oman'],Artist,1884,53,31,1937
Mrs. Samantha Pollard,"['Belarus', 'Hong Kong']",Racing automobile driver,1915,47,1,1962
Eric Fernandez,['Malta'],Artist,1885,9,50,1894
Todd Jones,"['Slovenia', 'Zambia']",Artist,1921,21,87,1942
Lisa Frank,"[""Cote d'Ivoire"", 'French Southern Territories']",Politician,1912,43,69,1955
Morgan Rodgers,"['Saint Lucia', 'Barbados']",Artist,1911,21,68,1932
Dr. Bethany Daugherty,"['Bermuda', 'Lithuania']",Alpine skier,1910,54,39,1964
Bradley Burns,"['Portugal', 'Sao Tome and Principe']",Military personnel,1901,25,37,1926
Mark Duran,['Cocos (Keeling) Islands'],Artist,1895,79,50,1974
Mrs. Katherine Gutierrez,"['Norfolk Island', 'Romania']",Artist,1897,80,58,1977
Shannon Brown,"['Denmark', 'Namibia']",Politician,1870,23,30,1893
Jason Ferguson,"['Syrian Arab Republic', 'Jordan']",Teacher,1889,20,9,1909
Jennifer Tucker,['Guyana'],Artist,1904,61,46,1965
William Werner,['Niger'],Artist,1878,51,23,1929
Thomas Bernard,['Senegal'],Researcher,1905,82,44,1987
Linda Beltran,['Spain'],Athlete,1914,12,49,1926
Gary Combs,['Panama'],Artist,1891,12,2,1903
Christopher Vasquez,['Andorra'],Winegrower,1909,71,3,1980
Kenneth Castillo,['Cuba'],Artist,1874,71,71,1945
Lisa Wolfe,['Kazakhstan'],Artist,1899,29,82,1928
Sarah Bryant,"['Sierra Leone', 'Dominica']",Politician,1878,43,42,1921
Misty Bonilla,['United States Virgin Islands'],Artist,1904,22,47,1926
Timothy Knox,['Cook Islands'],Artist,1891,60,78,1951
Adrian Perez,['Slovenia'],Artist,1871,33,7,1904
Hailey Gross,['Sudan'],Artist,1894,34,15,1928
Patricia Evans,['Egypt'],Artist,1886,26,60,1912
Michelle King,"['Pitcairn Islands', 'Slovenia']",Artist,1886,17,79,1903
Lisa Ellison,['Seychelles'],Researcher,1917,78,73,1995
Tasha Watkins,['Luxembourg'],Artist,1910,8,26,1918
Micheal Vega,"['Djibouti', 'Botswana']",Politician,1898,87,3,1985
Jay Perez,"['United States of America', 'Syrian Arab Republic']",Researcher,1908,49,15,1957
Jacob Mitchell,"['Kyrgyz Republic', 'Poland']",Artist,1923,87,87,2010
Wayne Kelly,['Maldives'],Politician,1906,80,36,1986
Laura Brown,"['Northern Mariana Islands', 'Serbia']",Politician,1885,12,8,1897
Gary Mcpherson,"['Australia', 'Panama']",Artist,1903,23,33,1926
Jason Johnson,"['Panama', 'Peru']",Weightlifter,1884,82,64,1966
Mary Roberts,['Korea'],Military personnel,1914,3,26,1917
Emily Jones,"['Gambia', 'Bolivia']",Artist,1898,72,40,1970
Sergio Knight,"['Eritrea', 'Syrian Arab Republic']",Athlete,1874,13,58,1887
Sandra Gallegos,['Sweden'],Politician,1887,65,44,1952
Dean Dominguez,['Solomon Islands'],Artist,1886,50,80,1936
Jennifer Maddox,['United Kingdom'],Aristocrat,1873,20,39,1893
Jonathan Perez,['New Zealand'],Artist,1914,24,76,1938
Rachel Johnson,['Russian Federation'],Politician,1886,37,12,1923
Kimberly Brown,"['Isle of Man', 'Norway']",Researcher,1896,75,28,1971
Ian Reynolds,"['Saint Lucia', 'Kenya']",Athlete,1888,54,33,1942
Richard Robertson,['Poland'],Artist,1900,62,78,1962
Ronald Butler,['Turkmenistan'],Artist,1887,86,81,1973
Matthew Leon,['Gabon'],Tribal chief,1920,76,55,1996
Lisa Cox,['Singapore'],Artist,1882,20,59,1902
Robert Hansen,"['Saint Helena', 'Czech Republic']",Politician,1913,64,62,1977
Gina Richards,"['Sudan', 'Somalia']",Researcher,1910,65,50,1975
Edwin Sanchez,"['Netherlands Antilles', 'Philippines']",Monarch,1873,87,41,1960
Michael Graves,['Nigeria'],Artist,1918,68,62,1986
Samantha Gallagher,"['Trinidad and Tobago', 'North Macedonia']",Journalist,1904,51,48,1955
Joshua Warren,['Venezuela'],Politician,1921,10,7,1931
Shannon Hart,"['Jordan', 'North Macedonia']",Artist,1894,22,49,1916
Rebecca Brown,['Bahamas'],Bartender,1897,44,87,1941
Molly Ochoa,"['French Polynesia', 'India']",Religious figure,1895,76,61,1971
Tammy Ochoa,"['South Africa', 'Nicaragua']",Religious figure,1908,39,41,1947
Larry Kelly,"['Andorra', 'Malawi']",Politician,1897,87,87,1984
Courtney Garcia,"['Guam', 'French Guiana']",Athlete,1883,88,61,1971
Angela Potter,"['Malaysia', 'Burundi']",Scenographer,1889,1,69,1890
Sierra Solis,"['Bouvet Island (Bouvetoya)', 'Somalia']",Engineer,1872,33,85,1905
Kimberly Hatfield,"['Haiti', 'Nauru']",Artist,1896,77,64,1973
Maria Bradley,"['Tokelau', 'Zimbabwe']",Forensic psychiatrist,1899,52,54,1951
Dylan Fernandez,['Bouvet Island (Bouvetoya)'],Politician,1919,57,82,1976
Garrett Fowler II,"['French Polynesia', 'Brunei Darussalam']",Artist,1892,37,26,1929
Charles Martinez,['Venezuela'],Politician,1881,57,1,1938
Gregory White,['Fiji'],Artist,1875,86,51,1961
Cory Price,"['Singapore', 'Ghana']",Artist,1882,6,10,1888
John Carter,"['Marshall Islands', 'Kiribati']",Engineer,1878,71,88,1949
Alicia Johnson,"['Saint Martin', 'Vietnam']",Military personnel,1921,47,86,1968
Kelly Murphy,['Cape Verde'],Serial killer,1893,34,76,1927
Alejandra Long,"['Turks and Caicos Islands', 'Lesotho']",Artist,1924,62,4,1986
John Oliver,"['Botswana', 'Reunion']",Serial killer; criminal,1876,33,44,1909
Keith Thomas,"['Fiji', 'Chad']",Artist,1887,70,69,1957
Tammy Martin,['United Kingdom'],Artist,1895,53,33,1948
Matthew Smith,"['San Marino', 'Qatar']",Politician,1895,64,50,1959
Robert Jones,['Mexico'],Artist,1918,85,67,2003
Edward Vasquez,['Switzerland'],Artist,1898,59,74,1957
Lindsay Holmes,"['Qatar', 'Yemen']",Entrepreneur,1881,45,28,1926
Anna Murray,['Micronesia'],Artist,1881,57,1,1938
Jonathan Travis,['Portugal'],Athlete,1907,84,51,1991
Brandon Ayala,"['Saudi Arabia', 'Angola']",Artist,1914,55,15,1969
Sara Curtis,"['China', 'Nauru']",Athlete,1874,24,57,1898
Cynthia Andrews,"['Holy See (Vatican City State)', 'Falkland Islands (Malvinas)']",Artist,1889,16,86,1905
Tara Sims,['Madagascar'],Artist,1919,77,15,1996
Melissa George,['New Zealand'],Artist,1872,43,76,1915
Jill Shepard,['Germany'],Artist,1923,44,47,1967
Joseph Miller,['Russian Federation'],Artist,1888,61,39,1949
Ann Harris,"['Western Sahara', 'Iceland']",Artist,1920,89,89,2009
Sarah Lester,['Korea'],Athlete,1897,4,72,1901
Connie Flores,"['Liberia', 'Reunion']",Sovereign,1888,78,17,1966
Bryan Ryan,['Oman'],Artist,1880,81,35,1961
Amy Burke,"['Togo', 'Uruguay']",Politician,1903,86,87,1989
Daniel Mcintyre,['Wallis and Futuna'],Artist,1876,49,63,1925
Gregory Lee,"['Sri Lanka', 'Czech Republic']",Artist,1889,9,46,1898
Timothy Matthews,"['Saint Pierre and Miquelon', 'American Samoa']",Religious figure,1909,4,62,1913
Hannah Foster,['Palestinian Territory'],Artist,1871,71,13,1942
John Bryant,['Guadeloupe'],Artist,1901,13,39,1914
Steven Garcia,"['Solomon Islands', 'Ethiopia']",Artist,1883,73,48,1956
Kristen Horne,['Somalia'],Researcher,1878,51,58,1929
Anthony Ware,"['Martinique', 'Netherlands Antilles']",Artist,1892,25,12,1917
Veronica Jacobs,['Mauritania'],Artist,1887,16,16,1903
Mr. Nathan Maldonado,['Turkey'],Military personnel,1914,29,27,1943
Michael Ortiz,['Gambia'],Religious figure,1911,17,21,1928
Dr. Rebecca Mora,['Northern Mariana Islands'],Artist,1875,8,62,1883
Anthony Moss,"['Vanuatu', 'Korea']",Artist,1918,17,76,1935
Edwin Alexander,"['Kyrgyz Republic', 'Ethiopia']",Artist,1878,6,3,1884
Pamela Obrien,"['Saudi Arabia', 'Oman']",Artist,1893,10,0,1903
Robert Frank,"['Tuvalu', 'Papua New Guinea']",Artist,1874,33,2,1907
Jeremy Beck,"['Finland', 'Egypt']",Journalist,1871,63,19,1934
Andrew Smith,"['Morocco', 'Montenegro']",Baker; socialite,1882,11,16,1893
Kimberly Johnson,['Turks and Caicos Islands'],Religious figure,1901,60,1,1961
Jeffrey Campos,"['Palestinian Territory', 'Saint Kitts and Nevis']",Artist,1877,16,10,1893
David Larson,"['Netherlands', 'Saint Helena']",Artist,1872,67,71,1939
Emily Ruiz,['Serbia'],Politician,1894,28,85,1922
Leonard Gonzalez,"['Palestinian Territory', 'Lesotho']",Artist,1887,63,55,1950
Teresa Johnson,['Belgium'],Artist,1887,35,1,1922
Alison Rollins,"['Uganda', 'Zimbabwe']",Executive producer; film producer,1902,49,37,1951
Annette Cohen,"['Cape Verde', 'Nicaragua']",Researcher,1892,42,55,1934
Alexander Erickson,"['Guatemala', 'Niger']",Artist,1875,3,25,1878
Erica Holland,['Tajikistan'],Researcher,1872,53,79,1925
Carol Cruz,"['Botswana', 'United States of America']",Artist,1918,64,77,1982
Lisa Bird,['Uruguay'],Athlete,1907,38,36,1945
Samantha Smith,['Pitcairn Islands'],Politician,1919,34,45,1953
Cynthia Sullivan,['Kuwait'],Artist,1873,23,13,1896
Jeffrey Ortiz,"['Netherlands', 'Taiwan']",Military personnel,1914,33,42,1947
Amy Marshall,"['Somalia', 'Bermuda']",Politician,1875,7,28,1882
Brandon Howell,['Poland'],Politician,1905,11,64,1916
Jodi Zavala,['Costa Rica'],Politician,1900,55,20,1955
Steve Butler,"['Heard Island and McDonald Islands', 'Congo']",Artist,1877,74,17,1951
Ashley Reed,['Gibraltar'],Politician,1908,2,72,1910
Jonathan Martin,"['Mauritania', 'Australia']",Politician,1908,45,20,1953
Stephanie Phillips,"['Kazakhstan', 'Maldives']",Artist,1900,43,12,1943
Kenneth Turner,"['Turks and Caicos Islands', 'Cameroon']",Politician,1899,66,27,1965
Jonathan Smith,"['Egypt', 'Mongolia']",Politician,1911,35,43,1946
Jackson Davidson,['Georgia'],Artist,1909,68,67,1977
Scott Carter,"['Ecuador', 'Rwanda']",Athlete,1885,27,87,1912
Kyle Parker,['Belize'],Researcher,1913,30,50,1943
Jon Daniel,"['Turks and Caicos Islands', 'Ecuador']",Artist,1881,69,57,1950
Gina Barrett,"['Ukraine', 'Luxembourg']",Artist,1906,86,50,1992
Beverly Clark,['Oman'],Artist,1875,35,7,1910
James Vasquez,"['Dominican Republic', 'Chad']",Artist,1904,63,84,1967
Emily Zamora,"['Saint Pierre and Miquelon', 'Cocos (Keeling) Islands']",Artist,1915,0,42,1915
Kristin Martin,['Bulgaria'],Artist,1920,74,64,1994
Victor Rivas,"['Barbados', 'Cayman Islands']",Monarch,1886,60,49,1946
Faith Gonzalez,['Malaysia'],Researcher,1879,89,55,1968
Danielle Marshall,"['Samoa', 'Saint Vincent and the Grenadines']",Politician,1872,52,8,1924
Jeffrey Williams,['Belize'],Politician,1903,61,41,1964
Riley Hart,"['Dominican Republic', 'Zimbabwe']",Athlete,1898,50,15,1948
Katherine Riley,"['Ghana', 'Central African Republic']",Artist,1887,28,2,1915
David Ford,['Congo'],Serial killer,1917,48,73,1965
Gary Barrera,['Croatia'],Artist,1902,53,35,1955
John Brown,"['Switzerland', 'Honduras']",Religious figure,1872,61,25,1933
Kenneth Williams,['Iceland'],Politician,1901,32,70,1933
Craig Graham,['Palestinian Territory'],Researcher,1911,8,81,1919
Mark Ingram,"['Peru', 'Korea']",Artist,1897,71,67,1968
Jonathan Matthews,"['Saint Vincent and the Grenadines', 'Uruguay']",Artist,1903,52,20,1955
Amanda Yang,['Tanzania'],Researcher,1877,74,18,1951
David Stewart,['Guam'],Artist,1882,21,13,1903
Nichole Austin,['Azerbaijan'],Artist,1924,79,66,2003
Andrew Gonzalez,['Central African Republic'],Athlete,1920,14,19,1934
Kenneth Turner,"['Kuwait', 'Myanmar']",Artist,1905,58,89,1963
Justin Santos,"['American Samoa', 'Belgium']",Politician,1924,45,6,1969
Renee Flores,"['Guinea', 'Panama']",Politician,1923,88,12,2011
Bryan Taylor,['Mongolia'],Artist,1876,35,74,1911
Chloe Moore,"['Peru', 'Ukraine']",Engineer,1878,17,70,1895
Stephen Parker,"['Comoros', 'Barbados']",Athlete,1902,5,30,1907
David Morgan,['Marshall Islands'],Military personnel,1910,4,1,1914
Phillip Lucas,['Myanmar'],Researcher,1922,35,33,1957
Raymond Hanson,['Bangladesh'],Entrepreneur,1901,30,42,1931
Hannah Guerrero,"['Iceland', 'Reunion']",Artist,1919,25,58,1944
Brett Smith,['South Africa'],Artist,1882,11,16,1893
Christopher Ford,"['Mexico', 'Puerto Rico']",Artist,1886,1,83,1887
Jessica Lewis,['Saint Pierre and Miquelon'],Military personnel,1876,82,74,1958
Christina Johnson,['Greenland'],Costume designer; fashion designer,1899,66,73,1965
Patricia Tucker,"['Mozambique', 'Guernsey']",Politician,1910,52,70,1962
Paul Nelson,['Iceland'],Artist,1892,88,70,1980
Brianna Hansen,"['Bahrain', 'Solomon Islands']",Artist,1911,15,39,1926
Dana Middleton,['Cameroon'],Athlete,1918,11,5,1929
Dr. Joseph Snyder,['Samoa'],Researcher,1923,30,36,1953
Marcus Wheeler,['Philippines'],Cinematographer,1904,81,66,1985
Victor Rose,"['China', 'British Virgin Islands']",Artist,1890,19,63,1909
Ryan Terry,"['Serbia', 'Madagascar']",Artist,1889,22,28,1911
Michelle Lawson,"['Tokelau', 'Sao Tome and Principe']",Artist,1877,57,52,1934
Heather Bentley,"['Tunisia', 'Maldives']",Religious figure,1904,51,12,1955
Tammy Dougherty,"['Sao Tome and Principe', 'Nauru']",Politician,1898,58,85,1956
Scott Howell,"['Uruguay', 'American Samoa']",Artist,1877,52,52,1929
Patrick Spears,['Cameroon'],Artist,1896,55,9,1951
Robert Wise,"['United States Virgin Islands', 'Slovenia']",Businessperson,1874,52,33,1926
Shawn Marsh,['Macao'],Artist,1877,2,58,1879
Taylor Warren,['Yemen'],Artist,1911,77,15,1988
Julia Mcclure,['Aruba'],Artist,1921,29,79,1950
Cheryl Martinez,['Mongolia'],Artist,1902,30,64,1932
Jeffery Lopez,['Brazil'],Politician,1887,80,83,1967
Raymond Blake,"['Comoros', 'Singapore']",Artist,1908,83,41,1991
Jennifer Morgan,"['United Arab Emirates', 'Singapore']",Athlete,1894,40,88,1934
Ana Warner,['Taiwan'],Military personnel,1900,79,6,1979
Patrick Bailey,['Dominica'],Artist,1902,71,7,1973
Paul Bailey,"['Aruba', 'Isle of Man']",Artist,1904,77,80,1981
Alejandra Day,"['Tuvalu', 'Cuba']",Aristocrat,1889,55,8,1944
Kenneth Harris,"['Kiribati', 'French Southern Territories']",Artist,1904,10,65,1914
Richard Wright,"['Jamaica', 'Saint Helena']",Athlete,1870,34,43,1904
Larry Cruz,['Macao'],Fighter pilot,1912,14,46,1926
Jeffrey Williams,"['Libyan Arab Jamahiriya', 'Venezuela']",Military personnel,1890,45,1,1935
Thomas Hawkins,"['United States Virgin Islands', 'Zimbabwe']",Artist,1901,5,4,1906
Angel Morgan,"['Maldives', 'Croatia']",Artist,1876,33,69,1909
Michelle Salazar,"['Japan', 'Austria']",Religious figure,1898,81,23,1979
Jonathon Keith,['Jordan'],Artist,1922,37,41,1959
Nicole Gardner,"['Western Sahara', 'French Polynesia']",Researcher,1886,0,72,1886
Debbie Scott,['Belize'],Teacher,1899,35,0,1934
Ronald Bennett,"['Antarctica (the territory South of 60 deg S)', 'Nepal']",Artist,1907,33,56,1940
Bill Anderson,"['Guam', 'Qatar']",Artist,1894,50,45,1944
Nancy Wright,"['Belgium', 'Saint Vincent and the Grenadines']",Artist,1912,88,48,2000
Michael Campos,"['Dominica', 'Brunei Darussalam']",Artist,1918,0,27,1918
Jillian Johnson,"['Ethiopia', 'Estonia']",Artist,1907,81,0,1988
Angela Stewart,"['Luxembourg', 'Congo']",Artist,1902,40,57,1942
Daniel Patterson,['Namibia'],Artist,1897,82,32,1979
Elizabeth Powell,['Guadeloupe'],Researcher,1887,79,72,1966
Karen Martinez,['United Kingdom'],Artist,1922,8,68,1930
Lisa Gray,['Mayotte'],Politician,1882,87,28,1969
Andrea Snyder,"['Togo', ""Cote d'Ivoire""]",Artist,1893,18,44,1911
Jenna Grimes,['Croatia'],Artist,1914,14,30,1928
Derek Williams,"['Tuvalu', 'Nicaragua']",Artist,1894,50,79,1944
Jaime Jones,"['Mongolia', 'Guinea-Bissau']",Researcher,1913,36,8,1949
Christopher Stuart,"['Gambia', 'Gabon']",Artist,1873,60,72,1933
Kenneth Juarez,"['Suriname', 'Nigeria']",Politician,1884,46,53,1930
Kathleen Bullock,"['Reunion', 'Israel']",Artist,1917,88,88,2005
Jeffrey Smith,['Japan'],Artist,1902,59,43,1961
Brittany Smith,['Jamaica'],Religious figure,1889,74,68,1963
Hayley Kelley,"['Bouvet Island (Bouvetoya)', 'Congo']",Athlete,1912,26,15,1938
Allison Scott,['Saint Vincent and the Grenadines'],Athlete,1915,2,8,1917
Larry Holden,"['Chile', 'Uruguay']",Astrologer,1892,65,40,1957
Alyssa Cline,"['Brazil', 'Japan']",Researcher,1881,86,56,1967
Thomas Miller MD,"['Portugal', ""Cote d'Ivoire""]",Artist,1923,0,75,1923
Michael Perkins,"['Saint Lucia', 'Mali']",Athlete,1923,22,48,1945
Kyle Wolfe,"['Cook Islands', 'Saint Pierre and Miquelon']",Researcher,1915,29,76,1944
Maria Lopez,['Mauritius'],Artist,1904,12,2,1916
John Morris,['Anguilla'],Politician,1896,67,19,1963
Christopher Gonzalez,"['Western Sahara', 'Costa Rica']",Artist,1873,14,31,1887
Ashley Rice,"['Libyan Arab Jamahiriya', 'Bhutan']",Athlete,1874,64,4,1938
Lisa Harmon,"['New Caledonia', 'Bangladesh']",Artist,1877,40,9,1917
John Humphrey,"['Egypt', 'Nepal']",Politician,1882,52,21,1934
Margaret Mcgee,['Saint Pierre and Miquelon'],Artist,1882,47,14,1929
Jose Robertson,['Romania'],Athlete,1884,85,19,1969
Rhonda French,['Tonga'],Journalist,1890,4,22,1894
Gerald Caldwell,"['Kiribati', 'Holy See (Vatican City State)']",Artist,1897,35,31,1932
Veronica Andersen,"['Oman', 'Ireland']",Artist,1921,38,15,1959
Tyler Gonzalez,['China'],Politician,1924,2,75,1926
John Wolfe,"['Ghana', 'Czech Republic']",Weightlifter,1920,65,17,1985
Douglas Garcia,['Cocos (Keeling) Islands'],Researcher,1903,68,70,1971
Carol Allen,"['Sri Lanka', 'Panama']",Artist,1907,3,41,1910
Christopher Johnson,['Tanzania'],Artist,1918,77,8,1995
Brian Wright,"['Uganda', 'Montserrat']",Military personnel,1909,83,7,1992
Patrick Mitchell,['Switzerland'],Consort,1878,74,38,1952
Sara Chase,"['Equatorial Guinea', 'Tuvalu']",Politician,1873,75,21,1948
Michael Smith,"['Czech Republic', 'Italy']",Politician,1920,71,37,1991
Alice Medina,['Bahrain'],Artist,1892,49,58,1941
Amy Burns,"['Burundi', 'Heard Island and McDonald Islands']",Military personnel,1871,74,18,1945
Angela Mccarty,"['Turkey', 'Heard Island and McDonald Islands']",Stand-up comedian,1923,69,73,1992
Nicole Garcia,"['Kiribati', 'Gabon']",Artist,1872,70,46,1942
Tara Cherry,"['Israel', 'Bermuda']",Lawyer,1879,59,56,1938
Richard King,"['Luxembourg', 'Samoa']",Artist,1894,0,33,1894
Russell Thomas,"['Gabon', 'Niue']",Military personnel,1915,55,55,1970
Kelly Diaz,"['Cuba', 'Benin']",Designer,1919,45,83,1964
Lucas Riddle,"['Guam', 'Moldova']",Artist,1905,29,81,1934
Tyler Keller,"['United Kingdom', 'Central African Republic']",Military personnel,1913,12,71,1925
Lisa House,"['Nauru', 'France']",Artist,1906,80,16,1986
William Landry,"['French Guiana', 'Faroe Islands']",Artist,1915,22,1,1937
Stephanie Johnson,['Mauritania'],Artist,1885,41,69,1926
Melissa David,['Sudan'],Artist,1904,87,87,1991
Ryan Jefferson,['Ireland'],Politician,1882,56,39,1938
Jason Willis,"['Qatar', 'Cook Islands']",Researcher,1902,46,36,1948
Terri Martin,"['Spain', 'Montserrat']",Artist,1888,78,67,1966
Michael Lopez,"['Saint Helena', 'Croatia']",Artist,1905,57,44,1962
Mario Lee,"['Estonia', 'Northern Mariana Islands']",Artist,1922,70,64,1992
Crystal Schneider,"['San Marino', 'Namibia']",Military personnel,1885,58,80,1943
Aaron Sutton,"['Palau', 'Honduras']",Athlete,1920,74,71,1994
George Ellison,['Falkland Islands (Malvinas)'],Artist,1915,57,63,1972
Daniel Wilson,"['American Samoa', 'Albania']",Artist,1895,48,49,1943
Kari Dunn,"['Rwanda', 'Netherlands Antilles']",Athlete,1906,46,32,1952
Danielle Ritter,['Maldives'],Politician,1914,80,68,1994
Jessica Roberts,"['Venezuela', 'Slovenia']",Politician,1923,16,28,1939
Richard Huerta,['United States of America'],Politician,1886,26,77,1912
Roy Neal,"['Germany', 'Germany']",Athlete,1917,4,89,1921
Samantha Love,"['Nigeria', 'Tokelau']",Athlete,1871,22,81,1893
Charles Meza,['Saint Barthelemy'],Researcher,1887,77,8,1964
Kevin Pratt,['Marshall Islands'],Politician,1912,5,36,1917
Amanda Andrade,"['Zambia', 'Tajikistan']",Explorer,1872,29,3,1901
David Cameron,"['Cameroon', 'India']",Artist,1923,46,64,1969
Rodney Brown,['South Georgia and the South Sandwich Islands'],Teacher,1896,56,52,1952
Jonathan Frazier,"['Zimbabwe', 'Oman']",Artist,1922,86,81,2008
Amy Adams,['Holy See (Vatican City State)'],Aristocrat,1889,31,18,1920
Michael Munoz,['Poland'],Researcher,1870,9,31,1879
Christopher Taylor,"['Ireland', 'United States Minor Outlying Islands']",Military personnel,1870,70,67,1940
Janet Jacobson,['Maldives'],Artist,1893,65,61,1958
Colin Nash,['Paraguay'],Artist,1901,51,51,1952
Caleb Manning,['Estonia'],Artist,1922,10,27,1932
Brittany Johnson,['Angola'],Researcher,1911,57,54,1968
James Stewart,"['Australia', 'Philippines']",Politician,1921,59,29,1980
Jessica Russell,['Namibia'],Professional wrestler,1892,27,30,1919
Amanda Lewis,['French Guiana'],Athlete,1922,25,77,1947
Jesse Hopkins,['British Virgin Islands'],Researcher,1914,79,82,1993
Chase Dyer,['Norway'],Researcher,1911,60,63,1971
Emma Brady,"['Marshall Islands', 'Cape Verde']",Politician,1897,52,68,1949
Sara Romero,"['Paraguay', 'Malawi']",Cinematographer; camera operator,1877,86,35,1963
Mr. Robert Mccullough,['Saint Vincent and the Grenadines'],Artist,1880,60,76,1940
Melissa Flowers,['Czech Republic'],Artist,1892,61,18,1953
Robert Thomas,['United States Virgin Islands'],Artist,1876,20,83,1896
Richard Murphy,"['Nicaragua', 'Bhutan']",Teacher,1900,47,77,1947
Frederick Holden,['Svalbard & Jan Mayen Islands'],Artist,1916,43,87,1959
Robin Baker,"['Australia', 'Palestinian Territory']",Racing automobile driver; formula one driver,1913,33,62,1946
Dustin Palmer,"['Hungary', 'Guadeloupe']",Politician,1922,49,17,1971
Catherine Wagner,['Gabon'],Politician,1886,28,74,1914
Anthony Mcdonald,['Australia'],Artist,1919,39,23,1958
Daniel Cruz,"['Kyrgyz Republic', 'British Indian Ocean Territory (Chagos Archipelago)']",Judoka,1875,58,12,1933
Jorge Ramirez,['Burkina Faso'],Artist,1876,53,39,1929
Jake Smith,"['Kenya', 'Pakistan']",Politician,1913,32,9,1945
Steven Roberts,['Bermuda'],Politician,1905,85,86,1990
Stephen Hernandez,['Romania'],Artist,1913,30,15,1943
Michael Berg,"['Estonia', 'Taiwan']",Artist,1897,51,59,1948
Karen Martin,['Congo'],Athlete,1874,51,57,1925
Crystal Adams,['Trinidad and Tobago'],Artist,1911,83,58,1994
Javier Hernandez,['Holy See (Vatican City State)'],Religious figure,1873,48,61,1921
Kathy Reyes,['Cook Islands'],Athlete,1891,43,32,1934
Maria Gomez,"[""Cote d'Ivoire"", 'Guatemala']",Artist,1922,29,70,1951
Christopher Lara,"['Montenegro', 'Greenland']",Artist,1875,51,17,1926
James Perez,"['Bhutan', 'Iraq']",Politician,1885,0,69,1885
Robert Lindsey,"['Saint Martin', 'Jersey']",Politician,1923,55,79,1978
Brian Moore,['Madagascar'],Athlete,1872,76,35,1948
Jeremy Terrell,"['Poland', 'Netherlands']",Jockey,1921,87,45,2008
Joshua Christensen,"[""Cote d'Ivoire"", 'Malawi']",Ballet dancer; pedagogue; choreographer; ballerina; dancer,1879,48,41,1927
John Johnson,"['Senegal', 'Iceland']",Artist,1882,43,60,1925
Sharon Harris,"['Hong Kong', 'South Africa']",Stockbroker,1879,65,10,1944
Paula Powell,"['Bouvet Island (Bouvetoya)', 'Saint Martin']",Author; television producer; television presenter; chef; autobiographer,1923,41,77,1964
Julia Watson,['Lithuania'],Artist,1876,56,63,1932
Whitney Kerr,"['Oman', 'United States of America']",Artist,1908,51,78,1959
Mary Smith,"['Moldova', 'Venezuela']",Politician,1888,87,78,1975
Andrew Myers,['Israel'],Politician,1919,51,31,1970
Jonathon Stewart,['United Arab Emirates'],Politician,1909,59,23,1968
Rhonda Padilla,"['Guyana', 'Guam']",Military personnel,1892,28,69,1920
Judith George,['Papua New Guinea'],Politician,1890,34,29,1924
Michael Mclaughlin,['Tokelau'],Artist,1915,44,42,1959
Matthew Ellis,['French Southern Territories'],Researcher,1907,2,14,1909
Hannah Jenkins,['Haiti'],Artist,1886,21,33,1907
Patrick Smith,"['Kenya', 'Puerto Rico']",Politician,1894,4,47,1898
Heather Wise,['Gabon'],Scenographer,1898,2,31,1900
Jennifer Estrada,['French Polynesia'],Politician,1870,49,13,1919
Angela Green,"['Lebanon', 'Mayotte']",Artist,1920,69,81,1989
Randall Pena,['Luxembourg'],Politician,1870,50,68,1920
John Ortega,['Tonga'],Nurse,1912,73,18,1985
Donna Sanders,"['San Marino', 'Puerto Rico']",Military personnel,1873,85,78,1958
Cynthia Martinez,"['Norway', 'Bulgaria']",Artist,1897,64,30,1961
Timothy Keith,"['Cyprus', 'San Marino']",Artist,1877,30,71,1907
Erin Davis,"['Micronesia', 'Iceland']",Artist,1879,39,75,1918
Ashlee Rice,"['Bhutan', 'Ireland']",Politician,1920,63,32,1983
Mark Branch,['Dominican Republic'],Politician,1887,77,5,1964
Erin Brooks,"['Yemen', 'Morocco']",Politician,1872,30,32,1902
Kevin Hernandez,"['Bahamas', 'Brunei Darussalam']",Artist,1902,28,49,1930
Kimberly Lopez,['Mongolia'],Military personnel,1900,89,19,1989
Elizabeth Smith,"['Haiti', 'Myanmar']",Artist,1910,18,19,1928
Juan Cox,['Egypt'],Politician,1888,72,65,1960
Christine Jackson,"['Antigua and Barbuda', 'Belize']",Researcher,1888,87,39,1975
Jason Suarez,['Congo'],Politician,1873,46,44,1919
Christie Johnson,['Bahrain'],Artist,1910,62,12,1972
Sarah Norton,"['New Caledonia', 'Equatorial Guinea']",Artist,1906,73,52,1979
Mark Davis,['Palestinian Territory'],Teacher,1906,7,44,1913
Connor Woods,"['Vanuatu', 'Iraq']",Athlete,1893,52,72,1945
Jesse Webb,['Senegal'],Politician,1895,1,13,1896
Thomas Dennis,['Tajikistan'],Artist,1895,82,64,1977
Carmen Krueger,"['Saint Helena', 'Tokelau']",Athlete,1877,24,36,1901
Gregory Lee,"['Saudi Arabia', 'Netherlands Antilles']",Athlete,1889,14,68,1903
Anne Douglas,['Marshall Islands'],Artist,1872,41,80,1913
Susan Diaz,"['Malawi', 'Kazakhstan']",Artist,1906,35,32,1941
Erica Proctor,"['Nigeria', 'Mauritania']",Researcher,1912,63,24,1975
Jack Jackson,['Armenia'],Politician,1907,30,18,1937
Christy Fox,"['Sierra Leone', 'Estonia']",Artist,1880,85,41,1965
Jeremiah Harper,"['Venezuela', 'Philippines']",Artist,1902,11,55,1913
Jennifer Reid,"['Grenada', 'Bahrain']",Artist,1922,22,36,1944
Rebecca Pugh,"['Faroe Islands', 'San Marino']",Artist,1877,19,38,1896
William Barber,"['Costa Rica', 'Cyprus']",Researcher,1914,25,11,1939
Shannon Jones,['Finland'],Artist,1920,22,36,1942
Hector Fisher,"['Malta', 'Sri Lanka']",Artist,1913,52,76,1965
Morgan Garcia,"['Jamaica', 'Holy See (Vatican City State)']",Politician,1899,8,64,1907
Julia Harrison,"['Djibouti', 'Slovakia (Slovak Republic)']",Athlete,1878,10,36,1888
Amanda Banks,['Benin'],Artist,1915,81,59,1996
Amanda Powell,"['Turkmenistan', 'Ghana']",Artist,1890,75,9,1965
Jason Perkins,"['India', 'Saudi Arabia']",Duke,1888,79,60,1967
William Jones,"['Saudi Arabia', 'Congo']",Artist,1883,84,54,1967
Scott Fleming,['Anguilla'],Researcher,1883,68,89,1951
Terri Smith,['Tanzania'],Journalist,1891,2,88,1893
William Flores,['Andorra'],Political activist,1917,12,7,1929
Timothy Anderson,['Bahamas'],Artist,1919,65,39,1984
Christopher Anderson,['Mexico'],Submariner; naval officer,1872,83,53,1955
Lydia Dean,['New Caledonia'],Artist,1913,69,50,1982
Sandra Ward,['Macao'],Politician,1889,80,58,1969
Kevin Davis,['Reunion'],Artist,1900,6,12,1906
Brandon Williams,"['Zambia', 'Mauritius']",Artist,1879,25,61,1904
John Fletcher,"['Moldova', 'Angola']",Christians jehovahâ€™s witnesses,1918,31,62,1949
Jimmy Osborne,"['Bouvet Island (Bouvetoya)', 'Kenya']",Athlete,1905,86,33,1991
Tiffany Carter,['Brazil'],Monarch,1893,72,81,1965
Rebecca Adams,['Antarctica (the territory South of 60 deg S)'],Artist,1871,45,82,1916
Maria Moran,['Saint Martin'],Military personnel,1901,5,5,1906
Kendra Rich,"['Austria', 'Tajikistan']",Artist,1915,80,29,1995
Ronald Thomas,"['British Indian Ocean Territory (Chagos Archipelago)', 'Sao Tome and Principe']",Artist,1886,89,50,1975
Chelsea Cole,"['Turkey', 'Kazakhstan']",Religious figure,1888,73,22,1961
Krista Palmer,['Azerbaijan'],Religious figure,1920,70,26,1990
Steven Nelson,['Georgia'],Artist,1909,45,21,1954
Anthony Anderson Jr.,"['Cook Islands', 'Moldova']",Military personnel,1881,31,63,1912
Steven Reyes,['Papua New Guinea'],Artist,1895,29,71,1924
James Brown,"['Palau', 'Saint Lucia']",Athlete,1902,7,33,1909
Molly Green,"['Bolivia', 'Barbados']",Artist,1902,66,10,1968
Mark Schmidt,['Iceland'],Artist,1880,43,6,1923
Brian Kelley,"[""Lao People's Democratic Republic"", 'Somalia']",Artist,1908,28,87,1936
Cassidy Robertson,['Nicaragua'],Politician,1884,36,1,1920
Rebecca Gordon PhD,"['Uzbekistan', 'Greenland']",Artist,1907,84,47,1991
Louis Matthews,['Latvia'],Politician,1887,52,5,1939
Kevin Davis,['Anguilla'],Athlete,1897,5,45,1902
Maxwell Cain,['Monaco'],Politician,1909,0,67,1909
Kayla Cardenas,"['Rwanda', 'New Zealand']",Protestant reformer,1885,64,50,1949
Matthew Murphy,['Nepal'],Researcher,1899,71,44,1970
Richard Russo,['Finland'],Artist,1915,84,87,1999
Erin Moore,"['Seychelles', 'Saint Helena']",Artist,1913,3,75,1916
Matthew Andrade,['Bahamas'],Artist,1889,20,57,1909
Xavier Walsh,['Martinique'],Artist,1877,0,27,1877
Melinda Cooper,"['Myanmar', 'Comoros']",Artist,1910,76,9,1986
Vanessa Johnson,['Faroe Islands'],Religious figure,1922,21,3,1943
Gina Davis,['Saint Kitts and Nevis'],Researcher,1908,71,58,1979
Jonathan Khan,['Guyana'],Aristocrat,1897,38,7,1935
Michael West,['Mongolia'],Artist,1909,36,45,1945
Jennifer Brock,"['Bulgaria', 'Singapore']",Politician,1910,16,33,1926
Terry Brown,"['Montserrat', 'Slovenia']",Artist,1884,21,33,1905
David Pierce,"['Antarctica (the territory South of 60 deg S)', 'Turkmenistan']",Politician,1874,33,33,1907
Kevin Tucker,['Afghanistan'],Politician,1898,88,6,1986
Christian Roman,['Andorra'],Politician,1878,12,38,1890
Mary Bailey,"['Korea', 'Tanzania']",Researcher,1894,78,14,1972
Ashley Fox,['French Polynesia'],Mountaineer; explorer,1884,71,86,1955
Latoya Rocha,"['Barbados', 'Greenland']",Artist,1884,89,81,1973
Dawn Harmon DDS,"['Bahamas', 'Guernsey']",Artist,1881,38,46,1919
Mark Jordan,"['Turks and Caicos Islands', 'Saint Kitts and Nevis']",Artist,1876,8,24,1884
John Smith,"['Kyrgyz Republic', 'Albania']",Student,1907,47,63,1954
Ashley Stanley,['Honduras'],Politician,1889,54,25,1943
Randall Bowen,"['Isle of Man', 'Paraguay']",Artist,1913,84,15,1997
Scott Shea,['Venezuela'],Artist,1923,48,81,1971
Shirley Moon,"['Greenland', 'Peru']",Military personnel,1908,43,31,1951
Katie Rodriguez,"['Holy See (Vatican City State)', 'Falkland Islands (Malvinas)']",Artist,1888,79,42,1967
Gabriel Ramirez,['Antarctica (the territory South of 60 deg S)'],Artist,1879,68,44,1947
Marissa Wells,"['Slovenia', 'Japan']",Researcher,1915,18,41,1933
Ms. Erin Fernandez,"['Bahamas', 'United States of America']",Physician,1892,53,53,1945
Christy Harris,"['Japan', 'French Polynesia']",Politician,1923,31,66,1954
Michael Potter,['Sweden'],Artist,1892,18,13,1910
George Horn,['Poland'],Researcher,1904,80,6,1984
Xavier Johnston,"['Namibia', 'Lesotho']",Athlete,1892,87,33,1979
Erik Steele,['Falkland Islands (Malvinas)'],Researcher,1914,33,67,1947
Brandon Bolton,['Syrian Arab Republic'],Politician,1909,41,43,1950
Joseph Ross,['Peru'],Athlete,1876,21,38,1897
Matthew Martin,['Netherlands'],Artist,1905,61,33,1966
John Barnes,"['Libyan Arab Jamahiriya', 'Estonia']",Artist,1904,87,45,1991
Jennifer Jones,"['Ethiopia', 'French Polynesia']",Artist,1905,53,2,1958
William Williams,['Montserrat'],Politician,1903,59,14,1962
Justin Lowe,['Jordan'],Artist,1888,65,53,1953
Tina Lewis,"['Estonia', 'Trinidad and Tobago']",Artist,1882,54,32,1936
Julie Jones,"['Seychelles', 'British Virgin Islands']",Artist,1874,42,62,1916
Henry Lutz,['Albania'],Researcher,1871,74,1,1945
Edwin Holmes,['French Southern Territories'],Artist,1889,76,86,1965
Edward Cole,"['New Caledonia', 'Macao']",Racing automobile driver,1892,49,35,1941
Stephanie Cuevas,['Norway'],Artist,1911,18,31,1929
James Meyers,['Macao'],Artist,1878,86,76,1964
Sara Singleton,['India'],Politician,1874,59,88,1933
Todd Pham,"['Sweden', 'Macao']",Politician,1895,31,51,1926
Crystal Bridges,['Maldives'],Fencer,1920,6,27,1926
Leslie King,"['Tajikistan', 'Egypt']",Researcher,1909,16,84,1925
Matthew Bennett,['Argentina'],Politician,1884,7,88,1891
Mark Miller,"['Ethiopia', 'Congo']",Politician,1879,53,59,1932
Stephanie Love,['Ireland'],Politician,1913,67,43,1980
Mike Martin,['French Guiana'],Artist,1914,10,15,1924
Stephen Bennett,['Macao'],Politician,1883,60,34,1943
Dr. Alexander Carroll,['Wallis and Futuna'],Politician,1893,75,0,1968
Michael Miller,['Romania'],Artist,1921,45,34,1966
Roberto Scott,"['Ethiopia', 'New Zealand']",Researcher,1908,23,83,1931
Heather Cross DDS,"['Kyrgyz Republic', 'Chad']",Politician,1915,58,79,1973
Kristin King,['Ecuador'],Conductor; pedagogue,1876,72,89,1948
Charles Mitchell,"['Swaziland', 'Moldova']",Politician,1897,57,89,1954
Michelle Franklin,"['Nicaragua', 'Nigeria']",Researcher,1920,17,67,1937
Steven Jones,['Montenegro'],Artist,1905,13,72,1918
Christian Torres,"['Timor-Leste', 'Mauritania']",Politician,1882,53,87,1935
Manuel Montgomery,"['Benin', 'Serbia']",Researcher,1904,4,49,1908
Kelly Carr,['Serbia'],Artist,1911,79,10,1990
Ronald Lopez,['Latvia'],Artist,1888,88,8,1976
Adam Gregory,"['Congo', 'Dominica']",Artist,1893,0,81,1893
Andrew Sanders,['Bahamas'],Canoeist,1876,34,78,1910
Paul Durham,"['Christmas Island', 'Timor-Leste']",Politician,1878,33,18,1911
Gregory King,['Burundi'],Artist,1872,33,77,1905
Denise Ramirez,['Bahamas'],Engineer,1921,79,49,2000
Larry Martin,"['Timor-Leste', 'Slovenia']",Researcher,1889,21,15,1910
James Christian,['United Arab Emirates'],Politician,1923,15,82,1938
Robin Li,['Canada'],Artist,1902,53,70,1955
Sharon Smith,"['Lesotho', 'Djibouti']",Researcher,1878,4,2,1882
Laura Lawrence,['Liechtenstein'],Artist,1871,75,40,1946
Richard Coleman,['Malaysia'],Athlete,1873,15,60,1888
Joshua Adkins,['Palestinian Territory'],Researcher,1921,8,5,1929
Ryan Martinez,"['Central African Republic', 'Haiti']",Artist,1882,1,86,1883
Jon Martinez,"['Uruguay', 'Colombia']",Artist,1877,5,51,1882
Patricia Morgan,"['Guatemala', 'Cook Islands']",Athlete,1880,53,16,1933
Elizabeth Ware,['Finland'],Politician,1909,10,23,1919
Thomas Alexander,['Equatorial Guinea'],Marathon runner,1875,7,10,1882
Bobby Rodriguez,"['Gabon', 'Benin']",Salesperson; television presenter; television personality,1903,36,59,1939
William Porter,"['Bouvet Island (Bouvetoya)', 'Brazil']",Artist,1881,60,23,1941
Brett Duncan,"['Grenada', 'Bahamas']",Politician,1909,83,1,1992
Julie Myers,"['French Southern Territories', 'New Caledonia']",Religious figure,1900,49,8,1949
Robert Marsh,['Seychelles'],Art dealer,1913,4,53,1917
Andrea Thomas,['United Kingdom'],Military personnel,1923,16,3,1939
Michael House,['Swaziland'],Artist,1903,23,40,1926
Jessica Maddox,"['Korea', 'Hong Kong']",Artist,1910,45,69,1955
Douglas Davis DVM,['Romania'],Artist,1919,71,47,1990
Melissa Rogers,"['Marshall Islands', 'Switzerland']",Teacher,1887,56,49,1943
Steven Boyle,"['United Arab Emirates', 'Bangladesh']",Artist,1896,2,74,1898
Samantha Scott,"['Spain', 'North Macedonia']",Politician,1877,53,48,1930
Jessica Rodriguez,['Faroe Islands'],Politician,1887,82,17,1969
Mark Taylor,"['Maldives', 'Poland']",Politician,1910,49,22,1959
Hannah Williamson,['Cocos (Keeling) Islands'],Artist,1878,49,19,1927
David Hunter,"['Belize', 'Estonia']",Athlete,1909,42,84,1951
Brittany Glover,"['French Guiana', 'Tajikistan']",Artist,1879,10,35,1889
Gregory Valencia,['Mayotte'],Manual worker,1903,76,64,1979
Claudia Carroll,['Ghana'],Athlete,1874,0,64,1874
Diamond Lam,"['Trinidad and Tobago', 'Norfolk Island']",Politician,1915,72,3,1987
Anna Long,['Solomon Islands'],Artist,1877,88,83,1965
Annette Newman,['Turkey'],Artist,1876,60,28,1936
Brian Rivera,"['Angola', 'Bosnia and Herzegovina']",Athlete,1914,33,77,1947
Ronald Morales,"['Maldives', 'Martinique']",Engineer,1903,74,9,1977
William Berry,['Guinea'],Athlete,1879,53,22,1932
Luis Bowman,"['Fiji', 'Australia']",Politician,1903,12,50,1915
Norma Beck,"['Hungary', 'Montenegro']",Researcher,1890,89,46,1979
Ashley Lawrence,"['San Marino', 'Bosnia and Herzegovina']",Artist,1885,81,73,1966
Jason Ryan,['Jersey'],Entrepreneur,1892,3,89,1895
Kyle Barr,"['Malawi', 'Croatia']",Artist,1912,37,1,1949
Sandy Maldonado,['Chad'],Researcher,1910,15,76,1925
Courtney Gallagher,"['El Salvador', 'South Africa']",Athlete,1918,62,50,1980
Maria Wood,"['Marshall Islands', 'Hong Kong']",Film producer,1887,55,83,1942
Shannon Carter,['Falkland Islands (Malvinas)'],Politician,1901,68,72,1969
Nicholas Sawyer,['Madagascar'],Politician,1883,80,28,1963
Melissa Krueger,['Comoros'],Athlete,1918,3,14,1921
Jessica Smith,"['Palau', 'Zimbabwe']",Mountaineer,1900,81,83,1981
Chad Park,['Guadeloupe'],Artist,1909,37,49,1946
Diane Sanford DVM,"['Tanzania', 'Moldova']",Artist,1891,20,65,1911
Dustin Fisher,"['Jordan', 'Uzbekistan']",Artist,1884,70,75,1954
George Phillips,"['Congo', 'Cayman Islands']",Politician,1921,16,22,1937
Andrew Smith III,"['Uruguay', 'Bulgaria']",Aristocrat,1919,23,38,1942
Shannon Fisher,"['Vietnam', 'Saint Kitts and Nevis']",Politician,1882,26,36,1908
David Robles,['Iceland'],Politician,1870,75,60,1945
Matthew Garcia,['Netherlands'],Athlete,1884,81,0,1965
Diane Roberts,"['Zimbabwe', 'Colombia']",Artist,1892,69,78,1961
Cole Martinez,['Tajikistan'],Journalist,1870,46,64,1916
Michelle Myers,"['United States Virgin Islands', 'Sri Lanka']",Lawyer,1891,23,70,1914
Benjamin Sanchez,"['Hong Kong', 'French Southern Territories']",Artist,1914,36,32,1950
Mary Adams,['Cuba'],Artist,1884,52,0,1936
Michael Johnson,['Lithuania'],Artist,1905,52,61,1957
Veronica Orr,['Guadeloupe'],Artist,1886,86,44,1972
Chase Murphy,"['Timor-Leste', 'American Samoa']",Artist,1909,86,70,1995
Darren Park,['British Virgin Islands'],Artist,1879,8,52,1887
Maria Schaefer,['Iceland'],Athlete,1910,53,73,1963
Michele Quinn,['Romania'],Military personnel,1905,57,63,1962
David Neal,"['Tanzania', 'Latvia']",Athlete,1912,38,11,1950
Gina Adams,"['Netherlands Antilles', 'Mali']",Artist,1871,38,63,1909
Christopher Brock,"['Dominican Republic', 'Niger']",Researcher,1915,83,6,1998
Meghan Gutierrez,"['Lesotho', ""Lao People's Democratic Republic""]",Politician,1906,5,19,1911
Joshua Gomez,['Saint Lucia'],Researcher,1894,87,59,1981
Shannon Smith,"['Ghana', 'Yemen']",Athlete,1876,3,52,1879
Rebecca Moore,['Argentina'],Researcher,1918,7,40,1925
Jacqueline Acevedo,"['South Africa', 'Greenland']",Researcher,1903,18,3,1921
Cathy Burns,"['Swaziland', 'Mayotte']",Artist,1871,57,64,1928
Carlos Gomez,"['Isle of Man', 'Azerbaijan']",Politician,1922,66,23,1988
Robin Brewer,"['Iraq', 'Ireland']",Researcher,1895,26,58,1921
Laura Harper,['French Southern Territories'],Politician,1915,42,79,1957
Holly Johnston,['Benin'],Politician,1876,19,63,1895
Jonathan Wright,['American Samoa'],Aristocrat,1894,14,50,1908
Timothy Rowland,['Singapore'],Artist,1917,21,10,1938
Heather Moran,['United Kingdom'],Artist,1920,80,81,2000
Lindsey Johnson MD,['Jamaica'],Military personnel,1899,5,21,1904
Margaret Young,['Ecuador'],Artist,1875,49,6,1924
Cory Gray,"['Palau', 'Ecuador']",Artist,1919,68,37,1987
Mr. Tommy Fisher,"['French Polynesia', 'Belarus']",Artist,1877,21,40,1898
Jason Mccormick,['Palestinian Territory'],Artist,1887,0,63,1887
Joseph Webb,"['Eritrea', 'Saint Barthelemy']",Politician,1910,30,15,1940
Samantha Miller,['Albania'],Sovereign,1873,3,85,1876
Jonathan Manning,['Tuvalu'],Artist,1872,77,72,1949
Melissa Cox,['Italy'],Artist,1885,17,20,1902
Joshua Anderson,['Seychelles'],Artist,1915,72,13,1987
Melanie Mccarthy,"['Peru', 'Saint Barthelemy']",Artist,1916,57,60,1973
Sara Smith,['Eritrea'],Artist,1924,77,14,2001
Joseph Bernard,"['Finland', 'French Polynesia']",Artist,1888,55,85,1943
Shawn Pearson,"['Luxembourg', 'Moldova']",Researcher,1910,12,52,1922
Michael Sutton,"['Nepal', 'Martinique']",Racing automobile driver,1895,25,1,1920
Elizabeth Roy,['Ukraine'],Politician,1912,46,63,1958
Nancy Doyle,"['Wallis and Futuna', 'Jersey']",Artist,1880,28,68,1908
Scott Lopez,['Malta'],Artist,1885,5,40,1890
Gregory Paul,['Cape Verde'],Artist,1898,58,51,1956
Mr. Justin Walker,['Mauritania'],Politician,1904,6,28,1910
Mary Rodgers,"['Suriname', 'Italy']",Athlete,1903,16,44,1919
Scott Deleon,"['Jersey', 'Micronesia']",Nun; pianist,1914,88,19,2002
Robin Hernandez,['Sweden'],Researcher,1902,57,86,1959
Daniel Escobar,"['Serbia', 'Azerbaijan']",Sovereign,1920,6,11,1926
Chelsea Miller,['Antarctica (the territory South of 60 deg S)'],Researcher,1874,48,78,1922
Emily Serrano,['Canada'],Artist,1871,84,76,1955
Michael Anderson,"['Uruguay', 'Tuvalu']",Artist,1922,76,85,1998
David Paul,"['Cuba', 'Brunei Darussalam']",Athlete,1882,11,81,1893
Zachary Montgomery,['Reunion'],Politician,1912,83,39,1995
Sharon Mitchell,['Ecuador'],Politician,1885,73,69,1958
Steven Gentry,['Ethiopia'],Researcher,1898,18,69,1916
Sarah Taylor,"['Suriname', 'Sweden']",Researcher,1907,54,76,1961
Anita Vaughn,"['Indonesia', 'Central African Republic']",Artist,1920,45,73,1965
Jasmine Lee,['Singapore'],Politician,1906,10,61,1916
Deborah Sellers,"['Qatar', 'Armenia']",Executioner,1873,76,75,1949
William Velasquez,"['Tokelau', 'Solomon Islands']",Politician,1885,89,83,1974
Zachary Phelps,['Suriname'],Artist,1908,36,57,1944
Deanna Oneill,"['Liberia', 'Faroe Islands']",Artist,1922,81,54,2003
Dennis Gordon,['Croatia'],Artist,1924,43,1,1967
Marcus Rodgers,"['North Macedonia', 'Seychelles']",Artist,1870,33,21,1903
Autumn Smith,['San Marino'],Artist,1920,84,9,2004
Jared White,"['Croatia', 'Finland']",Artist,1896,18,59,1914
Raymond James,['Saint Barthelemy'],Military personnel,1901,61,72,1962
William Howard,['New Caledonia'],Artist,1879,23,65,1902
Christopher Stanley,"['Belarus', 'Peru']",Artist,1890,84,82,1974
John Garcia,['Hungary'],Artist,1875,45,81,1920
Rebecca Henderson,"['British Virgin Islands', 'Finland']",Artist,1875,59,52,1934
Clinton Padilla,"['Ukraine', 'New Caledonia']",Artist,1908,15,78,1923
Nicholas Sullivan,"['Kazakhstan', 'Guyana']",Athlete,1890,84,47,1974
Jonathan Sullivan,"['New Caledonia', 'Heard Island and McDonald Islands']",Politician,1908,89,75,1997
Michael Williams,['Kyrgyz Republic'],Artist,1905,0,20,1905
Thomas Jackson,['Turkmenistan'],Artist,1889,60,60,1949
Erika Jackson,"['Austria', 'Vanuatu']",Artist,1905,17,56,1922
Tony Miller MD,['Kuwait'],Artist,1911,70,77,1981
Kevin Austin,['South Georgia and the South Sandwich Islands'],Athlete,1919,38,40,1957
Victor Lopez,"['New Caledonia', 'Faroe Islands']",Politician,1901,20,14,1921
Erin Fields,['Israel'],Teacher,1881,79,20,1960
Michelle Adams,['Cayman Islands'],Artist,1874,34,4,1908
Sherry Morton,['French Southern Territories'],Researcher,1884,32,34,1916
Michael Chase,['Botswana'],Artist,1874,53,68,1927
Christopher Williams,"['Moldova', 'Trinidad and Tobago']",Artist,1904,14,64,1918
Robert Johnson,['Barbados'],Military personnel,1901,62,44,1963
Timothy Thompson,"['Belgium', 'Zimbabwe']",Artist,1920,2,77,1922
John Peterson,"['Tuvalu', 'Ghana']",Aristocrat,1890,10,67,1900
Tracy Cobb,"['Saint Pierre and Miquelon', 'Papua New Guinea']",Researcher,1880,19,63,1899
Brandon Knox,"['Gabon', 'United States of America']",Businessperson,1911,62,29,1973
Brandon Washington,"['Bahamas', 'South Africa']",Athlete,1888,5,27,1893
Jenna Gonzalez,['Ireland'],Politician,1917,74,6,1991
John Rodriguez,"['Togo', 'Niue']",Artist,1886,71,13,1957
Timothy Moore,"['Yemen', 'Reunion']",Researcher,1898,50,29,1948
Julie Sanchez,"['French Guiana', 'Portugal']",Researcher,1870,83,75,1953
Timothy Ferrell,"['Greenland', 'Venezuela']",Artist,1923,10,22,1933
Jack Griffith,"[""Cote d'Ivoire"", 'Malaysia']",Television director,1921,38,88,1959
Courtney Avila,['Norfolk Island'],Artist,1918,57,7,1975
Anthony Hogan,"['Northern Mariana Islands', 'Azerbaijan']",Costume designer; fashion designer,1880,82,77,1962
Michael Gonzalez,"['Mauritius', 'San Marino']",Politician,1901,5,19,1906
Sean Garcia,"['Kyrgyz Republic', 'Belarus']",Artist,1891,40,7,1931
Debra Rodriguez,"['Malawi', 'Algeria']",Researcher,1870,21,63,1891
Ryan West,['Maldives'],Researcher,1877,10,62,1887
Melissa Brown,"['Marshall Islands', 'Montenegro']",Artist,1901,41,27,1942
Misty Campbell,"['Luxembourg', 'Martinique']",Gangster; extortion,1874,14,78,1888
Darrell Wyatt,"['Hong Kong', 'Haiti']",Athlete,1874,27,49,1901
Paul Schneider,['Korea'],Athlete,1873,24,49,1897
Erica Scott,"['Dominica', 'Ireland']",Researcher,1891,77,83,1968
Randy Dodson,"['Saint Pierre and Miquelon', 'Bosnia and Herzegovina']",Artist,1923,76,47,1999
Stephen Wilkins,"['Romania', 'Palestinian Territory']",Athlete,1903,58,81,1961
Sarah White,"['Bahrain', 'British Virgin Islands']",Politician,1885,3,78,1888
Willie Anderson,['Cayman Islands'],Athlete,1885,38,40,1923
Tammy Long,['Hong Kong'],Military personnel,1907,21,71,1928
Dr. Wyatt Hardy,['Iraq'],Sovereign,1912,10,88,1922
Pamela Martinez,['Kyrgyz Republic'],Politician,1915,80,61,1995
Traci Garcia,"['India', 'Taiwan']",Researcher,1920,76,79,1996
Chad Ingram,['Kuwait'],Politician,1897,45,58,1942
Joseph Hawkins,"['Central African Republic', 'Oman']",Teacher,1907,31,65,1938
Juan Evans,"['Jersey', 'Aruba']",Politician,1879,20,6,1899
Roberto Morrison,"['Saint Barthelemy', 'Libyan Arab Jamahiriya']",Politician,1922,54,71,1976
James Sampson,['Zimbabwe'],Artist,1875,3,70,1878
Scott Haynes,"['Wallis and Futuna', 'Palau']",Politician,1889,17,13,1906
Brandon Salinas,"['Cuba', 'Mexico']",Artist,1879,28,79,1907
Christina Vargas,"['Mexico', 'Liechtenstein']",Politician,1873,4,24,1877
Kevin Hamilton,"['Benin', 'Paraguay']",Artist,1903,29,38,1932
Samuel Norris,['Honduras'],Politician,1909,68,38,1977
Matthew Pearson,"['Azerbaijan', 'Greenland']",Politician,1909,10,55,1919
Alexandra Mckinney,"['Indonesia', 'Israel']",Physiologist; ethologist,1914,83,29,1997
Anita Fitzgerald,"['Oman', 'Chad']",Monk,1877,75,64,1952
Kathleen Barrett DVM,"['Spain', 'Andorra']",Religious figure,1880,14,57,1894
Lisa Alvarez,"['Gabon', 'Canada']",Politician,1894,3,5,1897
Lydia Mathews,['Philippines'],Artist,1903,52,0,1955
David Peters,"['Guyana', 'Iraq']",Politician,1875,83,85,1958
Terry Austin,"['Zambia', 'Zambia']",Artist,1887,42,57,1929
Adriana Dunn,"['India', 'Guatemala']",Physician,1889,24,53,1913
Emma Ramirez,['Mexico'],Socialite,1899,45,86,1944
Joshua Walker,['Brazil'],Researcher,1899,41,40,1940
Joshua Stone,['Liechtenstein'],Artist,1891,24,13,1915
Richard Gonzalez,['Cambodia'],Politician,1902,36,81,1938
Randall Young,"['Luxembourg', 'Pitcairn Islands']",Artist,1876,63,36,1939
Timothy Fox,['Lithuania'],Artist,1873,81,89,1954
Todd Miles,"['Germany', 'Saint Pierre and Miquelon']",Samurai,1917,14,45,1931
Scott Richmond,"['Uzbekistan', 'Haiti']",Artist,1891,13,37,1904
Susan Davis,"['New Zealand', 'Angola']",Athlete,1916,22,65,1938
Eric Stein,['Cuba'],Artist,1924,68,22,1992
Angel Montoya,['Korea'],Samurai,1903,77,78,1980
Sarah Bailey,"['Western Sahara', 'Sao Tome and Principe']",Artist,1898,17,88,1915
Matthew Arnold,"['Kenya', 'Reunion']",Researcher,1883,39,29,1922
Lawrence Rogers,['British Indian Ocean Territory (Chagos Archipelago)'],Artist,1877,39,84,1916
Lawrence Kelly,"['Cook Islands', 'Antigua and Barbuda']",Artist,1903,68,81,1971
James Yang,"['Germany', 'Isle of Man']",Artist,1872,45,59,1917
Gregory Chavez,['Libyan Arab Jamahiriya'],Artist,1891,26,37,1917
Haley Holt,['Panama'],Impresario,1897,54,62,1951
Pamela Davies,"['Korea', 'Moldova']",Researcher,1919,16,42,1935
Randy Maynard,['Estonia'],Politician,1871,46,54,1917
Miguel Garcia,"[""Cote d'Ivoire"", 'Timor-Leste']",Serial killer; criminal,1878,45,43,1923
Sean Martin,"['Romania', 'Togo']",Ruler,1907,72,48,1979
Dalton Anderson,"['Congo', 'Romania']",Artist,1909,48,89,1957
Mr. Eric Griffith,"['Denmark', 'Guadeloupe']",Politician,1914,4,50,1918
Tommy Hughes,"['Ireland', 'Liberia']",Racing automobile driver,1897,36,43,1933
Willie Choi,"['Bermuda', 'Tokelau']",Businessperson,1917,35,9,1952
Kenneth Carter,"['Iceland', 'Saint Pierre and Miquelon']",Artist,1907,50,71,1957
Anna Mathews,"['Chile', 'Niue']",Athlete,1897,21,64,1918
Colleen Richard,['Ethiopia'],Artist,1892,57,22,1949
Kayla Davis,['Guadeloupe'],Researcher,1909,86,87,1995
Tracy Nielsen,"['Guatemala', 'Samoa']",Athlete,1898,4,39,1902
Denise Richardson,['Mongolia'],Artist,1872,53,20,1925
Mr. Stanley Henry,"['Turkmenistan', 'Nepal']",Artist,1909,81,8,1990
Carl Cook,"['France', 'Suriname']",Politician,1923,74,49,1997
Danielle Simpson,['Myanmar'],Artist,1910,17,38,1927
Holly George,"['Mauritania', 'Zimbabwe']",Artist,1920,2,78,1922
Curtis Hernandez,"['Niue', 'Chile']",Trade unionist,1905,83,81,1988
David Sandoval,['Cocos (Keeling) Islands'],Researcher,1892,31,77,1923
Tonya Jones,['French Guiana'],Chairperson; organizational founder,1872,47,87,1919
Gloria White,"['Tuvalu', 'Burundi']",Presbyter,1871,31,52,1902
Jessica Sandoval,['Bouvet Island (Bouvetoya)'],Politician,1871,81,88,1952
Brandy Beck,['Bulgaria'],Artist,1874,85,80,1959
Elijah Leblanc,['Grenada'],Researcher,1907,48,14,1955
Thomas Martinez,['Bulgaria'],Artist,1880,17,23,1897
Aaron Davis,['Turkmenistan'],Politician,1902,89,47,1991
Michelle Smith,"['Comoros', 'Sierra Leone']",Artist,1884,20,0,1904
Justin Espinoza,['Malta'],Artist,1913,82,64,1995
Brooke Cummings DDS,['Brunei Darussalam'],Artist,1874,27,36,1901
Sarah Henry,['Niue'],Artist,1872,33,34,1905
Charlene Baker MD,"['Kiribati', 'Niue']",Athlete,1870,9,22,1879
Michael Johnson,"['Trinidad and Tobago', 'Saint Kitts and Nevis']",Artist,1881,13,36,1894
Alexandra Graham,['Honduras'],Artist,1897,67,12,1964
Ashley Moreno,['Syrian Arab Republic'],Politician,1920,54,83,1974
Amber Brown,['China'],Amateur wrestler,1885,20,55,1905
Melissa Peterson,"['Senegal', 'Finland']",Military personnel,1889,25,7,1914
Sara Rhodes,"['Zambia', 'Slovenia']",Religious figure,1876,74,38,1950
Deborah Bailey,['Mongolia'],Artist,1897,88,21,1985
Zachary Green,"['Saudi Arabia', 'Lebanon']",Researcher,1876,76,21,1952
Daniel Bailey,"['Malaysia', 'Grenada']",Artist,1878,47,76,1925
Mike Farley,"['Turkey', 'Honduras']",Artist,1922,29,0,1951
Tina Adams,['Sierra Leone'],Artist,1894,69,51,1963
David Rivera,"['Iraq', 'France']",Artist,1900,11,77,1911
Anita Lester,['Guadeloupe'],Aristocrat,1873,56,32,1929
Rebecca Davis,['Australia'],Politician,1911,11,10,1922
Brandi Brennan,"['Panama', 'Montserrat']",Artist,1878,81,53,1959
Ashley Hughes,['United States Minor Outlying Islands'],Civil servant,1894,51,7,1945
Jonathan Holmes,"['Oman', 'Sweden']",Translator,1919,67,2,1986
Donna Castro,['Denmark'],Artist,1872,78,4,1950
Lisa Hobbs,"['French Guiana', 'Guinea']",Politician,1876,30,0,1906
Stephanie Franklin,['Faroe Islands'],Politician,1885,73,3,1958
Jacqueline Ferguson,['Swaziland'],Artist,1907,77,43,1984
Patrick Armstrong,"['Ecuador', 'Afghanistan']",Businessperson,1880,0,38,1880
Kimberly Wright,['Dominican Republic'],Military personnel,1885,81,29,1966
Gregory Mullins,"['Fiji', 'Ecuador']",Artist,1887,86,80,1973
Michael Tucker,['Angola'],Sociologist,1921,32,1,1953
Kristy Smith,"['Togo', 'Korea']",Artist,1878,56,47,1934
John Mooney,['Malta'],Researcher,1917,55,11,1972
Jason Adams,['Antigua and Barbuda'],Artist,1913,22,19,1935
Nicole Brooks,['Kazakhstan'],Artist,1890,11,89,1901
Matthew Garcia,"['Togo', 'France']",Politician,1922,62,32,1984
Brian Bell,['Bhutan'],Military personnel,1923,77,59,2000
Adam Wilkinson,['Antarctica (the territory South of 60 deg S)'],Politician,1910,63,1,1973
Timothy Walker,"['Australia', 'Zimbabwe']",Politician,1918,15,89,1933
Brittany George,"['Grenada', 'United Kingdom']",Plumber,1908,20,68,1928
Jose Johnson,"['New Caledonia', 'Sudan']",Researcher,1875,25,25,1900
Robert Fields,['United States Minor Outlying Islands'],Artist,1900,40,22,1940
Patrick Hernandez,"['Kiribati', 'Guinea']",Researcher,1890,56,32,1946
Jonathan Nguyen Jr.,['Hong Kong'],Politician,1890,74,38,1964
Alice Jones,['Eritrea'],Artist,1906,89,88,1995
Julie Mclaughlin,"['Azerbaijan', 'Senegal']",Artist,1916,69,34,1985
Christine Davis,['Albania'],Politician,1897,26,60,1923
Gregory Sherman,"['Holy See (Vatican City State)', 'Taiwan']",Athlete,1884,41,29,1925
Erik Mullen,"['Slovakia (Slovak Republic)', 'French Southern Territories']",Athlete,1912,33,86,1945
Angela Winters,['Timor-Leste'],Artist,1902,32,12,1934
Joshua Nelson,['Tanzania'],Entrepreneur,1890,22,61,1912
George Blackburn,['Croatia'],Researcher,1872,9,82,1881
John Jones,"['Portugal', 'Mayotte']",Artist,1917,12,62,1929
Johnny Smith,"['Luxembourg', 'Switzerland']",Politician,1917,58,35,1975
David Ward,"['Bangladesh', 'Antarctica (the territory South of 60 deg S)']",Artist,1893,43,28,1936
Michael Bryan,"['Thailand', 'Montserrat']",Athlete,1917,27,66,1944
Willie Duncan,"['Morocco', 'Micronesia']",Athlete,1909,61,44,1970
Becky Wood,['Mali'],Artist,1900,85,2,1985
Brett David MD,['Liechtenstein'],Flight attendant; nurse,1874,77,17,1951
Dr. Jeffrey Hicks,"['Eritrea', 'Guadeloupe']",Politician,1910,51,49,1961
Courtney Campbell,"['Tokelau', 'Timor-Leste']",Athlete,1912,4,2,1916
Dustin Cruz,"['Slovakia (Slovak Republic)', 'Wallis and Futuna']",Researcher,1874,58,71,1932
Kyle Perez,"['Burkina Faso', 'Bangladesh']",Athlete,1904,5,5,1909
Vincent Gonzalez,"['Georgia', 'Mexico']",Artist,1879,10,73,1889
Kelsey Andrade,"['Montserrat', 'Zambia']",Politician,1898,5,5,1903
Susan Harrison,['Palau'],Politician,1878,2,20,1880
Emily Mccarthy,['Tokelau'],Athlete,1894,5,44,1899
Daniel Whitaker,"['Ukraine', 'Seychelles']",Artist,1889,12,35,1901
Ronald Price,"['American Samoa', 'American Samoa']",Artist,1903,8,16,1911
Danielle Jacobs,"['Kyrgyz Republic', 'Angola']",Politician,1903,61,22,1964
Angel Gordon,"['Kuwait', 'San Marino']",Researcher,1920,75,58,1995
Thomas Martin,['Papua New Guinea'],Athlete,1876,36,25,1912
William Eaton,['Gibraltar'],Politician,1883,48,52,1931
John Young,['French Southern Territories'],Criminal,1915,55,45,1970
Dawn Hogan,"['Guinea', 'Ethiopia']",Artist,1923,48,75,1971
Cindy Pierce,"['French Polynesia', 'Maldives']",Politician,1872,82,86,1954
Elizabeth Richardson,"['Eritrea', 'British Indian Ocean Territory (Chagos Archipelago)']",Athlete,1920,39,49,1959
Elizabeth Holmes,['Guyana'],Politician,1881,82,43,1963
Stephanie Russell,"['Paraguay', 'Anguilla']",Mountaineer; explorer,1917,30,7,1947
Keith Floyd,"['Australia', 'Mongolia']",Artist,1911,20,12,1931
Christopher Reyes,"['Gabon', 'French Guiana']",Researcher,1911,71,47,1982
Mrs. Christine Simpson,"['Andorra', 'Benin']",Politician,1922,78,89,2000
Adam Gordon,"['Swaziland', 'Latvia']",Artist,1898,4,11,1902
Maureen Ferrell,['Christmas Island'],Military personnel,1909,0,36,1909
Brandon Myers,['Poland'],Artist,1910,36,13,1946
Jennifer Holland,['Saint Vincent and the Grenadines'],Artist,1908,40,2,1948
Patrick Johnson DDS,"['Kuwait', 'Venezuela']",Artist,1910,87,65,1997
Kyle Holmes,"['Gambia', 'Australia']",Athlete,1921,60,79,1981
Tanya Hardy,"['Malawi', 'Guyana']",Artist,1894,20,47,1914
Jeffery Wright,['Hong Kong'],Artist,1913,47,88,1960
Emily Goodwin,"['Falkland Islands (Malvinas)', 'Switzerland']",Researcher,1924,56,56,1980
Nicole Elliott,['Korea'],Athlete,1891,40,50,1931
Aaron Morgan,['Cayman Islands'],Artist,1888,66,80,1954
Erica Crawford,['Ecuador'],Artist,1896,10,25,1906
Rebecca Gilbert,['Zambia'],Rally driver,1884,27,69,1911
Jeff Willis,['Portugal'],Researcher,1909,40,3,1949
Vernon Wang,"['El Salvador', 'Tuvalu']",Politician,1894,17,47,1911
Krystal Salinas,"['Lithuania', 'Spain']",Racing driver; racing automobile driver,1921,64,23,1985
Rachel Sanders,['Ukraine'],Researcher,1894,52,30,1946
Lindsay Armstrong,['Hong Kong'],Artist,1922,63,85,1985
Brandon Hunt,"['Armenia', 'Saint Barthelemy']",Artist,1908,47,20,1955
Kathryn Roth,['Sierra Leone'],Artist,1875,62,64,1937
Anita Hester,['Zimbabwe'],Artist,1905,21,75,1926
Eduardo Diaz,"['Cyprus', 'New Caledonia']",Mountaineer,1916,66,18,1982
Mitchell Silva,"['Switzerland', 'British Indian Ocean Territory (Chagos Archipelago)']",Serial killer,1896,21,73,1917
William Fuentes,['Thailand'],Motorcycle racer,1908,13,23,1921
Linda Nichols,['British Virgin Islands'],Artist,1882,49,85,1931
Olivia Hines,"['Comoros', 'Cuba']",Artist,1878,60,33,1938
Kristina Russell,"['Israel', 'Macao']",Artist,1907,3,43,1910
Rachel Bailey,['Turkmenistan'],Artist,1896,38,52,1934
Carolyn Bond,['Qatar'],Artist,1877,57,43,1934
Kristina Bowman,"['Mayotte', 'Belize']",Artist,1874,75,64,1949
Andrew Watkins,"['Japan', 'Hong Kong']",Researcher,1883,79,2,1962
Denise Forbes,"['Grenada', 'Denmark']",Artist,1877,24,11,1901
Jeffrey Warren,"['Luxembourg', 'Dominican Republic']",Artist,1915,12,65,1927
Paul Noble,"['Falkland Islands (Malvinas)', 'Eritrea']",Researcher,1910,43,49,1953
Michael Caldwell,['Swaziland'],Military personnel,1908,34,18,1942
Don Odom,"['Bouvet Island (Bouvetoya)', 'Georgia']",Athlete,1919,75,10,1994
Allison Hughes,"['Israel', 'Bulgaria']",Researcher,1873,34,61,1907
Ann Lee,"['British Virgin Islands', 'Aruba']",Researcher,1897,82,29,1979
Danielle York,"['Papua New Guinea', 'Bhutan']",Artist,1920,9,17,1929
Toni Reid,['United States Minor Outlying Islands'],Artist,1890,54,37,1944
Laura Mckenzie,"['United States Virgin Islands', 'Cape Verde']",Judoka,1906,16,64,1922
Yvette Sanders,"['Oman', 'Anguilla']",Researcher,1872,37,42,1909
Angela Anderson,['Switzerland'],Artist,1910,71,65,1981
Sarah Reynolds,['North Macedonia'],Artist,1881,87,64,1968
Tara Doyle,['Grenada'],Artist,1919,4,60,1923
Marc Duke,"['Fiji', 'Central African Republic']",Artist,1891,68,21,1959
Sergio Hinton,['Timor-Leste'],Religious figure,1896,82,16,1978
Judith Brown,['Ethiopia'],Artist,1879,22,54,1901
Laurie Morton,['Marshall Islands'],Artist,1891,1,45,1892
Larry Kirk,"[""Cote d'Ivoire""]",Artist,1872,49,16,1921
Heather Peterson,['Myanmar'],Politician,1896,33,36,1929
Amy Gardner,"['Mayotte', 'Falkland Islands (Malvinas)']",Artist,1884,2,39,1886
Vanessa Edwards,['Cook Islands'],Artist,1872,89,57,1961
Diane Wilson,"['Christmas Island', 'Holy See (Vatican City State)']",Artist,1909,63,43,1972
Rachel Berry,"['Chile', 'Ghana']",Marathon runner,1893,4,89,1897
Kelli Smith,"['Russian Federation', 'Ireland']",Researcher,1892,0,16,1892
Michael Anderson,"['Cameroon', 'Gambia']",Railroad construction foreman,1899,21,8,1920
Michael Crawford,"['Albania', 'Brunei Darussalam']",Artist,1900,57,84,1957
Frank Myers,['Montserrat'],Teacher,1871,25,74,1896
Barbara Kim,['North Macedonia'],Politician,1898,41,37,1939
Christina Davis,"['Tajikistan', 'Austria']",Politician,1912,11,45,1923
Angela Shaw,"['Guyana', 'Montenegro']",Athlete,1878,49,22,1927
Paula Wade,"['Israel', 'Belarus']",Athlete,1891,83,63,1974
Gregory Martin,['Armenia'],Artist,1918,33,36,1951
Paul Hernandez,"['Portugal', 'Antigua and Barbuda']",Artist,1911,31,78,1942
Logan Webb,['Bouvet Island (Bouvetoya)'],Monarch,1914,38,31,1952
Natalie Anderson,"['Lesotho', 'Korea']",Artist,1881,84,89,1965
Lisa Mitchell,['Algeria'],Politician,1901,15,60,1916
Craig Holmes,['Madagascar'],Athlete,1876,80,39,1956
Angela Goodman,"['Togo', 'Lithuania']",Researcher,1879,54,25,1933
Madeline Weaver,['Liberia'],Criminal,1919,35,77,1954
John Dougherty,['Puerto Rico'],Artist,1874,46,89,1920
Shawn Braun,"['Svalbard & Jan Mayen Islands', 'Greenland']",Religious figure,1875,31,29,1906
Nathan Kaufman,"['Northern Mariana Islands', 'Cocos (Keeling) Islands']",Politician,1908,74,73,1982
Jennifer Smith,"['Puerto Rico', 'Djibouti']",Pianist; music pedagogue,1910,4,29,1914
William Beard,"['Ecuador', 'Hong Kong']",Politician,1881,38,61,1919
Ryan Delacruz,['Christmas Island'],Military personnel,1906,64,70,1970
Jordan Shaw,"['Nepal', 'Antigua and Barbuda']",Artist,1916,13,61,1929
Stacie Andrade,"['Benin', 'Tuvalu']",Artist,1874,81,6,1955
Robert Morgan,['Uruguay'],Researcher,1909,81,12,1990
Mr. Jeffery Underwood,['Trinidad and Tobago'],Aristocrat,1884,88,4,1972
Michael Bullock,"['Syrian Arab Republic', 'New Zealand']",Mountaineer,1902,32,86,1934
Jennifer Reyes,['Congo'],Artist,1875,58,4,1933
Kenneth Nelson,['Iceland'],Artist,1876,72,87,1948
John Webb,"['Saudi Arabia', 'Bahrain']",Athlete,1895,59,66,1954
Joshua Barnes,['Malta'],Politician,1871,25,71,1896
Leah Wallace,['Sweden'],Artist,1908,52,1,1960
Gary Fernandez,"[""Cote d'Ivoire"", 'Spain']",Artist,1910,23,30,1933
James Whitehead,['Jordan'],Religious figure,1880,76,51,1956
Ashley Brown,['Saint Lucia'],Artist,1872,59,47,1931
Alexandra Hatfield,['Lebanon'],Athlete,1896,17,9,1913
Harold Johnson,"['Trinidad and Tobago', 'Papua New Guinea']",Artist,1881,30,28,1911
Hannah Rivera,"['Solomon Islands', 'Kiribati']",Military personnel,1919,63,41,1982
Kathryn Roman,"['Malaysia', 'Niue']",Artist,1876,82,46,1958
Kathleen Scott,['Taiwan'],Politician,1882,62,6,1944
Katherine White,"['New Zealand', 'South Georgia and the South Sandwich Islands']",Artist,1917,80,37,1997
Seth Madden,['Panama'],Artist,1911,2,88,1913
Robin Harrington,['Mozambique'],Researcher,1893,82,33,1975
Timothy Lang,"['Belgium', 'Madagascar']",Politician,1906,72,59,1978
Felicia Carr,"['Wallis and Futuna', 'Spain']",Artist,1923,62,31,1985
Joyce Williams,['Jamaica'],Artist,1901,8,64,1909
Edward Huang,['Guadeloupe'],Artist,1893,40,41,1933
Monica Harris DVM,['Montenegro'],Artist,1890,40,39,1930
Roy Blevins,"['Northern Mariana Islands', 'Bulgaria']",Politician,1917,12,48,1929
Kaitlin Curtis,"['Honduras', 'Mauritania']",Politician,1904,85,19,1989
Reginald Murphy,['Isle of Man'],Politician,1870,63,71,1933
Deanna Calderon,['Turkmenistan'],Politician,1893,6,60,1899
Maria Stone,"['British Indian Ocean Territory (Chagos Archipelago)', 'Wallis and Futuna']",Researcher,1901,44,12,1945
Bonnie Soto,['Malaysia'],Artist,1902,40,58,1942
Brian Flores,"['Belize', 'Haiti']",Artist,1900,0,34,1900
Wendy Gonzalez,['Madagascar'],Athlete,1900,72,56,1972
Kathryn Harris DDS,['Lithuania'],Artist,1921,4,29,1925
John West,"['Jersey', 'Bangladesh']",Artist,1886,22,9,1908
Gregory Phillips,"['Bahrain', 'Timor-Leste']",Artist,1896,21,67,1917
Adam Singleton,"['Eritrea', 'Pakistan']",Artist,1873,19,25,1892
Rachel Smith,['Swaziland'],Artist,1892,43,48,1935
Lauren Hunt,"['Burundi', 'Romania']",Artist,1872,81,5,1953
Thomas Riggs,"['Honduras', 'Colombia']",Athlete,1885,79,24,1964
Rebecca Wilkins,"['Palestinian Territory', 'American Samoa']",Athlete,1881,51,35,1932
Ryan Wong DDS,"['Iceland', 'Anguilla']",Artist,1877,18,21,1895
Kaylee Best,"['Ukraine', 'Bahamas']",Artist,1874,32,36,1906
Samuel Smith,['Lesotho'],Artist,1878,62,13,1940
Reginald Gross,"['Peru', 'Belarus']",Artist,1878,29,87,1907
Walter Wright,"['Pitcairn Islands', 'Moldova']",Artist,1870,62,56,1932
Susan Ferguson,['Azerbaijan'],Artist,1880,31,68,1911
Ralph Murray,['Panama'],Artist,1881,53,35,1934
Michael Riley,"['South Africa', 'Netherlands Antilles']",Ballet dancer; dancer,1905,51,32,1956
Michael Hensley,['Saint Lucia'],Religious figure,1900,52,48,1952
Bryce Gillespie,['Saint Pierre and Miquelon'],Artist,1879,22,42,1901
Paul Fox,"['Philippines', 'Solomon Islands']",Artist,1875,2,63,1877
Mark Wood,"['Jamaica', 'Hong Kong']",Athlete,1912,14,8,1926
Tyler Ferrell,['Armenia'],Artist,1891,53,71,1944
Monica Warren,"['China', 'Swaziland']",Researcher,1880,45,76,1925
Linda Brewer,"['Australia', 'Botswana']",Magician,1879,29,46,1908
Todd Melton,['Chad'],Researcher,1920,48,16,1968
Robert Kemp,"['Cocos (Keeling) Islands', 'Ecuador']",Artist,1873,47,39,1920
Richard Nelson,['Guinea'],Concentration camp guard,1903,36,82,1939
Kristin Martinez,"['Vietnam', ""Lao People's Democratic Republic""]",Artist,1873,88,28,1961
Jonathan Taylor,"['Uruguay', 'Singapore']",Researcher,1889,10,36,1899
Samantha Douglas,['Qatar'],Artist,1896,49,24,1945
Michael Sanders,"['Mexico', 'Philippines']",Artist,1885,29,36,1914
Ruth Watkins,['Sao Tome and Principe'],Artist,1920,28,6,1948
Jose Jones,['Indonesia'],Politician,1894,13,73,1907
Christine Stanley,['Dominica'],Artist,1910,21,87,1931
Mr. Daniel Martin MD,"['Indonesia', 'Bangladesh']",Teacher,1922,8,76,1930
Garrett Garcia,['Guatemala'],Artist,1922,84,3,2006
Beth Oconnell,['Eritrea'],Long-distance runner,1922,81,55,2003
Jennifer Berry,"['Norway', 'Saint Vincent and the Grenadines']",Military personnel,1900,71,63,1971
Michael Freeman,['Korea'],Artist,1892,9,37,1901
Billy Fisher,['Palau'],Artist,1922,27,72,1949
Melissa Perez,['Lithuania'],Artist,1922,38,89,1960
Gina Williams,"['Central African Republic', 'Ecuador']",Artist,1879,6,9,1885
Christopher Pittman,"['United States Virgin Islands', 'South Georgia and the South Sandwich Islands']",Politician,1879,83,66,1962
Mary Leon,['Zambia'],Artist,1905,7,78,1912
Jacqueline Dunn,['Albania'],Researcher,1901,47,85,1948
Anthony Ford,['Mexico'],Artist,1903,32,72,1935
Eric Pierce,['Djibouti'],Artist,1906,59,25,1965
John Stewart,['United Arab Emirates'],Researcher,1896,7,47,1903
Laura Smith,"['Taiwan', 'Cyprus']",Artist,1891,81,8,1972
Kristin Richardson,"['Antarctica (the territory South of 60 deg S)', 'Turkmenistan']",Researcher,1892,65,4,1957
Stephen Graham,['Tonga'],Researcher,1888,65,40,1953
Harold Alvarez,"['Pitcairn Islands', 'Dominica']",Artist,1890,67,44,1957
Angela Maldonado,"['Anguilla', 'Germany']",Politician,1900,20,13,1920
Dennis Harrison,"['Tajikistan', 'Poland']",Artist,1894,17,19,1911
Cody Johnson,"['Gabon', 'Mongolia']",Artist,1893,27,37,1920
Tracy Ward,['Paraguay'],Athlete,1895,56,39,1951
Erika Moon,"['Greece', 'Western Sahara']",Artist,1873,4,44,1877
Brandon Perez,"['Cook Islands', 'Cook Islands']",Politician,1908,5,33,1913
Victor Cardenas,['Egypt'],Artist,1895,14,19,1909
James Wagner,"['Kuwait', 'Martinique']",Artist,1905,1,82,1906
Carmen Love,"['Greece', 'Guernsey']",Politician,1919,42,66,1961
Shelley Duncan,['Uruguay'],Artist,1904,54,85,1958
Sean Ford,"['New Zealand', 'Slovakia (Slovak Republic)']",SalonniÃ¨re,1876,59,73,1935
Debra Logan,['Korea'],Researcher,1887,86,26,1973
Shelby Fleming,"['Eritrea', 'Yemen']",Military personnel,1897,14,19,1911
Samantha Smith,['El Salvador'],Athlete,1918,67,53,1985
Natasha Ellis,['Saint Vincent and the Grenadines'],Artist,1923,0,21,1923
Tammie Garcia,['Marshall Islands'],Artist,1879,28,55,1907
Megan Oconnor,['Guinea-Bissau'],Artist,1911,50,14,1961
Dana Reyes,"['Sweden', 'Bangladesh']",Artist,1880,86,82,1966
Wendy Hill,"['Mali', 'Ethiopia']",Forensic psychiatrist,1886,7,45,1893
Kaitlin Wilcox,['Bangladesh'],Artist,1905,74,88,1979
George Mccann,['Belize'],Politician,1890,23,58,1913
Emily Sanders,"['Saint Vincent and the Grenadines', 'Russian Federation']",Researcher,1900,66,25,1966
Jillian Rivera,['El Salvador'],Artist,1892,87,20,1979
James Ruiz,['Mayotte'],Athlete,1913,86,9,1999
Beth Wu,"['French Guiana', 'Faroe Islands']",Researcher,1900,54,17,1954
Timothy Johnson,"['Djibouti', 'Greenland']",Artist,1873,67,73,1940
Jasmine Bright MD,"['Anguilla', 'Lebanon']",Conductor,1892,2,30,1894
Shannon Walton,['Egypt'],Artist,1902,17,11,1919
Natasha Klein,"['San Marino', 'Equatorial Guinea']",Artist,1875,60,60,1935
Allison English,['New Caledonia'],Politician,1904,74,25,1978
David Harris,['South Africa'],Politician,1903,36,42,1939
Darrell Graves,"['Egypt', 'Hong Kong']",Artist,1883,0,30,1883
Evan Rogers,"['Guadeloupe', 'Timor-Leste']",Researcher,1871,15,35,1886
Christopher Webb,['Madagascar'],Artist,1908,9,0,1917
Harry Ortiz,['Gambia'],Politician,1872,74,34,1946
Jennifer Dixon,['France'],Politician,1906,78,14,1984
Brett Butler,"['Mayotte', 'Timor-Leste']",Artist,1871,89,4,1960
Nicole Evans,"[""Cote d'Ivoire"", 'Albania']",Politician,1878,89,19,1967
Maria Avery,['Barbados'],Artist,1917,35,21,1952
Stephen Rogers,"['Belize', 'Oman']",Physician,1878,29,72,1907
George Frey,['United States Minor Outlying Islands'],Politician,1886,62,20,1948
Jared Hammond,['Mauritania'],Artist,1907,59,11,1966
Patricia Smith,['Gabon'],Artist,1897,3,1,1900
Elizabeth Knight,"['Grenada', 'Romania']",Artist,1886,66,61,1952
Julie Collier,['Azerbaijan'],Politician,1896,65,43,1961
Daniel Rivera,['Denmark'],Artist,1918,12,32,1930
Samuel Nolan,"['Cameroon', 'Montserrat']",Athlete,1906,16,62,1922
Sergio Cline,"['Chad', 'Reunion']",Artist,1902,56,73,1958
Katrina Wyatt,"['Antigua and Barbuda', 'Serbia']",Artist,1870,44,74,1914
Patrick Gonzales,['Gibraltar'],Artist,1882,28,22,1910
Jack Wood,['Heard Island and McDonald Islands'],Politician,1924,22,8,1946
Jeremy Gallegos,"['Niger', 'Dominican Republic']",Artist,1897,51,48,1948
Johnny Ferguson,"['Croatia', 'Qatar']",Researcher,1872,46,74,1918
Andrew Smith,"['Jordan', 'Lesotho']",Artist,1905,59,5,1964
Kimberly Smith,"['Yemen', 'Switzerland']",Artist,1923,57,81,1980
Emily Wilkins,"['Montserrat', 'Turkmenistan']",Politician,1923,35,74,1958
Donna Rice,"['Austria', 'Lebanon']",Researcher,1892,80,89,1972
Rachel Wilson,"['Micronesia', 'Lithuania']",Politician,1886,46,70,1932
Edward Leblanc,"['Falkland Islands (Malvinas)', 'Portugal']",Artist,1870,29,55,1899
Andrew Mooney,"['Sudan', 'Guinea']",Artist,1900,64,9,1964
Manuel Tran,['Puerto Rico'],Merchant; murderer,1891,47,21,1938
Karen Reed,['British Indian Ocean Territory (Chagos Archipelago)'],Artist,1877,84,46,1961
Susan Rodriguez,['French Guiana'],Religious figure,1920,56,27,1976
Steven Yoder,"['Nicaragua', 'Swaziland']",Religious figure,1907,51,62,1958
John Holland,"['Djibouti', 'Costa Rica']",Researcher,1922,40,19,1962
Wayne Foley,['Tokelau'],Artist,1912,60,33,1972
Miranda Williams,['Suriname'],Artist,1871,83,3,1954
Debbie Tran,['Jamaica'],Neurologist; physiologist; anatomist,1921,80,68,2001
Victoria Smith,"['Anguilla', 'Vanuatu']",Artist,1913,16,49,1929
Ellen Lucero,"['Botswana', 'Angola']",Artist,1900,60,82,1960
Kelly Tucker,"['Suriname', 'Australia']",Artist,1909,11,2,1920
Matthew Atkinson,"['Palau', 'Saint Kitts and Nevis']",Artist,1903,20,49,1923
Amanda Larson,"['Jordan', 'Burundi']",Artist,1899,78,25,1977
Matthew Armstrong,"['Costa Rica', 'Indonesia']",Lawyer,1913,31,73,1944
Andrea Phillips,['Kiribati'],Aristocrat,1894,63,32,1957
Laura Turner,['Gibraltar'],Athlete,1912,64,62,1976
Nicole Chen,"['Bouvet Island (Bouvetoya)', 'Korea']",Artist,1914,57,59,1971
Julie Oliver,"['Ireland', 'Azerbaijan']",Politician,1883,7,44,1890
Matthew Johnson,"['Puerto Rico', 'Iceland']",Sprinter,1916,35,73,1951
Stacy Wells,['Montenegro'],Researcher,1924,84,10,2008
Jordan Jacobs,['Seychelles'],Politician,1872,87,53,1959
Colin Chase,"['Cocos (Keeling) Islands', 'Namibia']",Artist,1921,29,9,1950
Jeffrey Riley,"['Saint Lucia', 'Seychelles']",Artist,1903,6,14,1909
Crystal Turner,"['Belarus', 'Benin']",Motorcycle racer; racing automobile driver,1896,79,61,1975
Sharon Murphy,['United Arab Emirates'],Artist,1915,34,39,1949
Andrew Davis,['Jamaica'],Artist,1923,70,12,1993
Travis Webb,['Niger'],Artist,1915,56,85,1971
Scott Anderson,['Brazil'],Researcher,1882,65,62,1947
Johnathan Kim,"['South Georgia and the South Sandwich Islands', 'Saint Kitts and Nevis']",Politician,1891,33,87,1924
David Larson,"['Sierra Leone', 'Western Sahara']",Artist,1877,37,74,1914
Renee Young,"['Sao Tome and Principe', 'Hong Kong']",Artist,1887,44,15,1931
Elizabeth Bennett,"['Vietnam', 'Bouvet Island (Bouvetoya)']",Politician,1894,22,39,1916
Randy Cunningham,['Niue'],Entrepreneur,1872,26,17,1898
Victoria Hubbard,"['Mexico', 'Mexico']",Politician,1894,72,72,1966
Christina Hinton,['Djibouti'],Artist,1883,69,72,1952
Matthew Hester,['Algeria'],Politician,1899,19,58,1918
Beth Prince,['Suriname'],Artist,1923,76,57,1999
Robert Brown,['Sierra Leone'],Samurai,1895,50,78,1945
Peter Hinton,['Tunisia'],Businessperson,1898,8,2,1906
Maria Pierce,"['Western Sahara', 'Micronesia']",Athlete,1896,15,4,1911
James Moore,['Saudi Arabia'],Artist,1890,8,4,1898
Chad Burns,['Reunion'],Artist,1913,69,34,1982
Seth Ewing,['Guernsey'],Athlete,1908,37,31,1945
Meghan Garcia,"['Svalbard & Jan Mayen Islands', 'Uruguay']",Artist,1887,61,78,1948
Jamie Whitney,['Saint Barthelemy'],Politician,1889,17,83,1906
Andrea Romero,['Bermuda'],Athlete,1885,60,11,1945
Kristina Mcintosh,['Saint Pierre and Miquelon'],Feudatory,1881,4,8,1885
Heather Cummings,['Niue'],Military personnel,1889,22,63,1911
Joshua Kelly,['Hong Kong'],Politician,1896,1,9,1897
Emily Harmon,['Korea'],Politician,1911,16,19,1927
Bryan Abbott,['American Samoa'],Artist,1913,56,78,1969
Jacob Burke,"['French Guiana', 'Namibia']",Translator,1914,89,37,2003
Joshua Lewis,"['Anguilla', 'French Southern Territories']",Artist,1880,27,64,1907
Heidi Walton,['Lesotho'],Artist,1912,59,71,1971
Amber Richardson,['French Guiana'],Military personnel,1907,1,37,1908
Christina Hill,"['Italy', 'United States Minor Outlying Islands']",Artist,1899,42,35,1941
Brandon Reese,"['South Georgia and the South Sandwich Islands', 'New Caledonia']",Politician,1912,54,71,1966
Wesley Phillips,"['Comoros', 'Greece']",Artist,1910,68,35,1978
Donald Johnson,['Guam'],Artist,1904,42,35,1946
Paige Daugherty,"['Venezuela', 'South Georgia and the South Sandwich Islands']",Politician,1884,23,1,1907
Matthew Anderson,"['Zambia', 'Haiti']",Artist,1871,25,86,1896
Diana Schwartz,['Holy See (Vatican City State)'],Politician,1921,88,38,2009
Emma Davis,"['American Samoa', 'Gibraltar']",Politician,1878,9,74,1887
Peggy Roberts,"['Senegal', 'Iran']",Military personnel,1881,85,34,1966
Janice Miller,['Mexico'],Artist,1890,58,85,1948
Kevin Ruiz,['Turkmenistan'],Politician,1912,62,4,1974
Ronald Smith,['Bouvet Island (Bouvetoya)'],Artist,1908,57,60,1965
Morgan Arnold,['Guam'],Researcher,1884,45,83,1929
Veronica Compton,"['Falkland Islands (Malvinas)', 'Hong Kong']",Artist,1896,80,5,1976
Rebecca Hanson,"['Cayman Islands', 'Qatar']",Artist,1922,7,63,1929
Ashlee Simmons,"[""Lao People's Democratic Republic"", 'Isle of Man']",Monk,1902,50,35,1952
Brian Page,['Northern Mariana Islands'],Artist,1913,0,82,1913
Miss Chelsea Harris,['Bhutan'],Politician,1889,55,64,1944
Tina Morales,"['Western Sahara', 'United States Minor Outlying Islands']",Artist,1875,12,14,1887
Stephanie Chandler,['Macao'],Artist,1911,78,15,1989
Charles Larson,['Fiji'],Politician,1876,82,78,1958
Kent Larson,['Libyan Arab Jamahiriya'],Artist,1898,2,31,1900
Casey Cox,"['Marshall Islands', 'Suriname']",Politician,1887,5,26,1892
Robert Walker,"['French Southern Territories', 'New Caledonia']",Artist,1905,0,72,1905
Susan Watson,['Faroe Islands'],Athlete,1904,3,50,1907
Jacob Smith,"['Liechtenstein', 'Guadeloupe']",Politician,1906,76,20,1982
Steven Hoffman,"['Morocco', 'Burundi']",Politician,1890,69,31,1959
Maria Johnson,['Falkland Islands (Malvinas)'],Politician,1906,46,47,1952
Thomas Nguyen,"['Maldives', 'Honduras']",Artist,1897,64,38,1961
Michele Jimenez,"['Sri Lanka', 'Palau']",Artist,1901,79,66,1980
Lori Cruz,"['Mozambique', 'Guatemala']",Artist,1873,79,15,1952
Anna Avila,['Jordan'],Artist,1906,37,69,1943
Nancy Massey,"['Jordan', 'Thailand']",Researcher,1900,37,55,1937
Holly Weber,['Dominican Republic'],Researcher,1911,62,8,1973
Danielle Conley,"['Belgium', 'El Salvador']",Religious figure,1885,43,16,1928
Andrew Davenport,"['Belgium', 'Tokelau']",Sovereign,1880,55,63,1935
Dustin Flores,['Martinique'],Artist,1881,5,75,1886
Donna Adams,"['Iraq', 'Vanuatu']",Artist,1917,18,36,1935
Alexander Johnson,"['Comoros', 'Equatorial Guinea']",Researcher,1907,79,6,1986
Kim Strickland,['Moldova'],Artist,1878,9,87,1887
Elizabeth Salas,"['British Virgin Islands', 'United States Minor Outlying Islands']",Artist,1884,29,35,1913
Heather Miller,"['Equatorial Guinea', 'Gibraltar']",Athlete,1906,27,78,1933
Troy Johnson,['Dominica'],Athlete,1897,73,22,1970
Darrell Graham,"['Guatemala', 'Vietnam']",Researcher,1895,18,36,1913
Deanna Delacruz,"['Marshall Islands', 'Luxembourg']",Translator,1870,47,35,1917
Peter Wilson,['French Polynesia'],Artist,1913,81,52,1994
Jeremy Turner,['Trinidad and Tobago'],Serial killer; criminal,1898,25,18,1923
Amanda Rowe PhD,['Guyana'],Publisher,1891,36,65,1927
Jonathan Jones,['United Kingdom'],Artist,1898,18,21,1916
Teresa Jones,['Kenya'],Politician,1877,26,69,1903
Christian Mendoza,['Syrian Arab Republic'],Artist,1918,0,83,1918
Adam Rodgers,['French Southern Territories'],Explorer,1877,55,36,1932
Samantha Miller,"['Western Sahara', 'Somalia']",Artist,1895,58,67,1953
Kenneth Anderson,"['Faroe Islands', 'French Guiana']",Athlete,1920,30,51,1950
Jacob Wallace,['Sierra Leone'],Artist,1917,70,63,1987
Beth Wallace,"['Bahamas', 'Equatorial Guinea']",Artist,1884,22,42,1906
Jeremy Hall,['Nigeria'],Game designer; role-playing game designer,1913,80,69,1993
Luis Brown,['Armenia'],Artist,1915,16,79,1931
Ryan Morris,['Tanzania'],Politician,1911,53,37,1964
Jonathan Campbell,"['Paraguay', 'Bolivia']",Artist,1906,66,84,1972
Patrick Miller,['Tokelau'],Politician,1879,86,80,1965
Paul Foster,"['India', 'Chad']",Politician,1874,79,89,1953
Tina Moss,"['Greece', 'Sri Lanka']",Artist,1907,82,86,1989
Abigail Coffey,"['New Zealand', 'Bolivia']",Politician,1916,6,69,1922
Tiffany Pierce,['Nicaragua'],Politician,1893,76,89,1969
Jordan Sanders,"['Serbia', 'Azerbaijan']",Entrepreneur,1913,41,21,1954
Kevin Foster,"['Madagascar', 'Martinique']",Athlete,1906,87,44,1993
Philip Reed,"['Taiwan', 'Australia']",Artist,1896,67,19,1963
Jon Rice,['Korea'],Businessperson,1919,85,33,2004
Brian Collins,['Colombia'],Artist,1876,27,37,1903
Beth Carrillo,"['South Georgia and the South Sandwich Islands', 'Argentina']",Artist,1879,3,4,1882
John Gonzalez,['Liberia'],Military personnel,1886,87,45,1973
Travis Bartlett,['Fiji'],Politician,1899,55,29,1954
Isaac Garrison,['Turkey'],Politician,1873,39,8,1912
Teresa Hart,['Canada'],Researcher,1914,70,25,1984
Kathy Brown,['Guernsey'],Artist,1904,48,23,1952
Dylan Chang,['Costa Rica'],Ruler,1893,1,4,1894
Robert Bowman,"['Switzerland', 'Kenya']",Politician,1872,58,59,1930
Jacob Finley,['Paraguay'],Artist,1893,53,14,1946
Robert Hernandez,['Papua New Guinea'],Explorer,1915,4,39,1919
Donald Long,['Venezuela'],Politician,1895,84,51,1979
Jessica Graham,['Czech Republic'],Politician,1882,16,53,1898
Carrie Bennett,"['Liberia', 'Monaco']",Artist,1873,58,17,1931
Brad Dunn,['Sri Lanka'],Artist,1890,25,57,1915
Patty Hernandez,['Saint Barthelemy'],Artist,1919,58,85,1977
Don Graves,"[""Lao People's Democratic Republic"", 'Denmark']",Politician,1897,33,43,1930
Kevin Aguilar,['Venezuela'],Military personnel,1870,53,89,1923
Christopher Davila,['Somalia'],Politician,1907,81,82,1988
Megan Gonzalez,"[""Cote d'Ivoire""]",Artist,1872,84,68,1956
Brenda Shaw,['Swaziland'],Artist,1906,17,48,1923
Sharon Davis,['Sao Tome and Principe'],Artist,1923,56,62,1979
Jessica Wilkerson,['Lebanon'],Teacher,1904,38,48,1942
Lindsey Davis,"['Somalia', 'Botswana']",Military personnel,1922,24,23,1946
April Shelton,"['Jersey', 'Albania']",Politician,1877,25,2,1902
Heidi Gonzalez,"['Thailand', 'Netherlands Antilles']",Artist,1898,9,74,1907
Heather Gordon,['Afghanistan'],Athlete,1886,44,76,1930
Ryan Baker,"['Serbia', 'Jamaica']",Criminal,1874,77,17,1951
Charles Watkins,"['Tanzania', 'Ecuador']",Athlete,1901,82,2,1983
Stephen Tucker,"['Honduras', 'Jersey']",Artist,1874,21,0,1895
Brandon Adams,['Niger'],Artist,1910,89,77,1999
Timothy Warren,['Iceland'],Artist,1879,44,14,1923
Crystal Manning,['French Southern Territories'],Politician,1917,35,50,1952
Kevin Morris,"['Cocos (Keeling) Islands', 'Montenegro']",Athlete,1887,78,40,1965
Megan Morris,['Oman'],Artist,1895,5,27,1900
Christopher Williams,"['Netherlands Antilles', 'Marshall Islands']",Artist,1910,85,60,1995
Michael Nguyen,"['Egypt', 'Northern Mariana Islands']",Politician,1892,0,86,1892
Dana Cline,['Cocos (Keeling) Islands'],Artist,1880,55,47,1935
Jose Payne,"['Timor-Leste', 'Mauritania']",Politician,1897,46,69,1943
Jonathan Hamilton,"['Barbados', 'Sao Tome and Principe']",Pianist,1873,4,38,1877
Kristen Knapp,['Andorra'],Researcher,1905,11,42,1916
Michael Coleman,['Brunei Darussalam'],Artist,1876,28,21,1904
Angela Carson,"['Saint Barthelemy', 'Egypt']",Artist,1916,33,34,1949
Shirley Miller,['Armenia'],Artist,1921,71,21,1992
Samantha Wilson,"['Christmas Island', 'Sierra Leone']",Military personnel,1884,27,4,1911
Mark Taylor,"['Canada', 'Faroe Islands']",Playwright; author; dramaturge,1877,30,79,1907
Leslie Rogers,['Ireland'],Artist,1921,32,86,1953
Cheyenne Zavala,['United States Minor Outlying Islands'],Artist,1912,82,18,1994
Christopher Diaz,"['Angola', 'Norfolk Island']",Researcher,1910,74,6,1984
Daniel Mason,['Cocos (Keeling) Islands'],Artist,1885,84,65,1969
Rebecca Stokes,"['Falkland Islands (Malvinas)', 'Belarus']",Researcher,1891,75,19,1966
Monica Erickson,"['Korea', 'Mayotte']",Athlete,1871,53,15,1924
Kelly Lee,['Egypt'],Artist,1874,66,65,1940
Kelly Nielsen,['Norway'],Artist,1875,86,4,1961
Kimberly Coleman,['New Zealand'],Artist,1892,11,42,1903
Craig Harris,"['Egypt', 'Fiji']",Racing automobile driver; formula one driver,1899,78,74,1977
Kimberly Aguilar,"['Guatemala', 'Panama']",Mechanic,1891,59,27,1950
Yolanda Dennis,"['Sao Tome and Principe', 'Lebanon']",Politician,1915,59,22,1974
Savannah Ayala,['Bangladesh'],Kayaker,1904,88,18,1992
Travis Fernandez PhD,['Albania'],Athlete,1880,50,38,1930
Geoffrey Shaw,['Greenland'],Artist,1906,67,84,1973
Donald Calderon,"['Senegal', 'Guinea-Bissau']",Artist,1907,27,5,1934
Mr. Charles Lindsey,['El Salvador'],Artist,1883,76,7,1959
Karen White,['Ecuador'],Politician,1872,30,26,1902
Antonio Rich,['Angola'],Artist,1918,75,41,1993
Jeffrey Strickland,"['Panama', 'Ghana']",Researcher,1902,30,67,1932
Stacey Tucker,"['Singapore', 'Bangladesh']",Politician,1898,79,51,1977
Joel Smith,['San Marino'],Researcher,1921,36,34,1957
Michael Paul,"['Heard Island and McDonald Islands', 'Reunion']",Artist,1907,46,68,1953
Morgan Williams,"['Lesotho', 'Mongolia']",Athlete,1882,8,69,1890
Angela Howard,"['Gibraltar', 'British Indian Ocean Territory (Chagos Archipelago)']",Artist,1870,72,18,1942
Clayton Morris,"['New Caledonia', 'Burundi']",Artist,1884,32,74,1916
Megan Gray,"['Norfolk Island', 'Eritrea']",Artist,1915,75,10,1990
Julia Scott,['Timor-Leste'],Artist,1880,87,33,1967
Christopher Harris,['Cyprus'],Disc jockey,1888,30,33,1918
Lauren Stevens,['Isle of Man'],Artist,1914,83,0,1997
Rebekah Carpenter,"['Tonga', 'Rwanda']",Athlete,1891,11,55,1902
Jason Wolfe,"['Jordan', 'Niue']",Serial killer,1889,16,6,1905
Lindsay Benson,['Haiti'],Military personnel,1920,21,31,1941
Barbara Simpson,['Egypt'],Artist,1923,62,84,1985
Jennifer Smith,"['Luxembourg', 'Slovenia']",Artist,1871,18,9,1889
Shane Mayer,"['Iraq', 'Sweden']",Artist,1897,8,84,1905
James Russo,"['Ecuador', 'Hungary']",Mobster,1906,12,79,1918
Susan Bradley,"['Malawi', 'Vanuatu']",Athlete,1881,33,1,1914
Katherine Lewis DDS,"['China', 'Svalbard & Jan Mayen Islands']",Aristocrat,1883,44,63,1927
Jeff Molina,"['Rwanda', 'Palau']",Artist,1879,0,49,1879
Candice Lindsey,['Moldova'],Artist,1874,37,71,1911
Hayley Newman,"['Guernsey', 'Tanzania']",Artist,1905,51,17,1956
Tyler Crawford,"['Azerbaijan', 'Japan']",Researcher,1911,50,37,1961
Richard Davis,"['Iceland', 'Norway']",Artist,1892,49,23,1941
Danielle Hendricks,"['Christmas Island', 'New Caledonia']",Athlete,1924,56,28,1980
Deborah Walton,['Senegal'],Artist,1904,30,51,1934
Micheal Miller,"['Cuba', 'Barbados']",Politician,1915,69,46,1984
Mark Wu,['Cayman Islands'],Artist,1888,15,59,1903
Charles Hill,['Saint Martin'],Politician,1923,10,31,1933
Stephen Kennedy,['Afghanistan'],Politician,1885,40,37,1925
Donald Gonzalez,"['Eritrea', 'United States of America']",Artist,1874,86,32,1960
Richard Hayes,['Saudi Arabia'],Cross-country skier,1904,60,24,1964
Wendy Cobb,['Saudi Arabia'],Athlete,1880,39,71,1919
John Ramirez,['Tanzania'],Artist,1912,42,73,1954
Kelly Chapman,['Argentina'],Artist,1912,10,65,1922
Caitlin Ochoa,['Slovenia'],Politician,1910,29,82,1939
Holly Garner,"['New Caledonia', 'Liechtenstein']",Artist,1921,33,36,1954
David Valencia,"['Montenegro', 'Israel']",Politician,1896,72,59,1968
Jonathan Henry,['Iran'],Politician,1879,44,89,1923
Sarah Taylor,"['Belize', 'Samoa']",Resistance fighter; trade unionist,1887,85,44,1972
Ricky Rivera,"['Bolivia', 'Turkey']",Heilpraktiker,1911,88,56,1999
Timothy Chase,['Sierra Leone'],Artist,1891,70,31,1961
Brian Becker,"['French Southern Territories', 'Iraq']",Military personnel,1889,42,8,1931
David Allen,"['Israel', 'Libyan Arab Jamahiriya']",Politician,1897,37,63,1934
Ernest Williams,"['Paraguay', 'British Virgin Islands']",Artist,1900,77,67,1977
Wendy Lynch,['Turkmenistan'],Artist,1903,1,65,1904
Laura Munoz,"['Guinea-Bissau', 'Aruba']",Artist,1903,81,60,1984
Patricia Adams,['Iceland'],Researcher,1897,85,36,1982
Christopher Lowe,"['Israel', 'Mauritania']",Artist,1902,22,55,1924
Angela Watson,['Isle of Man'],Military personnel,1897,58,3,1955
Jason Mclean,['Australia'],Artist,1909,14,19,1923
Tonya Bradshaw,['France'],Artist,1920,7,43,1927
Jeremy Roy,['Cape Verde'],Politician,1889,43,33,1932
Robert Mitchell,['Syrian Arab Republic'],Artist,1917,69,21,1986
Sarah Hall,['Solomon Islands'],Trade unionist,1920,25,28,1945
Diane Church,['Qatar'],Politician,1921,14,70,1935
Timothy Williams,['Congo'],Researcher,1907,71,22,1978
Andrew Mayo,['United Kingdom'],Artist,1902,69,24,1971
Jennifer Ward,['Netherlands'],Housekeeper,1908,45,77,1953
Nicole Chen,"['Christmas Island', 'Eritrea']",Artist,1874,71,55,1945
Kimberly Myers,['North Macedonia'],Artist,1912,86,23,1998
Brandon Love,"['Senegal', 'United States of America']",Artist,1891,37,56,1928
Christopher Lopez,['Solomon Islands'],Researcher,1882,7,6,1889
Emily Rocha,['Malawi'],Serial killer,1876,37,46,1913
Ethan Cox,"['Gibraltar', 'Chad']",Artist,1891,80,57,1971
Jeffrey James,['South Africa'],Ballet dancer; choreographer; ballerina,1915,56,29,1971
Briana Berry,"['South Georgia and the South Sandwich Islands', 'Belize']",Politician,1909,52,58,1961
Beverly Carter,['Holy See (Vatican City State)'],Politician,1918,70,61,1988
Dennis Cox,"['Mongolia', 'Bosnia and Herzegovina']",Military personnel,1913,22,52,1935
Kerry Guerra,"['Taiwan', 'Zimbabwe']",Military personnel,1878,84,54,1962
Christopher Carter,"['Cameroon', 'San Marino']",Athlete,1891,61,75,1952
Samantha Hendrix,"['Iraq', 'Turkey']",Researcher,1902,63,58,1965
Chad Newman,"['Turkmenistan', 'Martinique']",Military personnel,1906,3,79,1909
Elizabeth Rodriguez,"['American Samoa', 'Sweden']",Engineer,1905,71,5,1976
Caroline Moore,['Nicaragua'],Athlete,1881,88,75,1969
Brittany Morris,"[""Lao People's Democratic Republic"", 'Mexico']",Artist,1897,86,62,1983
Nancy Perez,['Czech Republic'],Politician,1908,87,80,1995
Haley Gross,"['Guam', 'Japan']",Artist,1910,2,16,1912
Christopher Marshall,"['Israel', 'Montserrat']",Artist,1906,29,69,1935
Erin Miller,['Saint Barthelemy'],Military personnel,1895,40,53,1935
John Hampton,['Bulgaria'],Artist,1919,86,27,2005
Dustin Murray,"['Rwanda', 'Greece']",Artist,1910,26,26,1936
Angela Perry,['Uzbekistan'],Researcher,1915,78,34,1993
Ricardo Miller,['Palestinian Territory'],Artist,1900,4,82,1904
Phillip King MD,"['Israel', 'Paraguay']",Amateur wrestler,1912,4,18,1916
Heidi Davis,"['Turkmenistan', 'Mayotte']",Artist,1877,57,61,1934
Samantha Mccarthy,"['Turkey', 'Armenia']",Researcher,1897,3,89,1900
Vincent Moran,"['Zimbabwe', 'Netherlands Antilles']",Politician,1884,19,66,1903
Casey Pineda,"[""Cote d'Ivoire""]",Military personnel,1878,80,37,1958
Scott Peck,['Belize'],Artist,1891,88,64,1979
Anthony Velez,['Serbia'],Artist,1902,53,35,1955
Anthony King,"['Poland', 'Sudan']",Artist,1898,62,1,1960
Cameron Murray,['Dominica'],Artist,1888,63,63,1951
Angela Brown,['Anguilla'],Religious figure,1892,79,87,1971
Zachary Lee,['Kenya'],Religious figure,1875,49,55,1924
Alison Reyes,['Greenland'],Artist,1910,4,27,1914
Alexandra Marquez,['Lithuania'],Artist,1904,22,80,1926
Michelle Villarreal,['Sierra Leone'],Nun,1923,52,31,1975
Leonard Williams,"['Wallis and Futuna', 'Holy See (Vatican City State)']",Artist,1893,27,35,1920
Lisa Oconnell,"['Finland', 'Bangladesh']",Politician,1900,70,1,1970
Christopher Gonzales,"['Venezuela', 'Sudan']",Military personnel,1914,39,42,1953
Nicole Porter,['Romania'],Artist,1911,86,22,1997
Troy Lopez,['Lesotho'],Artist,1876,48,39,1924
David Henson,['Kazakhstan'],Aristocrat,1873,21,5,1894
Shelley Medina,"['Bahrain', 'South Georgia and the South Sandwich Islands']",Politician,1884,66,17,1950
Heather Thompson,['Myanmar'],Artist,1922,61,60,1983
Karen Romero,['El Salvador'],Politician,1918,44,45,1962
Ebony Shepard,"['Denmark', 'Panama']",Athlete,1897,53,59,1950
Maurice Mitchell,['British Indian Ocean Territory (Chagos Archipelago)'],Artist,1911,35,77,1946
Kristen Sanford,"['France', 'San Marino']",Artist,1881,15,89,1896
Adrian Solomon,"['Turkmenistan', 'Jamaica']",Artist,1906,66,23,1972
Christina Koch,"['Italy', 'Sweden']",Artist,1908,55,85,1963
Alexis Kennedy,"['Spain', 'Norfolk Island']",Witness,1874,40,36,1914
Kevin Carroll,"['Malawi', 'South Georgia and the South Sandwich Islands']",Artist,1892,3,25,1895
John Christian,['Micronesia'],Artist,1881,51,21,1932
Laura Conner,"['Lebanon', 'Spain']",Athlete,1905,41,48,1946
Ashley Calderon,['Portugal'],Architect,1913,46,43,1959
Adriana Davis,"[""Cote d'Ivoire"", 'Poland']",Politician,1907,83,38,1990
Cameron Kelley,['Bhutan'],Artist,1917,39,39,1956
Carmen Rodriguez,['Tuvalu'],Politician,1909,75,73,1984
Melissa Smith,"['Turkey', 'South Georgia and the South Sandwich Islands']",Military personnel,1892,76,45,1968
Alex Mitchell,['Northern Mariana Islands'],Artist,1922,65,80,1987
Amanda Park,['Lesotho'],Researcher,1900,60,67,1960
Cameron Rodriguez,"['Zambia', 'Rwanda']",Costume designer; fashion designer; designer,1901,33,71,1934
Aaron Wilson,['Poland'],Politician,1884,47,5,1931
Kelly Thompson,['Cape Verde'],Student,1911,17,48,1928
Tina Cannon,"['Eritrea', 'Burkina Faso']",Researcher,1878,66,20,1944
Adam Barnes,"[""Lao People's Democratic Republic"", 'Myanmar']",Teacher,1902,37,47,1939
Melissa Pierce,"['Reunion', 'Switzerland']",Artist,1914,63,4,1977
Robin Mack,['Lebanon'],Cowboy,1886,17,74,1903
Kyle Cobb,['Kuwait'],Artist,1887,77,33,1964
Heather Wolfe,['Niger'],Artist,1876,52,89,1928
Lisa White,['Kenya'],Researcher,1908,19,8,1927
James Patterson,"['Slovenia', 'Philippines']",Artist,1905,87,63,1992
Michael Johnston,['Madagascar'],Guitarist,1871,79,21,1950
Randall Park,['Bahrain'],Politician,1883,27,70,1910
Jacqueline Cox,"['Guinea', 'South Georgia and the South Sandwich Islands']",Politician,1903,4,74,1907
Jose Brown,['Namibia'],Artist,1875,14,47,1889
Melanie Rivera,['Korea'],Politician,1882,22,68,1904
Vanessa Wells,"['Turkey', 'Bangladesh']",Researcher,1894,36,86,1930
Brian Meyer,['Solomon Islands'],Researcher,1902,63,89,1965
Meredith Valdez,"['Dominican Republic', 'Croatia']",Politician,1890,29,68,1919
Rachel Marsh,"['Solomon Islands', 'Nauru']",Artist,1923,58,65,1981
Caitlin Miranda,['Palestinian Territory'],Artist,1906,49,15,1955
Matthew Snyder,"['Mayotte', 'Cyprus']",Artist,1892,32,16,1924
Claudia Evans,"['Zambia', 'Sudan']",Researcher,1924,34,33,1958
Paula Houston,"['Djibouti', 'Norfolk Island']",Artist,1873,50,83,1923
Rhonda Navarro,['El Salvador'],Artist,1878,82,10,1960
Sarah Summers,['Benin'],Religious figure,1911,5,5,1916
Alan Taylor,['Gibraltar'],Artist,1904,14,32,1918
Cindy Rogers,"['Ukraine', 'Myanmar']",Artist,1901,60,48,1961
Mark Thompson,['Korea'],Serial killer,1921,44,73,1965
Ronald Gutierrez,['Tanzania'],Religious figure,1883,55,67,1938
Tammy Hopkins,['Reunion'],Teacher,1912,5,13,1917
Chelsea Cole,['Ghana'],Collector,1893,18,53,1911
Amy Hall,"['Kazakhstan', 'Maldives']",Professional wrestler,1905,42,33,1947
Tammy Lee,['Kyrgyz Republic'],Military personnel,1902,63,67,1965
Jacob Crawford,['Belize'],Artist,1907,10,4,1917
Jennifer Dawson,['Saint Lucia'],Military personnel,1909,23,26,1932
Michael Rodriguez,['Denmark'],Politician,1910,68,72,1978
Jeffrey Anderson,"['Rwanda', 'Faroe Islands']",Artist,1915,59,79,1974
Robert Parker,"['Jamaica', 'Guernsey']",Politician,1923,56,22,1979
Zachary Ayala,"['Sri Lanka', 'Mali']",Athlete,1896,4,35,1900
Christopher Powell,"['Canada', 'Poland']",Athlete,1898,29,66,1927
Sarah Wright PhD,['British Virgin Islands'],Artist,1910,37,85,1947
Dale Thomas,['Moldova'],Politician,1907,89,68,1996
Joseph Cochran,['Fiji'],Artist,1891,23,47,1914
Molly Santana,"['South Georgia and the South Sandwich Islands', 'Fiji']",Politician,1911,58,71,1969
Jason Wright,"['Vietnam', 'Solomon Islands']",Researcher,1872,23,85,1895
Jeff Farley,"['Syrian Arab Republic', 'Austria']",Artist,1911,4,15,1915
Mary Fisher,['Saint Martin'],Politician,1885,46,14,1931
Erica Thompson,"['Jersey', 'Ukraine']",Artist,1914,60,44,1974
Crystal Fowler,"['Ghana', 'Faroe Islands']",Researcher,1872,19,60,1891
Jeff Myers,['Libyan Arab Jamahiriya'],Artist,1871,35,84,1906
Dalton Roberts,['Panama'],Artist,1917,59,84,1976
Jon Vasquez,"['Moldova', 'Bhutan']",Artist,1878,74,8,1952
Brian Owen,['Malta'],Artist,1907,70,40,1977
Mrs. Natalie Castillo,['Sweden'],Artist,1904,80,84,1984
Cindy Baxter,['Madagascar'],Artist,1918,8,35,1926
Melissa Johnson,['Israel'],Artist,1922,10,65,1932
Daniel Sullivan,['Djibouti'],Student; resistance fighter,1884,38,22,1922
Sally Glenn,['Netherlands Antilles'],Artist,1885,72,24,1957
Nicole Richmond,['Tajikistan'],Politician,1886,23,25,1909
David Peters,['Kuwait'],Artist,1893,27,8,1920
Christine Wright,['Uganda'],Artist,1874,30,78,1904
Bryan Lee,"['Russian Federation', 'United States of America']",Athlete,1875,86,68,1961
Mark Spencer,"['Tuvalu', 'Japan']",Athlete,1920,46,5,1966
Cory Houston,"['United States of America', 'Guyana']",Teacher,1921,37,29,1958
John Howard,['Cocos (Keeling) Islands'],Politician,1895,50,58,1945
John Russo,['Vietnam'],Engineer,1883,67,45,1950
Kathryn Garcia,"['Bolivia', 'Malaysia']",Religious figure,1900,23,56,1923
Patricia Sexton,['Cook Islands'],Artist,1878,15,15,1893
Raymond Myers,['Benin'],Military personnel,1908,88,49,1996
Karen Murray,"['Belize', 'Falkland Islands (Malvinas)']",Artist,1885,73,40,1958
Karen Hampton,['Albania'],Military personnel,1870,67,24,1937
Michael Freeman,"['Puerto Rico', 'Vanuatu']",Terrorist,1882,18,3,1900
Jacob Allen,"['Nauru', 'Samoa']",Politician,1877,77,16,1954
Becky Klein,"['North Macedonia', 'Iran']",Artist,1879,85,41,1964
Steven Blackburn,['Brunei Darussalam'],Researcher,1904,26,32,1930
Brian Williamson,['Italy'],Entrepreneur,1900,73,70,1973
Mrs. Donna Koch,['Luxembourg'],Athlete,1870,83,35,1953
Peter Hartman,"['Israel', 'Albania']",Military personnel,1875,59,46,1934
Chelsea Vasquez,['Central African Republic'],Artist,1890,85,39,1975
Lindsay Parker,['Maldives'],Costume designer; fashion designer; designer,1876,84,59,1960
Katherine Harris,"['Israel', 'Namibia']",Artist,1887,33,24,1920
Jonathan Holland,"['Turkey', 'Jersey']",Artist,1884,55,38,1939
Anthony Nguyen,"['Spain', 'Montserrat']",Military personnel,1912,79,72,1991
William Rosario,"['Montenegro', 'Angola']",Manager; playboy playmate; radio personality; model; professional wrestler; beauty pageant contestant,1892,8,62,1900
Nicole Snyder,"['Antarctica (the territory South of 60 deg S)', 'Sweden']",Artist,1917,70,79,1987
David Stewart,"['Nicaragua', 'Benin']",Artist,1920,51,20,1971
Anna Frazier,['Panama'],Researcher,1888,31,49,1919
Brandon Sellers,"['Holy See (Vatican City State)', 'Portugal']",Cinematographer,1907,55,42,1962
Barbara Gonzales,['China'],Privateer,1909,28,42,1937
Matthew Allen,['South Georgia and the South Sandwich Islands'],Politician,1910,60,1,1970
Ashlee Garcia,['Turkey'],Artist,1912,21,39,1933
Charles Serrano,"['Aruba', 'Mayotte']",Engineer,1919,22,33,1941
Jessica Yu,['Equatorial Guinea'],Artist,1888,72,3,1960
Joshua Day,"['Armenia', 'Norway']",Researcher,1922,59,31,1981
Susan Simpson,['Bangladesh'],Researcher,1899,17,84,1916
Katherine Phillips,['Argentina'],Artist,1875,14,13,1889
Joseph Roberts,['Sudan'],Cartography,1901,24,49,1925
Heidi Diaz,['Venezuela'],Artist,1882,17,14,1899
Steven Miller,"['Aruba', 'Bolivia']",Artist,1914,68,70,1982
Jason Brooks,['India'],Religious figure,1877,35,8,1912
Teresa Acosta,['New Zealand'],Artist,1891,74,47,1965
Carolyn Gonzalez,['Cambodia'],Competitive diver,1878,39,57,1917
Janice Taylor,['Macao'],Artist,1923,53,51,1976
Chris Thomas,['Moldova'],Politician,1905,29,34,1934
David Randall,['Zambia'],Artist,1911,29,58,1940
Carolyn Harvey,['Palau'],Artist,1912,37,62,1949
Joanne Hardin,['Italy'],Politician,1903,41,65,1944
Deborah Gardner,"['Tuvalu', 'Pitcairn Islands']",Athlete,1879,4,62,1883
Erik Thomas,['Maldives'],Artist,1915,67,80,1982
Joel Hernandez,"['Estonia', 'Libyan Arab Jamahiriya']",Artist,1870,60,12,1930
Shawn Grimes,"['Qatar', 'Papua New Guinea']",Artist,1917,19,61,1936
Karen Bolton,"['Montserrat', 'Romania']",Artist,1891,17,54,1908
Patrick Edwards,['Cameroon'],Religious figure,1881,56,21,1937
Jennifer Mcguire,"['Syrian Arab Republic', 'Monaco']",Researcher,1878,34,59,1912
Daniel Wright,"['Chile', 'Taiwan']",Artist,1903,69,21,1972
Mrs. Jenna Barry,['Andorra'],Costume designer; fashion designer; designer,1915,34,29,1949
Catherine Fleming,['Tajikistan'],Artist,1893,21,46,1914
Jessica Phillips,"['Cocos (Keeling) Islands', 'Burkina Faso']",Artist,1872,1,77,1873
Randy Bishop,"['Sierra Leone', 'Lithuania']",Athlete,1913,1,6,1914
Angela Kane,['Uruguay'],Athlete,1905,30,70,1935
Mrs. Michelle Clark,"['Haiti', 'Pakistan']",Artist,1874,7,7,1881
Brianna Johnson,"['Bahrain', 'Argentina']",Politician,1877,48,6,1925
Joshua Moore,['India'],Artist,1904,58,2,1962
Melissa Hickman,"['Palau', 'Ethiopia']",Artist,1896,73,28,1969
Katherine Hanson,"['Pakistan', 'Timor-Leste']",Artist,1922,21,17,1943
Julia Aguirre,"['Tajikistan', 'Mongolia']",Athlete,1906,24,30,1930
Justin Davis,['United Arab Emirates'],Costume designer; fashion designer,1924,29,56,1953
William Hanson,['Portugal'],Artist,1890,54,0,1944
Miranda Wilkerson,"['Turks and Caicos Islands', 'Tanzania']",Artist,1871,25,17,1896
Loretta Cohen,"['French Guiana', 'Niue']",Politician,1879,77,68,1956
Andrew Allen,"['Chile', 'Reunion']",Military personnel,1912,71,77,1983
Jessica Flynn,['Iran'],Artist,1897,8,69,1905
Steve Ramos,"['French Southern Territories', 'Barbados']",Researcher,1879,81,35,1960
Michelle Mcneil,['Myanmar'],Artist,1919,5,36,1924
Kimberly Coffey,"['Faroe Islands', 'Antarctica (the territory South of 60 deg S)']",Artist,1912,31,24,1943
Thomas Mendoza,"['Moldova', 'Ghana']",Researcher,1890,56,66,1946
Jack Smith,"['Paraguay', 'Pakistan']",Researcher,1901,78,89,1979
Patrick Burns,['Chad'],Researcher,1904,40,29,1944
Patricia Boyer,['Timor-Leste'],Artist,1898,22,89,1920
Joseph Wolf,['Poland'],Lawyer,1890,76,70,1966
Karen Robinson,"['Samoa', 'Swaziland']",Politician,1893,16,4,1909
Angel Phillips,['Nauru'],Artist,1910,63,34,1973
Julian Romero,"['Guernsey', 'Somalia']",Artist,1895,21,80,1916
Jesse Williams,['Saint Lucia'],Artist,1882,53,0,1935
Kim Flowers MD,"['Vanuatu', 'Netherlands Antilles']",Artist,1877,42,34,1919
Kayla Guerra,"['Bangladesh', 'United States of America']",Researcher,1911,85,77,1996
Amy Harding,['Saint Pierre and Miquelon'],Artist,1918,66,86,1984
Eric Johnson,"['Morocco', 'Cuba']",Artist,1894,25,73,1919
Dean Sherman,['Jersey'],Artist,1870,34,71,1904
Richard Burton,"['British Indian Ocean Territory (Chagos Archipelago)', 'Syrian Arab Republic']",Politician,1886,13,30,1899
Darren Howell,"['Algeria', 'Australia']",Fighter pilot,1871,7,64,1878
Tammy Smith,"['Bermuda', 'Bosnia and Herzegovina']",Politician,1883,1,63,1884
Shannon Gutierrez,['Argentina'],Artist,1914,83,47,1997
Matthew Wilson,['Cape Verde'],Explorer,1913,17,10,1930
Connie Douglas,"['Korea', 'Malawi']",Artist,1918,52,14,1970
Nicole Burns,['Syrian Arab Republic'],Artist,1923,84,46,2007
Christopher Peterson,['Philippines'],Politician,1905,27,67,1932
Jennifer Anderson,['Sierra Leone'],Amateur wrestler,1889,88,89,1977
Jacob Nichols,['Vietnam'],Politician,1872,43,64,1915
Mark Leblanc,['Azerbaijan'],Artist,1880,63,7,1943
Mr. Brian Hill IV,"['Mauritius', 'Congo']",Politician,1909,21,74,1930
Jason Shepherd,['Croatia'],Artist,1896,73,45,1969
William Stewart,['Myanmar'],Researcher,1921,70,54,1991
Carrie Lopez,['Guernsey'],Artist,1922,56,31,1978
Laura Snyder,"['United States of America', 'New Caledonia']",Politician,1911,63,44,1974
Thomas Benjamin,"['French Southern Territories', 'Saint Lucia']",Artist,1886,43,75,1929
Patricia Myers,"['Kenya', 'Iraq']",Aristocrat,1910,67,73,1977
Michelle Fernandez,"['South Georgia and the South Sandwich Islands', 'Marshall Islands']",Teacher,1907,10,54,1917
Jeffrey Rodriguez,['Nicaragua'],Revolutionary,1877,8,19,1885
James Carson,"['El Salvador', 'Paraguay']",Artist,1909,63,24,1972
Wesley Hampton,['Guinea-Bissau'],Journalist,1919,77,15,1996
Charles Williams,"['Montserrat', 'Georgia']",Artist,1914,72,39,1986
Sarah Wilson,"['Saint Pierre and Miquelon', 'Montserrat']",Athlete,1911,21,51,1932
Tyrone Mcgee,['Senegal'],Politician,1897,50,29,1947
Andrew Schneider,['Libyan Arab Jamahiriya'],Politician,1870,22,81,1892
Adam Smith,['Suriname'],Journalist,1913,15,34,1928
Nicole Thomas,"['Libyan Arab Jamahiriya', 'Mexico']",Politician,1886,57,52,1943
Ryan Hawkins,"['Western Sahara', 'Cook Islands']",Model,1904,57,74,1961
Rebecca Stewart MD,['Slovakia (Slovak Republic)'],Politician,1888,76,78,1964
Catherine Leach,"['Qatar', 'Indonesia']",Politician,1899,33,63,1932
Benjamin Johnson,['Myanmar'],Architect,1906,17,16,1923
Stephanie Sosa,['Saint Barthelemy'],Researcher,1886,39,72,1925
Brenda White,"['Tajikistan', 'Hong Kong']",Athlete,1880,66,69,1946
Christopher Huynh,"['Morocco', 'Angola']",Politician,1888,67,53,1955
Kenneth Owens,['Monaco'],Artist,1878,72,63,1950
Destiny Sanders,"['Reunion', 'Belarus']",Artist,1907,75,25,1982
Michael Hall,['India'],Artist,1906,2,0,1908
Cody Gomez,['Liechtenstein'],Military personnel,1886,18,32,1904
Michael Huff,['Puerto Rico'],Artist,1901,88,82,1989
Norma Wilson,"['Aruba', 'Switzerland']",Politician,1901,86,27,1987
Justin Clark,"['Greenland', 'Austria']",Politician,1892,37,61,1929
Bill Christensen,"['Malta', ""Cote d'Ivoire""]",Artist,1887,71,66,1958
Justin Ramirez MD,['Guadeloupe'],Artist,1871,64,42,1935
Greg Vasquez,['Kazakhstan'],Athlete,1878,54,26,1932
Jennifer Holder,['Samoa'],Artist,1900,17,61,1917
Kathryn Simpson,"['Saint Vincent and the Grenadines', 'Swaziland']",Researcher,1871,25,4,1896
Dorothy Mason,"['Mauritania', 'Svalbard & Jan Mayen Islands']",Political activist,1870,52,4,1922
Brian Dawson,['Algeria'],Athlete,1919,27,30,1946
Mr. Adam Brennan MD,['Djibouti'],Military personnel,1894,4,55,1898
Joshua Ortega,"['Ethiopia', 'Saint Pierre and Miquelon']",Aristocrat,1900,31,62,1931
Alexis Nguyen,['Denmark'],Artist,1905,60,32,1965
Joe Myers,"['Morocco', 'Mauritius']",Religious figure,1893,84,17,1977
Christina Cooper,"['Guyana', 'Suriname']",Researcher,1903,32,33,1935
Alyssa Mcdonald,['French Polynesia'],Teacher,1888,80,72,1968
Pamela Vargas,"['Cocos (Keeling) Islands', 'Bhutan']",Artist,1907,24,38,1931
Cameron Mcmillan,"['Gibraltar', 'Kenya']",Politician,1914,16,16,1930
Tamara Williams,"['Grenada', 'South Georgia and the South Sandwich Islands']",Artist,1889,10,73,1899
Maureen Reed,['Haiti'],Artist,1878,15,12,1893
Melanie Compton,"['Tokelau', 'Iraq']",Waiter,1872,57,71,1929
Jason Tran,"['French Polynesia', 'Norfolk Island']",Pianist,1885,52,11,1937
Gary Bishop,"['Saint Martin', 'Peru']",Artist,1888,2,24,1890
James Walters,"['Heard Island and McDonald Islands', 'Sweden']",Artist,1872,41,58,1913
Courtney Hardy,"['Andorra', 'Micronesia']",Athlete,1891,18,46,1909
Deborah Barron,"['Mayotte', 'Japan']",Researcher,1911,55,32,1966
Wesley Stewart,"['Ethiopia', 'Mongolia']",Researcher,1917,84,5,2001
David Thompson,"['Western Sahara', 'Honduras']",Researcher,1907,19,75,1926
Thomas Graves,"['Myanmar', 'Wallis and Futuna']",Researcher,1900,80,36,1980
Stephanie Christensen,"['Central African Republic', 'Kenya']",Artist,1904,74,87,1978
Alan Jackson,['United States Virgin Islands'],Artist,1887,56,56,1943
Thomas Stein,['Togo'],Politician,1898,33,81,1931
Ryan Coleman,['Andorra'],Entrepreneur,1893,63,7,1956
Sabrina Fisher,['Ireland'],Artist,1899,36,45,1935
Thomas Cochran,['Dominican Republic'],Athlete,1909,74,23,1983
Lisa Reyes,['Cuba'],Strongman; bodybuilder; powerlifter,1888,69,10,1957
James Cordova,['Montserrat'],Artist,1914,30,5,1944
Lisa Mckinney,"['Qatar', 'Afghanistan']",Entrepreneur,1881,48,43,1929
Hunter Hernandez,"['Moldova', 'Poland']",Teacher,1885,22,37,1907
Linda Smith,"['Mozambique', 'Ethiopia']",Politician,1907,89,76,1996
Cynthia Lynch,"['Belgium', 'Turks and Caicos Islands']",Artist,1914,18,17,1932
Jeremy Davis,['Benin'],Military personnel,1870,63,66,1933
Kristen Dyer,['Argentina'],Artist,1878,64,24,1942
Ann Hansen,"['Northern Mariana Islands', 'Sri Lanka']",Artist,1870,28,53,1898
Luke Jones,"['Norfolk Island', 'North Macedonia']",Athlete,1871,79,18,1950
Lisa Barker,['Cambodia'],Politician,1918,59,16,1977
Erin Scott,"['Montserrat', 'Saint Martin']",Artist,1916,30,78,1946
Brittany Miller,['Kiribati'],Politician,1912,13,21,1925
Lisa Chambers,['Puerto Rico'],Artist,1877,51,65,1928
Anthony Moyer,['Mexico'],Engineer,1894,85,52,1979
Adam Robinson,['United Arab Emirates'],Artist,1870,21,89,1891
Candace Martin,"['Monaco', 'Korea']",Athlete,1915,44,72,1959
Matthew Crawford,['Mozambique'],Secretary,1924,60,82,1984
Karen Strickland,"['Japan', 'Saint Kitts and Nevis']",Artist,1919,68,53,1987
Kelly Nash,"['Dominican Republic', 'Georgia']",Artist,1881,76,32,1957
Ryan Johns,['Liechtenstein'],Researcher,1905,47,87,1952
William Lynch,"['Czech Republic', 'Bolivia']",Politician,1912,76,66,1988
Shannon Fuller,"['Nigeria', 'Djibouti']",Canoeist; kayaker,1913,10,13,1923
Tiffany Smith,['Libyan Arab Jamahiriya'],Athlete,1893,25,41,1918
Heather Flowers,"['Maldives', 'Kyrgyz Republic']",Politician,1921,89,34,2010
Julie Hawkins,['Nicaragua'],Artist,1878,52,23,1930
Anthony Gutierrez,['New Caledonia'],Athlete,1896,19,3,1915
Brandon Alvarado DDS,['Philippines'],Artist,1895,86,43,1981
Michael Ward,['Honduras'],Artist,1900,12,60,1912
Maria Pope,"['Djibouti', 'Burkina Faso']",Artist,1906,54,38,1960
Kathryn Smith,['Cook Islands'],Astronomer,1914,41,10,1955
Michele Perez,['United States of America'],Artist,1902,42,18,1944
Steven Jimenez,['Kenya'],Artist,1890,46,48,1936
Maurice Anderson,"['Samoa', 'Kuwait']",Teacher,1871,81,0,1952
Rose Gray,"['Botswana', 'Bulgaria']",Artist,1880,44,66,1924
Daniel Williamson,['Nauru'],Artist,1892,51,86,1943
Vanessa Thompson,"['Micronesia', 'Italy']",Racing automobile driver,1880,52,71,1932
Diane Patterson,['Hungary'],Politician,1918,45,22,1963
Amy Lane,"['Malaysia', 'Eritrea']",Artist,1906,86,6,1992
Dennis Hunter,"['Iceland', 'Spain']",Artist,1909,19,42,1928
Richard Avery,['French Guiana'],Artist,1908,44,11,1952
Tammy Burke,['Moldova'],Researcher,1911,15,62,1926
Erica Norris,['Iceland'],Artist,1903,45,33,1948
Sandra Johnson,"['Palau', 'Cocos (Keeling) Islands']",Researcher,1901,61,5,1962
Courtney Brewer,"['India', 'Brunei Darussalam']",Artist,1870,23,87,1893
Emily Roberts,"['Cyprus', 'Brunei Darussalam']",Artist,1877,6,5,1883
Suzanne Jones,"['Somalia', 'Svalbard & Jan Mayen Islands']",Entrepreneur,1922,1,82,1923
Carol Rowland,"['Comoros', 'Ethiopia']",Politician,1907,52,24,1959
Linda Thomas,['South Georgia and the South Sandwich Islands'],Artist,1875,11,87,1886
Mr. Patrick Rogers,['Senegal'],Artist,1895,29,7,1924
William Patrick,['United Kingdom'],Politician,1897,2,30,1899
Alexander Gonzalez,"['Belgium', 'Brazil']",Artist,1923,44,74,1967
Stephen Wells,['United States Minor Outlying Islands'],Politician,1873,12,48,1885
Joseph Weber,['Norway'],Artist,1894,82,17,1976
David Green,"['Mozambique', 'Niue']",Artist,1908,35,19,1943
Adrian Brown,['Czech Republic'],Athlete,1905,81,0,1986
Christopher Taylor,['Kenya'],Researcher,1878,0,86,1878
Frank Simpson,['United States of America'],Politician,1897,35,65,1932
Kurt Skinner,['Burkina Faso'],Researcher,1904,9,4,1913
Luke Wilkins,['Barbados'],Racing automobile driver; formula one driver,1894,45,38,1939
Bradley Robinson,['El Salvador'],Artist,1879,73,25,1952
Charles Hudson,"['Bahamas', 'French Polynesia']",Artist,1905,49,20,1954
Samantha Bass,['Ecuador'],Politician,1870,24,39,1894
Isaac Roberson,['Lithuania'],Politician,1902,10,8,1912
Diana Townsend,['Gabon'],Researcher,1888,34,66,1922
Aaron Williams,['Nicaragua'],Artist,1924,59,55,1983
Robert Turner,"['Argentina', 'Bouvet Island (Bouvetoya)']",Artist,1913,76,33,1989
Sheila Miller,"['Falkland Islands (Malvinas)', 'Djibouti']",Researcher,1909,88,4,1997
Kevin Simmons,"['Western Sahara', 'Equatorial Guinea']",Artist,1900,60,45,1960
James Moran,"['Sao Tome and Principe', 'Saint Martin']",Drawer; gallerist,1908,61,88,1969
Ashley Gomez,"['Cocos (Keeling) Islands', 'Brunei Darussalam']",Businessperson,1881,60,11,1941
Ashley Washington,['Bouvet Island (Bouvetoya)'],Athlete,1918,35,15,1953
Chase Green,"['Malta', 'Myanmar']",Politician,1892,71,2,1963
Brandon Walker,['Germany'],Military personnel,1880,68,37,1948
Jennifer Gordon,['Portugal'],Teacher,1917,66,79,1983
Pamela Gilmore,['Greece'],Artist,1898,38,88,1936
Jennifer Johnson,['Pakistan'],Artist,1896,78,23,1974
Alex Kelley,"['Guatemala', 'Azerbaijan']",Artist,1873,13,40,1886
Valerie Zavala,['Netherlands'],Artist,1881,30,24,1911
Alex Bennett,['Guinea'],Athlete,1914,32,80,1946
Christopher Thompson,['Uruguay'],Politician,1883,24,89,1907
Charlene Anderson,['Korea'],Artist,1910,82,71,1992
Jeremy Perry,['Solomon Islands'],Athlete,1873,7,66,1880
John Solis,"['French Guiana', 'Uganda']",Artist,1905,60,29,1965
Christopher Humphrey,['Dominica'],Researcher,1874,78,21,1952
Melanie Mcpherson,"['Saint Helena', 'Armenia']",Artist,1890,31,15,1921
Eileen Miller,"['Bhutan', 'Togo']",Artist,1873,48,36,1921
Ariel Marshall,"['Turkey', 'Slovenia']",Artist,1923,36,19,1959
Chad Reed,"['Saint Vincent and the Grenadines', 'Sierra Leone']",Artist,1896,18,3,1914
Stephen Thomas,"['Serbia', 'Niue']",Artist,1882,43,82,1925
Andrew Velazquez,['Turkey'],Journalist,1897,56,86,1953
Erika Gonzalez,['Honduras'],Artist,1922,21,35,1943
Danielle Collins,['Gambia'],Artist,1883,63,40,1946
Robin Gross,['Kyrgyz Republic'],Amateur wrestler,1917,65,87,1982
Margaret Gregory,"['Marshall Islands', 'Russian Federation']",Politician,1912,57,45,1969
Rachel Martin,"['Netherlands Antilles', 'Greece']",Artist,1896,81,73,1977
Parker Lee,"['Guinea-Bissau', 'Luxembourg']",Politician,1907,54,41,1961
Theresa Wade,['Slovenia'],Athlete,1920,44,44,1964
Joshua Scott,['Monaco'],Artist,1907,43,51,1950
Jennifer Gordon,"['Bahrain', 'Gibraltar']",Athlete,1894,36,20,1930
Johnny Montgomery,['United States Virgin Islands'],Politician,1881,0,69,1881
Susan Taylor,"['Wallis and Futuna', 'Ethiopia']",Religious figure,1917,74,3,1991
Brenda Brown,"['Wallis and Futuna', 'Cayman Islands']",Artist,1897,77,17,1974
Matthew Rodgers,"['Ghana', 'Portugal']",Politician,1889,54,17,1943
Taylor Payne,"['Israel', 'Sao Tome and Principe']",Politician,1917,62,10,1979
Jason Flowers,['Sierra Leone'],Artist,1870,33,78,1903
Michael Madden,['Burundi'],Artist,1878,63,72,1941
Carlos Thompson,"['Italy', 'Tokelau']",Politician,1888,6,39,1894
Julie Cooper,"['Malaysia', 'Ecuador']",Politician,1909,3,4,1912
Nicole Camacho,"['Montenegro', 'Bouvet Island (Bouvetoya)']",Sprinter,1909,70,58,1979
Shannon Jackson,"['Central African Republic', 'Morocco']",Artist,1875,52,47,1927
Dennis Harmon,['Congo'],Artist,1910,32,20,1942
Russell Martin,['Moldova'],Researcher,1905,69,55,1974
Audrey Mueller,['Saint Lucia'],Researcher,1870,55,38,1925
Keith Payne,['Central African Republic'],Artist,1913,61,56,1974
Mrs. Terry Lee DVM,['Panama'],Artist,1919,55,72,1974
Amanda Rodriguez,"['Mauritania', 'Guyana']",Entrepreneur,1919,8,63,1927
Megan Evans,['Suriname'],Politician,1893,20,18,1913
Jonathon Rangel,['Grenada'],Artist,1923,46,33,1969
Megan White,"['Vanuatu', 'Seychelles']",Politician,1911,60,35,1971
Samuel Owens,"['Slovenia', 'Russian Federation']",Artist,1882,7,18,1889
Victoria Bush,"['Algeria', 'Belize']",Artist,1913,63,38,1976
Tiffany Sanchez,"['Greenland', 'Saudi Arabia']",Athlete,1881,25,76,1906
Elizabeth Nelson,"['Mozambique', 'Myanmar']",Artist,1904,38,2,1942
Roberta Perry,"['Oman', 'Anguilla']",Artist,1877,25,73,1902
Lance Sutton,"['Swaziland', 'Brunei Darussalam']",Artist,1908,49,2,1957
Kendra Harper,"['Kiribati', 'Moldova']",Artist,1910,66,86,1976
Brandon Newman Jr.,['Gabon'],Physician,1884,49,84,1933
Richard Jones,"['Argentina', 'Cape Verde']",Advocate; resistance fighter,1921,48,52,1969
Nicholas Peterson,['United Arab Emirates'],Artist,1894,78,82,1972
Jonathan Chavez,['Macao'],Artist,1908,57,57,1965
Kristin Bartlett,"['Pakistan', 'Kazakhstan']",Artist,1874,33,55,1907
Angela Nelson,['Hungary'],Artist,1901,29,79,1930
Nathan Clark,"['Costa Rica', 'Burundi']",Politician,1879,24,43,1903
Catherine Freeman,"['Turks and Caicos Islands', 'Sao Tome and Principe']",Artist,1909,33,27,1942
Danielle Acosta,['Kenya'],Artist,1906,89,84,1995
Jody Wood,"['Central African Republic', 'Cuba']",Artist,1893,20,75,1913
Kristin Henry,"['Brazil', 'Saudi Arabia']",Artist,1923,74,68,1997
Susan Ramos,"['Saint Helena', 'Marshall Islands']",Artist,1894,33,17,1927
Cameron Nguyen,"['Guernsey', 'Aruba']",Artist,1922,66,20,1988
Debra Humphrey,['Taiwan'],Artist,1881,37,11,1918
Mr. Justin Alvarez,"['Andorra', 'Ireland']",Artist,1901,84,57,1985
Tara Lopez,"['Austria', 'Brunei Darussalam']",Politician,1883,71,83,1954
Jason Le,['Kiribati'],Shogun,1921,49,49,1970
Jeremy Spencer,"['Sierra Leone', 'Barbados']",Artist,1909,4,63,1913
Kristen Sanchez,"['Iran', 'Rwanda']",Military personnel,1878,2,11,1880
Brian Jensen,"['Cocos (Keeling) Islands', 'Armenia']",Athlete,1891,81,16,1972
Angela Rodriguez,['Syrian Arab Republic'],Artist,1872,51,17,1923
Cheryl Sanders,['Wallis and Futuna'],Politician,1885,3,77,1888
Brian Blackwell,"['Uganda', 'Indonesia']",Artist,1899,51,68,1950
Andrea Castillo,"['Maldives', 'French Polynesia']",Artist,1892,88,81,1980
Craig Baker,"['Bolivia', 'Chad']",Athlete,1874,72,78,1946
Mr. Jason Gonzales DVM,['Gabon'],Researcher,1880,44,70,1924
Amy James,['Bosnia and Herzegovina'],Politician,1922,13,7,1935
Kristin Hunt,"[""Cote d'Ivoire"", 'Cape Verde']",Politician,1892,74,38,1966
Mr. Jason Webb,"['Puerto Rico', 'Albania']",Engineer,1875,60,0,1935
Christopher Wright,"['Turkey', 'Reunion']",Artist,1876,28,80,1904
Mr. Charles Guerra,"['Moldova', 'Lesotho']",Politician,1895,41,44,1936
John Pennington MD,['Indonesia'],Artist,1877,64,42,1941
Brenda Roth,"['Bulgaria', 'Guatemala']",Artist,1910,7,37,1917
Timothy Duarte,"['Poland', 'Guinea-Bissau']",Artist,1885,49,30,1934
Jon Edwards,['Uganda'],Artist,1873,7,20,1880
Shawn Jordan,['Saint Lucia'],Artist,1917,69,30,1986
David Anderson,"['Tajikistan', 'Malta']",Teacher,1898,87,37,1985
Johnny Vance,"['Namibia', 'San Marino']",Athlete,1922,28,58,1950
Amanda Solis,"['Panama', 'Saint Vincent and the Grenadines']",Artist,1883,12,37,1895
Michael Watson,"['Jamaica', 'Central African Republic']",Athlete,1886,10,26,1896
Lisa Mitchell,"['Bosnia and Herzegovina', 'Denmark']",Artist,1894,19,36,1913
Jennifer Chang,"['El Salvador', 'Sri Lanka']",Artist,1924,34,77,1958
Anthony Castro,"['United States Minor Outlying Islands', 'Kiribati']",Politician,1914,3,69,1917
Julia Lee,"['Chad', 'Tonga']",Artist,1899,13,73,1912
Brittany Ramos,"['Georgia', 'Heard Island and McDonald Islands']",Researcher,1891,57,1,1948
Casey Cohen,['Turkey'],Artist,1915,49,23,1964
Kayla Edwards,['Tunisia'],Politician,1875,13,52,1888
Laura Rich,"['Netherlands Antilles', 'Guyana']",Politician,1896,89,19,1985
Theresa Taylor,"['Tajikistan', 'Uzbekistan']",Artist,1894,63,69,1957
Christopher Young,['Guernsey'],Politician,1915,1,14,1916
Barbara Armstrong,"['Rwanda', 'Martinique']",Nurse; social worker,1901,50,30,1951
Christopher Smith,['Vietnam'],Politician,1914,22,10,1936
Ryan Smith,"['Guinea-Bissau', 'United Kingdom']",Athlete,1906,54,14,1960
Michelle Bruce,"['Poland', 'Palestinian Territory']",Artist,1906,14,85,1920
Emily Johnson,"['Nicaragua', 'Libyan Arab Jamahiriya']",Politician,1890,18,56,1908
Donald Schwartz,['Burkina Faso'],Military personnel,1911,26,34,1937
Lauren Crane,['Holy See (Vatican City State)'],Politician,1922,55,14,1977
Melanie Wright,"['Brazil', 'Slovakia (Slovak Republic)']",Artist,1900,2,6,1902
Katherine Parker,"['Norfolk Island', 'Colombia']",Politician,1898,72,54,1970
Cole Smith,['Guam'],Artist,1871,0,84,1871
Sonia Grant,['Singapore'],Artist,1924,65,40,1989
Keith Patrick,['North Macedonia'],Researcher,1891,72,29,1963
Kendra Pugh,"['Canada', 'Myanmar']",Politician,1895,54,8,1949
Chris Sweeney,['Anguilla'],Politician,1919,73,14,1992
William Russell,"['Vanuatu', 'Tanzania']",Serial killer; criminal,1909,86,18,1995
Jessica Dyer,"['Ecuador', 'Palau']",Businessperson,1916,83,28,1999
Joanna Davis,"['Syrian Arab Republic', 'Kenya']",Athlete,1906,87,48,1993
William Thompson,"['Cape Verde', 'Rwanda']",Long-distance runner,1923,19,18,1942
Johnny Escobar,"['Burundi', 'Falkland Islands (Malvinas)']",Artist,1921,79,2,2000
Anna Henry,['Bahrain'],Artist,1904,50,66,1954
Andrew Cardenas,['Antarctica (the territory South of 60 deg S)'],Artist,1894,55,78,1949
Jill Orozco,['Korea'],Athlete,1880,72,61,1952
Sean Serrano,"['Lithuania', 'Belgium']",Politician,1880,31,71,1911
Pamela Davila,['Peru'],Artist,1886,39,28,1925
William Stanton,"['Tajikistan', 'Venezuela']",Artist,1879,68,22,1947
Amanda Hardy,"['Timor-Leste', 'Brunei Darussalam']",Mountaineer; explorer,1922,76,30,1998
Rebecca Brown,"['Fiji', 'Holy See (Vatican City State)']",Artist,1919,42,57,1961
John Medina,['Haiti'],Artist,1884,47,51,1931
Pamela Miller,['Denmark'],Researcher,1909,30,17,1939
Andrew Mcbride,['Puerto Rico'],Violinist,1882,52,56,1934
Louis Rosario,"['China', 'United States Virgin Islands']",Politician,1892,11,58,1903
Theresa Daniel,"['Kyrgyz Republic', 'Eritrea']",Artist,1899,74,26,1973
Mikayla Brock,"['Colombia', 'Svalbard & Jan Mayen Islands']",Politician,1907,80,60,1987
Brian Saunders,"['Lithuania', 'Cyprus']",Artist,1895,49,42,1944
Brittany Johnson,['Djibouti'],Artist,1885,31,35,1916
Diana Shelton,['Tajikistan'],Politician,1880,42,50,1922
Tyler Chen,"['Costa Rica', 'Pitcairn Islands']",Artist,1878,39,63,1917
Thomas Murphy,['Mexico'],Artist,1878,8,64,1886
Mary Brady,"['Sao Tome and Principe', 'Afghanistan']",Military personnel,1871,5,8,1876
Kayla Morse,['Saudi Arabia'],Athlete,1897,18,77,1915
Kiara Hammond,"['Sierra Leone', 'Central African Republic']",Athlete,1900,43,81,1943
Melinda Alvarez,['Samoa'],Artist,1914,54,35,1968
Justin Clay,"['Iceland', 'Montserrat']",Criminal; street vendor,1915,56,51,1971
Joshua Williams DVM,"['Paraguay', 'Senegal']",Artist,1874,56,38,1930
Emma Williams,['Guadeloupe'],Politician,1882,14,79,1896
Erica Brown,['Greece'],Artist,1895,80,25,1975
Jamie Walsh,"['Iraq', 'Suriname']",Businessperson,1909,86,17,1995
Steven Pineda,['Bosnia and Herzegovina'],Military personnel,1916,28,23,1944
Jason Simmons,"['Congo', 'Nicaragua']",Costume designer; fashion designer,1907,53,46,1960
Michelle Wallace,"['Bangladesh', 'Palestinian Territory']",Artist,1887,66,74,1953
Scott Gonzalez,"['Marshall Islands', 'Bahamas']",Artist,1877,17,60,1894
Michael Poole,['Indonesia'],Religious figure,1877,46,31,1923
Erica Buchanan,['Yemen'],Politician,1901,27,16,1928
Cameron Goodman,"['Guinea', 'Bahamas']",Television producer; aerobatics pilot,1913,58,72,1971
Antonio Jones,['Reunion'],Politician,1900,33,32,1933
Melanie Khan,['Guernsey'],Gangster,1907,69,54,1976
Douglas White,['Bolivia'],Artist,1907,1,11,1908
Corey Ramos,['Bahamas'],Engineer,1899,24,2,1923
Marc Galvan,"['Gambia', 'Bahamas']",Artist,1883,52,80,1935
Dennis Steele,['Fiji'],Nurse; torturer; concentration camp guard,1875,3,34,1878
Laura Kelly,['Tajikistan'],Artist,1904,53,61,1957
Marie Dickerson,"['Italy', 'Iraq']",Military personnel,1887,70,31,1957
Deborah Romero,"['Guam', 'Marshall Islands']",Socialite; consort,1922,2,62,1924
Antonio Douglas,"['Norfolk Island', 'Haiti']",Entrepreneur,1902,39,8,1941
Angela Garcia,"['Bouvet Island (Bouvetoya)', 'Oman']",Military personnel,1898,36,54,1934
Jacqueline Simon,['Germany'],Amateur wrestler,1903,87,46,1990
Diane Cline,['French Southern Territories'],Researcher,1921,61,41,1982
Douglas Herrera,"['Martinique', 'Mauritania']",Samurai; bushi,1917,73,53,1990
Andrew Hernandez,['Malawi'],Artist,1911,64,62,1975
Danny Morgan,"['Azerbaijan', 'Armenia']",Artist,1880,26,42,1906
Jody Maynard,['Indonesia'],Politician,1901,9,46,1910
Phyllis Phillips,"['Paraguay', 'Papua New Guinea']",Athlete,1923,48,70,1971
Taylor King,"['Cocos (Keeling) Islands', 'Israel']",Researcher,1870,9,34,1879
Patricia Page,['Tuvalu'],Researcher,1917,15,2,1932
Kevin Edwards,"['Nauru', 'United Arab Emirates']",Artist,1872,58,87,1930
John Payne,['Bhutan'],Artist,1921,77,3,1998
Michael Rasmussen,['Germany'],Artist,1914,23,14,1937
Jose Mitchell,"['Botswana', 'South Africa']",Artist,1918,0,64,1918
Christopher Butler,"['Mayotte', 'Yemen']",Researcher,1884,43,35,1927
Angela Foley,"['Norway', 'Nigeria']",Politician,1921,41,75,1962
Jackie Solis,"['French Polynesia', 'Sri Lanka']",Amateur wrestler,1907,67,63,1974
Colin Perkins,['Zambia'],Politician,1902,78,65,1980
Scott Shields,['Libyan Arab Jamahiriya'],Military personnel,1898,3,56,1901
Fernando Flynn,['Belarus'],Researcher,1904,65,75,1969
Sherry Bowen,"['Iraq', 'Benin']",Politician,1907,86,9,1993
Chelsea Murphy,"['United States of America', 'Mauritius']",Athlete,1895,5,56,1900
Shaun Miller,['San Marino'],Artist,1890,39,35,1929
Logan Morse,['Panama'],Politician,1908,86,0,1994
Courtney Dudley,"['Korea', 'Namibia']",Artist,1912,74,39,1986
Benjamin Phillips,['Sudan'],Journalist,1897,5,33,1902
Jeffrey Carson,"['Cameroon', 'New Zealand']",Politician,1912,10,78,1922
Brent Reed,"['Iceland', 'Ukraine']",Politician,1887,1,2,1888
Lauren Strickland,['Mauritania'],Athlete,1893,83,37,1976
Robert Alvarez,"['Macao', 'Malta']",Military personnel,1871,86,84,1957
Felicia Smith MD,['Bosnia and Herzegovina'],Politician,1891,23,43,1914
Christine Martinez,"['Vanuatu', 'Cameroon']",Psychiatrist; psychoanalyst,1903,9,22,1912
Dr. Patricia Serrano MD,"['Nauru', 'Serbia']",Artist,1905,5,78,1910
James Jones,['Italy'],Religious figure,1890,65,46,1955
Russell Davis,"['Mayotte', 'Libyan Arab Jamahiriya']",Artist,1887,77,42,1964
Joseph Russell,['Haiti'],Politician,1905,48,70,1953
Samuel Dennis,"['Bosnia and Herzegovina', 'Iceland']",Artist,1902,71,8,1973
Jessica Lewis,"['Venezuela', 'Heard Island and McDonald Islands']",Artist,1921,69,23,1990
Sarah Baker,['Lithuania'],Politician,1887,69,48,1956
Sean Chen,['Tanzania'],Artist,1871,28,44,1899
Troy Mcfarland,"['Haiti', 'Nauru']",Artist,1923,62,80,1985
Miss Caroline Richardson,"['British Virgin Islands', 'Poland']",Artist,1886,27,54,1913
Lauren Evans,['Azerbaijan'],Researcher,1922,72,31,1994
Michael Ramirez,['Seychelles'],Teacher,1919,35,25,1954
Terry Parker,"['Qatar', 'Mongolia']",Researcher,1924,75,85,1999
Steven Woods,['Palau'],Politician,1876,37,77,1913
Rebecca Santiago,"['South Georgia and the South Sandwich Islands', 'Thailand']",Researcher,1877,35,1,1912
Joshua Flores,['Suriname'],Artist,1870,24,79,1894
George Turner,"['Bahrain', 'French Guiana']",Architect,1898,36,39,1934
Javier Stark,['Serbia'],Athlete,1909,7,75,1916
Kathy Wallace,['Bolivia'],Artist,1895,79,60,1974
John Murphy,['Netherlands'],Researcher,1873,40,60,1913
Katherine Young,"['Saint Lucia', 'Cape Verde']",Politician,1890,40,8,1930
Jason Kane,"['Netherlands', 'Italy']",Artist,1878,51,81,1929
Johnathan Spencer,"['Ecuador', 'Grenada']",Artist,1874,25,73,1899
Rachael Lowery,['Jamaica'],Politician,1919,12,26,1931
Anne Lewis,"['Hungary', 'Falkland Islands (Malvinas)']",Politician,1876,45,14,1921
Melissa Cochran,['Venezuela'],Artist,1882,66,60,1948
Christopher Smith,"['Western Sahara', 'Guatemala']",Artist,1920,37,79,1957
Nicholas White,"['Palestinian Territory', 'Uruguay']",Artist,1878,60,81,1938
James Ayala,"['Solomon Islands', 'Azerbaijan']",Physician,1907,23,21,1930
Mrs. Brianna Brooks,"['Seychelles', 'Poland']",Athlete,1877,16,45,1893
Matthew Austin,['Heard Island and McDonald Islands'],Artist,1875,34,9,1909
Tonya Brown,"['Czech Republic', 'Thailand']",Artist,1886,10,73,1896
Mr. Preston Skinner MD,"['American Samoa', 'Marshall Islands']",Artist,1922,16,67,1938
Jonathon Osborn,"['Netherlands', 'Zambia']",Politician,1877,53,8,1930
Jodi Washington,['Angola'],Researcher,1902,50,62,1952
Audrey Robinson,"['Timor-Leste', 'Bulgaria']",Politician,1878,67,27,1945
Natalie Rivera,"['Latvia', 'French Guiana']",Researcher,1895,47,58,1942
Ryan Reed,"['Netherlands Antilles', 'Panama']",Teacher,1890,43,42,1933
Michael Santana,"['Pakistan', 'Bosnia and Herzegovina']",Researcher,1899,29,35,1928
Christina Frank,"['Northern Mariana Islands', 'Saint Lucia']",Artist,1915,13,51,1928
Edgar Stephens,"['Serbia', 'Venezuela']",Politician,1906,39,18,1945
Jodi Wiggins,"['Guatemala', 'Chile']",Artist,1893,85,27,1978
Jennifer Arias,"['Christmas Island', 'Anguilla']",Artist,1889,86,25,1975
Mary Pace,['Western Sahara'],Businessperson,1923,17,6,1940
Noah Owen,['Bangladesh'],Artist,1913,46,74,1959
Cheryl Hamilton,['Belarus'],Artist,1886,89,5,1975
Gregory Vance,['Bermuda'],Artist,1907,83,80,1990
Joshua Lane,['Cuba'],Artist,1918,26,21,1944
Michele Burgess,"['Cape Verde', 'Solomon Islands']",Researcher,1880,18,19,1898
Beth Moore,['Wallis and Futuna'],Artist,1874,78,23,1952
Allison Horn,"['Mauritius', 'India']",Artist,1880,38,41,1918
Michael Hoffman,['Kenya'],Cinematographer,1913,77,71,1990
Cole Williams,['Italy'],Artist,1889,74,4,1963
Dennis Smith,"['Nicaragua', 'Papua New Guinea']",Midwife; serial killer,1888,24,3,1912
Gloria Trevino,['Malaysia'],Artist,1900,48,22,1948
Shane Wilson,['Guatemala'],Military personnel,1879,6,39,1885
Darren Morgan,"['Netherlands', 'Czech Republic']",Politician,1878,27,14,1905
Theresa Hayes,['Niger'],Politician,1876,51,24,1927
Keith Harris,"['Malawi', 'Bahamas']",Politician,1884,17,8,1901
Jamie Contreras,['Burkina Faso'],Politician,1886,26,38,1912
Richard Townsend,"['Tokelau', 'Norway']",Politician,1898,32,83,1930
Tina Wang,['Bulgaria'],Artist,1911,77,44,1988
Christopher Mason,['French Southern Territories'],Artist,1915,66,21,1981
Robert Anderson,['Iceland'],Journalist,1912,46,44,1958
Jessica Hart PhD,['American Samoa'],Domestic worker; tinsmith,1904,34,47,1938
Joshua Johnson,"['Cocos (Keeling) Islands', 'Reunion']",Artist,1887,79,64,1966
Sarah Mann,['Zambia'],Artist,1881,11,4,1892
Cody Meyer,"[""Lao People's Democratic Republic"", 'Uzbekistan']",Artist,1870,68,9,1938
Anthony Mckee,"['Bangladesh', 'Guernsey']",Artist,1903,53,49,1956
Mr. Johnny Young DVM,['North Macedonia'],Artist,1909,19,19,1928
Don Garcia,['Albania'],Artist,1924,48,89,1972
Chelsea Wagner,['Lithuania'],Researcher,1885,55,66,1940
Amanda Berry,['Bolivia'],Artist,1890,6,60,1896
Jose Fitzpatrick,['Norfolk Island'],Religious figure,1875,6,64,1881
Chase Harris,['Liechtenstein'],Artist,1915,76,36,1991
Michael Schultz,['Guinea'],Athlete,1870,42,75,1912
Jonathon Anderson,['Gabon'],Artist,1883,2,72,1885
Zachary Watson,['Uganda'],Politician,1892,8,60,1900
David Williamson,"['Thailand', 'Grenada']",Researcher,1899,79,40,1978
Terri Price,['Micronesia'],Sailor,1917,61,14,1978
Alexander Lambert,['Svalbard & Jan Mayen Islands'],Cross-country skier,1899,37,74,1936
Daniel Marshall,"['Nigeria', 'Congo']",Artist,1890,33,63,1923
Valerie Everett,"['Martinique', 'Romania']",Politician,1894,79,15,1973
Stephen Warner,"['Gabon', 'Bermuda']",Artist,1870,26,11,1896
Austin Bishop,"[""Lao People's Democratic Republic"", 'Latvia']",Engineer,1921,62,51,1983
Amanda Miller,['Guam'],Researcher,1870,12,70,1882
Michelle Roberts,"['Germany', 'Guatemala']",Artist,1918,6,29,1924
Dana Cowan,['Lesotho'],Researcher,1879,11,17,1890
Michael Thomas,['Comoros'],Military personnel,1908,61,69,1969
Carol Wallace,"['Philippines', 'Equatorial Guinea']",Artist,1872,18,1,1890
Robert Montgomery,['Algeria'],Researcher,1909,42,24,1951
Barbara Rios,['Denmark'],Businessperson,1904,78,21,1982
Rebecca Lee,"['Equatorial Guinea', 'Belarus']",Athlete,1923,74,19,1997
Leslie Chan,['Jamaica'],Artist,1872,16,9,1888
Austin Sanchez,['Antigua and Barbuda'],Athlete,1876,42,88,1918
Bradley Smith,['Bhutan'],Artist,1918,66,70,1984
Nicholas Carney,"['Azerbaijan', 'Niue']",Athlete,1894,56,65,1950
Paul Lewis,"['Singapore', 'Lebanon']",Artist,1902,42,6,1944
Carrie Stewart,"['Marshall Islands', 'Cuba']",Artist,1871,38,84,1909
Claudia Conner,"['Somalia', 'Bhutan']",Religious figure,1920,66,33,1986
Robert Edwards,['India'],Researcher,1877,39,57,1916
Felicia Brewer,"['Jersey', 'Moldova']",Artist,1910,85,80,1995
Tammy Burns,"['Solomon Islands', 'Botswana']",Politician,1885,4,14,1889
Richard Knight,['Chile'],Athlete,1877,57,14,1934
Olivia Perez,"['Morocco', 'Armenia']",Politician,1917,13,26,1930
Sarah Brooks,['North Macedonia'],Religious figure,1883,44,70,1927
Nicole Nguyen,['Estonia'],Artist,1882,74,30,1956
Thomas Lane,['Switzerland'],Long-distance runner; marathon runner,1908,20,55,1928
Michael Martin,"['San Marino', 'Suriname']",Artist,1872,79,15,1951
Robert Franklin,"['Israel', 'Bhutan']",Artist,1905,81,50,1986
Joshua Hamilton,['Kazakhstan'],Politician,1916,3,39,1919
James Cook,"['Canada', 'Gibraltar']",Aristocrat,1914,73,52,1987
Eric Cunningham,"['Macao', 'Tajikistan']",Politician,1881,86,52,1967
Andrew Mitchell,['Trinidad and Tobago'],Politician,1890,84,65,1974
Carrie Lyons,"['Bolivia', 'Suriname']",Artist,1895,73,76,1968
Sean Davis,"['Nepal', 'Indonesia']",Artist,1872,87,73,1959
Jasmin Knight,"['Martinique', 'Cyprus']",Television presenter,1919,49,89,1968
Valerie Skinner,"['Chile', 'Kuwait']",Artist,1899,45,67,1944
Jamie Yang,"['Haiti', 'Japan']",Athlete,1874,72,35,1946
Angela Maddox,"['China', 'Nicaragua']",Artist,1910,61,21,1971
Susan Davis,"[""Cote d'Ivoire"", 'Trinidad and Tobago']",Athlete,1917,26,74,1943
Noah Robinson,['Wallis and Futuna'],Artist,1880,43,3,1923
Laura Flynn,"['Croatia', 'Vietnam']",Artist,1879,10,23,1889
Tina Escobar,['United States of America'],Politician,1873,46,69,1919
Evelyn Morgan,['Germany'],Artist,1922,74,23,1996
Molly Walton,"['Monaco', 'Thailand']",Athlete,1888,33,11,1921
Anthony Myers,['Malta'],Artist,1899,63,84,1962
Amanda Perkins,"['Hungary', 'Australia']",Politician,1878,21,29,1899
Nicholas Harris,"['Iraq', 'Czech Republic']",Nurse; serial killer; criminal,1924,19,17,1943
Melissa Freeman,"['Thailand', 'Latvia']",Artist,1894,45,11,1939
Jessica Barrett,['Poland'],Artist,1916,35,77,1951
Shane Johnson,['Germany'],Artist,1891,80,68,1971
Kyle Contreras PhD,"['Martinique', 'Liberia']",Artist,1901,16,75,1917
Mitchell Meyers,['Liberia'],Religious figure,1886,29,3,1915
Tyler Montgomery,['France'],Researcher,1899,77,44,1976
Amanda Carlson,"['Czech Republic', 'Slovenia']",Politician,1904,53,39,1957
Jesse Campbell,['Cameroon'],Artist,1895,49,59,1944
Michael Shepard,"['United States Minor Outlying Islands', 'Nauru']",Researcher,1893,67,49,1960
Kelly Jones,"['Tajikistan', 'Namibia']",Engineer,1915,72,44,1987
Matthew Kane,['Micronesia'],Researcher,1912,74,76,1986
Amanda Huff,['Guernsey'],Politician,1874,82,39,1956
Charlene Black MD,"['Dominican Republic', 'Cook Islands']",Artist,1878,71,60,1949
Alex Sampson,['Georgia'],Artist,1910,5,75,1915
Susan Hall,['Switzerland'],Artist,1889,66,52,1955
Richard Becker,"['Samoa', 'Switzerland']",Artist,1919,27,53,1946
Antonio Leonard,"['Namibia', 'British Virgin Islands']",Businessperson,1910,80,28,1990
Christine Cameron,['Comoros'],Artist,1909,51,0,1960
John Bell,"['San Marino', 'Oman']",Athlete,1920,30,33,1950
Michelle Edwards,"['Iceland', 'Comoros']",Novelist,1905,10,58,1915
Michael Jackson,['Azerbaijan'],Artist,1890,62,79,1952
Ryan House,"['Rwanda', 'Guyana']",Judge,1911,35,53,1946
James Wilson,"['Solomon Islands', 'Korea']",Artist,1894,89,88,1983
Brandon Garrison,"['United Arab Emirates', 'Palestinian Territory']",Artist,1900,37,23,1937
Evan Shaw,['Iceland'],Artist,1892,87,86,1979
Andrea Small,['Serbia'],Artist,1871,75,21,1946
Robert Jones,['Zambia'],Explorer,1880,87,74,1967
Hannah Key,"['Serbia', 'Saint Martin']",Researcher,1905,62,56,1967
William Duarte,"['Macao', 'Angola']",Disc jockey,1901,43,10,1944
Kevin Yates,"['Cyprus', 'Burundi']",Politician,1895,15,60,1910
Colleen Jarvis,"['Saint Kitts and Nevis', 'Greenland']",Artist,1896,25,64,1921
Joshua Perkins,['Gabon'],Artist,1903,55,44,1958
Frank Melton,['Singapore'],Politician,1874,18,41,1892
Eric Tucker,['Saint Helena'],Artist,1900,10,47,1910
Hannah Cruz,['Iceland'],Researcher,1904,80,12,1984
Mark Meyer,['Yemen'],Artist,1874,19,78,1893
David Sutton,"['Tanzania', 'Uzbekistan']",Artist,1877,82,86,1959
Holly Martinez,['Canada'],Politician,1885,24,11,1909
Samantha Bishop,"['Mauritania', 'Romania']",Athlete,1916,44,61,1960
Danielle Martin,['Cameroon'],Researcher,1905,71,77,1976
Clayton Wilson,['Italy'],Artist,1920,47,47,1967
Matthew Swanson,['Thailand'],Politician,1879,14,8,1893
Jeff Thomas,"['Liechtenstein', 'Zimbabwe']",Artist,1915,24,31,1939
Jerry White PhD,"['Australia', 'Djibouti']",Researcher,1907,89,14,1996
Jeffery Perez,['Jordan'],Politician,1920,22,69,1942
Matthew Hutchinson,"['Moldova', 'Cameroon']",Artist,1923,83,36,2006
Michael Thomas,"['Finland', 'United States of America']",Politician,1895,75,27,1970
Reginald Robinson,"['Kenya', 'Burkina Faso']",Carpenter; joiner,1882,46,33,1928
Heather Rosales,['Timor-Leste'],Monarch,1904,72,67,1976
Jonathan Abbott,['Micronesia'],Researcher,1894,70,7,1964
Rebecca Rogers,['Poland'],Neurologist,1907,56,29,1963
Christian Hahn,"['Sri Lanka', 'Italy']",Athlete,1875,30,24,1905
Keith Harrington DDS,"['Ethiopia', 'Macao']",Serial killer,1900,40,73,1940
Jon Ferguson,['Dominican Republic'],Researcher,1882,87,35,1969
Crystal Smith,['Trinidad and Tobago'],Artist,1873,52,14,1925
Amy Gonzalez,"['Nauru', 'Cayman Islands']",Artist,1916,83,48,1999
Michael Johnson,"['Brazil', 'Sudan']",Artist,1905,80,2,1985
Connie Sanford,"['Thailand', 'Guinea-Bissau']",Researcher,1916,19,57,1935
Cole Nguyen DDS,['Gibraltar'],Politician,1919,59,71,1978
Casey Booker,"['El Salvador', 'Namibia']",Monarch,1884,23,1,1907
Joshua Howell,"['Zambia', 'Syrian Arab Republic']",Athlete,1899,26,31,1925
Sarah Russo,['Montenegro'],Artist,1890,19,49,1909
Christopher Gonzalez,"['Slovakia (Slovak Republic)', 'Australia']",Military personnel,1911,60,29,1971
Brandy Anderson,"['Botswana', 'Italy']",Artist,1924,72,9,1996
Timothy Tran,['Cook Islands'],Artist,1881,53,22,1934
Dylan Cook,"['Wallis and Futuna', 'Switzerland']",Artist,1910,32,3,1942
Melinda Contreras,['Costa Rica'],Artist,1911,16,54,1927
Jeffrey Jackson,"['Somalia', 'Uruguay']",Artist,1918,68,50,1986
Monica James,['Northern Mariana Islands'],Teacher,1878,65,38,1943
John Robinson,"['Saudi Arabia', 'Albania']",Artist,1918,52,15,1970
Cynthia Jones,"['Pitcairn Islands', 'New Zealand']",Artist,1901,30,35,1931
Devon Edwards,"['Hungary', 'Iran']",Aristocrat,1923,86,76,2009
Daniel Davidson,"['Nigeria', 'Lesotho']",Politician,1886,40,42,1926
Carol Snyder,['Sao Tome and Principe'],Artist,1918,21,38,1939
Andrew Burke,"['Guinea', 'Ghana']",Researcher,1907,12,48,1919
Margaret Wiley,"['Romania', 'Macao']",Politician,1922,53,47,1975
Stephanie Gomez,['Kyrgyz Republic'],Artist,1912,46,50,1958
Nicole Malone,['Singapore'],Military personnel,1904,65,48,1969
Kyle Neal,['Palestinian Territory'],Artist,1901,85,31,1986
Xavier Pham,['Saint Helena'],Artist,1872,55,2,1927
Willie Wells,"['Central African Republic', 'Panama']",Artist,1898,75,29,1973
Scott Hall,['United States of America'],Artist,1915,1,59,1916
Mark Hanna,"['Costa Rica', 'Chad']",Artist,1902,86,71,1988
Erin Myers,"['Bangladesh', 'Moldova']",Athlete,1892,31,89,1923
Julian Salazar,"['Sweden', 'Singapore']",Politician,1922,23,24,1945
Austin Burns,['Ukraine'],Monk,1903,77,58,1980
Carrie Morris,['Korea'],Journalist,1884,50,53,1934
Anthony Fernandez,"['Nauru', 'Tonga']",Artist,1924,8,69,1932
Richard Oconnor,"['British Virgin Islands', 'Mozambique']",Artist,1903,45,84,1948
Brenda Blackwell,"['Saudi Arabia', 'Congo']",Military personnel,1917,74,27,1991
Joshua Thomas,['Macao'],Athlete,1900,17,1,1917
Sharon Bonilla,['Palestinian Territory'],Motorcycle racer; racing automobile driver,1916,22,50,1938
Mr. Derek Taylor,['Marshall Islands'],Politician,1911,63,57,1974
Jacqueline Barker,['Guam'],Artist,1923,40,10,1963
Jacob Buckley,"['Kenya', 'Lebanon']",Artist,1902,65,23,1967
Gloria Anderson,"['Saint Vincent and the Grenadines', 'Monaco']",Politician,1895,69,21,1964
Francisco Torres,['Nepal'],Artist,1913,9,77,1922
Richard Maxwell,['Italy'],Artist,1873,31,42,1904
Emily Miller,['Korea'],Artist,1870,77,49,1947
Thomas Mitchell,['Cameroon'],Guitarist,1877,42,12,1919
Howard Romero,['Korea'],Politician,1884,59,48,1943
Rebecca Johnson,['Nicaragua'],Artist,1915,58,40,1973
Jeffrey Lopez,['Taiwan'],Politician,1896,30,15,1926
Greg Nelson,['Uruguay'],Prison warden; torturer; concentration camp guard,1874,57,76,1931
Sandra Wilson,['Bahamas'],Researcher,1879,57,5,1936
William Chang,"['Saint Pierre and Miquelon', 'French Southern Territories']",Researcher,1919,85,26,2004
Michelle Duke,"['Iraq', 'Turkmenistan']",Artist,1909,36,9,1945
Micheal Friedman,['Seychelles'],Religious figure,1879,79,29,1958
Michael Jones,"['Qatar', 'Sri Lanka']",Politician,1922,5,20,1927
Kyle Ruiz,['Luxembourg'],Artist,1874,30,52,1904
Dr. Lauren Hill,['Wallis and Futuna'],Artist,1915,44,52,1959
Olivia Wright,['Guinea'],Athlete,1914,33,5,1947
Tina Rodriguez,"['Tuvalu', 'Korea']",Artist,1884,25,35,1909
David Hoover,['Senegal'],Politician,1899,32,74,1931
Austin Peterson,"['Venezuela', 'Mali']",Politician,1906,79,47,1985
Makayla Stevens,['El Salvador'],Politician,1871,48,47,1919
Danielle Elliott MD,"['Cocos (Keeling) Islands', 'Estonia']",Artist,1903,8,85,1911
Nathaniel Clark,['Sri Lanka'],Criminal,1880,39,60,1919
Thomas Baird,['Tuvalu'],Athlete,1870,74,88,1944
Alex Knight,"['Vietnam', 'Algeria']",Artist,1873,1,32,1874
Cynthia Mayer,"['Japan', 'Central African Republic']",Athlete,1887,73,55,1960
Thomas Patterson,"['Vietnam', 'Finland']",Military personnel,1877,81,45,1958
Michael Welch,"['Seychelles', 'Kuwait']",Politician,1916,32,14,1948
Timothy Steele,['Austria'],Artist,1924,37,5,1961
Gregory Thomas,['Slovenia'],Athlete,1880,41,85,1921
Kevin Casey,"['Eritrea', 'Libyan Arab Jamahiriya']",Artist,1874,57,59,1931
Kimberly Anderson,['Bouvet Island (Bouvetoya)'],Artist,1906,59,29,1965
Karen Fox,['Equatorial Guinea'],Researcher,1873,43,57,1916
Lindsey Alvarez,"['United States of America', 'Qatar']",Artist,1907,30,41,1937
Richard Lopez,['Czech Republic'],Artist,1904,33,41,1937
Benjamin Jones,['South Georgia and the South Sandwich Islands'],Politician,1923,14,27,1937
Julie Frazier,"['Armenia', 'Turks and Caicos Islands']",Military personnel,1872,58,47,1930
Kenneth Moore DDS,"['Benin', 'Armenia']",Artist,1904,2,19,1906
Jacob Webb,['Tajikistan'],Artist,1872,14,32,1886
Brandy Johnson,"['Moldova', 'Mali']",Artist,1899,71,42,1970
Angel Herman,['Jordan'],Researcher,1883,59,10,1942
Steven Williams,"['Anguilla', 'Kazakhstan']",Researcher,1887,49,37,1936
Joseph Sanchez,"['Korea', 'Poland']",Military personnel,1871,27,27,1898
Amanda Horton,"['Angola', 'Burundi']",Athlete,1889,39,16,1928
Jaime Phelps Jr.,"['Liberia', 'Antigua and Barbuda']",Artist,1893,27,42,1920
Sheri Mills,"['Anguilla', 'Guyana']",Artist,1920,9,46,1929
Mary Diaz,"['Solomon Islands', 'Czech Republic']",Researcher,1902,7,43,1909
Christina Guzman,"['Guinea', 'Kiribati']",Researcher,1898,51,9,1949
Terrence Strickland,['Paraguay'],Teacher,1895,88,15,1983
Kristie Ruiz,['Colombia'],Researcher,1915,79,39,1994
Gabrielle Wolf,"['Mali', 'Heard Island and McDonald Islands']",Artist,1871,17,52,1888
Amy Sanchez,"['Namibia', 'Canada']",Artist,1915,9,6,1924
Amy Ware,['Romania'],Artist,1894,63,71,1957
Stephanie Johnson,"['Namibia', 'South Georgia and the South Sandwich Islands']",Artist,1897,48,2,1945
Stephen Lewis,"['Ghana', 'Timor-Leste']",Politician,1876,57,45,1933
Mathew Cruz,"['Latvia', 'Fiji']",Artist,1917,42,85,1959
Christine Hartman,['Libyan Arab Jamahiriya'],Politician,1905,75,58,1980
David Riley,"['Portugal', 'Denmark']",Artist,1880,84,29,1964
Nicholas Williams,"['Finland', 'Brunei Darussalam']",Researcher,1887,5,67,1892
Julie Green,['Malaysia'],Artist,1900,64,24,1964
Cindy Brown,['Liechtenstein'],Artist,1924,60,38,1984
Lisa Young,['Puerto Rico'],Ballet dancer; ballet master; choreographer,1893,43,56,1936
Ryan Tucker,"['Jamaica', 'Mali']",Athlete,1901,53,47,1954
Troy Newman,"['Holy See (Vatican City State)', 'Denmark']",Artist,1904,16,21,1920
Charles Schwartz,['Venezuela'],Politician,1919,60,44,1979
Susan Miller,['Russian Federation'],Politician,1924,83,85,2007
Alyssa Gill,['Panama'],Artist,1900,30,26,1930
Vincent Wright,['Benin'],Artist,1917,57,69,1974
Jose Lopez,"['Trinidad and Tobago', 'Korea']",Artist,1878,11,28,1889
Kelly Higgins,"['Saint Kitts and Nevis', 'Yemen']",Artist,1908,7,89,1915
Christian Walker,['Zambia'],Entrepreneur,1905,25,1,1930
John Young,"['Christmas Island', 'Nepal']",Military personnel,1889,33,75,1922
Alexis Miranda,"['Uruguay', 'Jordan']",Homekeeper,1921,45,55,1966
Matthew West,"['Gibraltar', 'El Salvador']",Artist,1921,74,48,1995
Mary Walker,"['Saudi Arabia', 'Ireland']",Researcher,1914,77,33,1991
Steven Irwin,"['Korea', 'Honduras']",Artist,1921,63,4,1984
Daniel Hartman,"['Slovakia (Slovak Republic)', 'Andorra']",Politician,1917,28,44,1945
Erin Thornton,['Mayotte'],Artist,1914,32,38,1946
Alex Gonzalez,"['Egypt', 'Grenada']",Artist,1897,9,25,1906
Linda Lee,['Wallis and Futuna'],Politician,1875,29,45,1904
Rachel Johnson,['Nicaragua'],Politician,1898,81,61,1979
Shelly Sandoval,"['Iceland', 'Costa Rica']",Artist,1885,14,83,1899
Elizabeth Brown,['Peru'],Artist,1914,50,7,1964
Alexander Santos,['Taiwan'],Politician,1890,39,61,1929
Steven Miller,"['Singapore', 'Guyana']",Artist,1879,45,58,1924
Andrew Porter,"['Ethiopia', 'Montenegro']",Artist,1909,35,67,1944
Omar Perez,['Nauru'],Artist,1874,49,80,1923
Cassandra Ramirez,"['Saint Pierre and Miquelon', 'Svalbard & Jan Mayen Islands']",Artist,1878,14,4,1892
Anthony Grant,"['Bosnia and Herzegovina', 'Greenland']",Politician,1872,21,31,1893
Annette Daniels DDS,['New Caledonia'],Politician,1899,42,12,1941
Audrey Fitzgerald,"['Isle of Man', 'Malawi']",Artist,1892,47,3,1939
Matthew Boyer,['Papua New Guinea'],Athlete,1891,13,43,1904
Timothy Horton,"['Macao', 'Azerbaijan']",Military personnel,1917,87,66,2004
Gail Edwards,['Tajikistan'],Artist,1886,13,68,1899
Shelley Cain,"['Mozambique', 'Serbia']",Artist,1911,73,77,1984
Sean Sanders,"['Belize', 'Taiwan']",Athlete,1922,29,35,1951
Allen Alvarez,"['Isle of Man', 'Poland']",Military personnel,1879,70,3,1949
Eddie Perry,"['Montenegro', 'Slovakia (Slovak Republic)']",Drug trafficker,1918,51,77,1969
Scott Mullins,['Kiribati'],Politician,1894,35,5,1929
Kayla Patel,"['Cocos (Keeling) Islands', 'Saint Pierre and Miquelon']",Artist,1891,75,32,1966
Jeffrey Clark,"['Malaysia', 'Burkina Faso']",Artist,1914,41,29,1955
Harry Hendrix,['Marshall Islands'],Military personnel,1874,64,45,1938
William Floyd,['Sao Tome and Principe'],Artist,1894,60,51,1954
Kelly Morales,['Panama'],Researcher,1877,0,29,1877
Amy Brewer,['Palau'],Researcher,1911,22,54,1933
Dominique Foster,['Tonga'],Weightlifter,1880,31,55,1911
Curtis Murray,"['Guinea-Bissau', 'Congo']",Artist,1890,28,40,1918
Kevin Snyder,['Australia'],Religious figure,1891,2,46,1893
Travis Oconnell,"['Belarus', 'Spain']",Artist,1918,89,54,2007
Vanessa Odom,['Saint Kitts and Nevis'],Businessperson,1915,61,34,1976
Jeanette Gilbert,['Slovenia'],Journalist,1879,60,43,1939
Ryan Cook,"['Australia', 'Pakistan']",Artist,1889,39,83,1928
Douglas Kline,"['Tonga', 'Uganda']",Architect,1872,38,71,1910
Nicholas Sanchez,"['Turks and Caicos Islands', 'Turkmenistan']",Researcher,1911,64,46,1975
Matthew Faulkner,"['Turks and Caicos Islands', 'Slovenia']",Journalist,1896,70,23,1966
Emily Johnson,['Ecuador'],Artist,1918,35,58,1953
Anthony Sherman,"['Mauritania', 'Somalia']",Artist,1900,48,85,1948
Antonio White,"['Bermuda', 'Dominica']",Researcher,1879,15,13,1894
Danielle King,"['Tanzania', 'Barbados']",Artist,1913,49,80,1962
Richard Jones,"[""Cote d'Ivoire"", 'San Marino']",Religious figure,1886,76,5,1962
John Gibson,['Barbados'],Artist,1886,68,89,1954
Mary Smith,['Indonesia'],Researcher,1883,15,17,1898
Matthew Lambert,['Guernsey'],Politician,1918,54,20,1972
Brenda Montgomery,['Burkina Faso'],Artist,1924,68,24,1992
Tammy Fletcher,['Gabon'],Artist,1883,1,69,1884
David Compton,"['Luxembourg', 'Belize']",Artist,1874,19,28,1893
Dylan Medina,['Ireland'],Artist,1915,46,75,1961
Tamara Lewis,['Chile'],Amateur wrestler,1896,60,24,1956
Michael Taylor,['Norway'],Artist,1885,74,71,1959
Joel Romero,['Eritrea'],Politician,1896,43,59,1939
Dr. Jeremy Nelson,['Gambia'],Artist,1882,24,33,1906
Kent Rodriguez,"['Jersey', 'Slovenia']",Artist,1911,44,38,1955
Andre Hernandez,['Slovenia'],Politician,1913,73,28,1986
Scott Dawson,['Peru'],Politician,1879,74,68,1953
Courtney King,['Antigua and Barbuda'],Artist,1922,49,86,1971
Gabrielle Welch,"['French Guiana', 'Jamaica']",Artist,1906,20,77,1926
Anthony Neal,['Bhutan'],Monarch,1895,78,83,1973
Tammy Gray,['Tanzania'],Athlete,1917,40,27,1957
Tabitha Hernandez,['Guam'],Researcher,1882,37,70,1919
Amanda Thomas,['Hong Kong'],Artist,1882,61,43,1943
Terry Miller,"['Australia', 'Nauru']",Military personnel,1921,82,15,2003
Carol Bowen,"['Uzbekistan', 'Vanuatu']",Military personnel,1919,28,73,1947
Steven Johnson,"['Uzbekistan', 'Isle of Man']",Artist,1898,30,62,1928
Tiffany Ballard,['Nepal'],Researcher,1871,8,35,1879
Angela Taylor,['Qatar'],Military personnel,1905,49,29,1954
Deborah Wells,"['Georgia', 'Niue']",Military personnel,1922,89,63,2011
Cody Palmer,['Palestinian Territory'],Politician,1902,51,17,1953
Cody Flynn,"['Montserrat', 'Tanzania']",Politician,1901,56,88,1957
Thomas Williams,['United Kingdom'],Athlete,1897,85,66,1982
Dawn Conner,['Liechtenstein'],Businessperson,1918,73,53,1991
Jose Frey,"['Palestinian Territory', 'Canada']",Politician,1883,5,11,1888
Thomas Maddox,['Germany'],Artist,1871,1,58,1872
Dennis Doyle,"['Morocco', 'Northern Mariana Islands']",Artist,1918,62,26,1980
Michelle Michael,"['New Caledonia', 'Greece']",Politician,1902,67,40,1969
Jason Smith,['Panama'],Artist,1915,19,2,1934
Patrick Warren,['Bouvet Island (Bouvetoya)'],Politician,1881,0,53,1881
Holly Beasley,['Singapore'],Researcher,1898,86,71,1984
Karen Carney,"['Mongolia', 'Belgium']",Entrepreneur,1914,55,27,1969
April Harmon,"['Guinea-Bissau', 'Belize']",Gangster,1921,6,21,1927
Jane Peters,['Rwanda'],Artist,1876,46,2,1922
Christine White,['Cook Islands'],Artist,1907,58,42,1965
Deanna Martinez,['Sweden'],Artist,1923,87,9,2010
Cheryl Mcmahon,"['Australia', 'Cameroon']",Journalist,1885,2,62,1887
Crystal Leon,"['Chile', 'Malaysia']",Artist,1873,46,57,1919
Jonathan Franco,"['Sri Lanka', 'El Salvador']",Politician,1909,2,67,1911
Albert Chambers,['Macao'],Military personnel,1904,53,58,1957
Heather Miller,['Tajikistan'],Artist,1886,48,63,1934
Blake Singleton,"['United States of America', 'Swaziland']",Politician,1887,87,75,1974
Sharon Sanchez,"['Finland', 'Heard Island and McDonald Islands']",Artist,1921,40,21,1961
Anthony Perkins,"['Tunisia', 'Venezuela']",Politician,1891,29,2,1920
Cindy Jones,"['Vanuatu', 'Mexico']",Artist,1879,75,38,1954
Joseph Rose,"['Moldova', 'Sierra Leone']",Artist,1874,37,22,1911
Susan Lucas,"['Equatorial Guinea', 'Mali']",Politician,1874,15,16,1889
Steven Parker,['Niger'],Athlete,1873,79,17,1952
Austin Strickland,['Congo'],Artist,1882,10,85,1892
Jeffery Smith,['Pitcairn Islands'],Politician,1879,62,59,1941
Kimberly Roman,"['Egypt', 'Estonia']",Researcher,1895,48,54,1943
Zachary Baker,['France'],Politician,1919,76,48,1995
Scott Ayers,"['Switzerland', 'Zambia']",Competitive diver,1915,61,45,1976
Grace Knox,['Morocco'],Artist,1885,30,89,1915
Albert Francis,"['United Kingdom', 'Saint Pierre and Miquelon']",Artist,1898,14,19,1912
Benjamin Adkins,['Chile'],Artist,1896,88,27,1984
Anne Bryant,['Micronesia'],Teacher,1882,56,66,1938
Suzanne Weaver,['Tajikistan'],Athlete,1879,80,68,1959
Joseph Davis,['Serbia'],Businessperson,1883,12,75,1895
Victor Boyle,"['Colombia', 'Kiribati']",Artist,1872,54,1,1926
Jodi Johnson,"['Somalia', 'Mongolia']",Researcher,1916,56,0,1972
Tiffany Copeland,['Kazakhstan'],Researcher,1881,45,5,1926
Elijah Fowler,['French Polynesia'],Artist,1920,71,57,1991
Danielle Holt,['Eritrea'],Researcher,1915,69,30,1984
Caleb Osborne,"['Saint Martin', 'Ghana']",Politician,1903,6,28,1909
Linda Ramirez,['Reunion'],Teacher,1920,84,38,2004
Jessica Woods,['Switzerland'],Researcher,1916,19,1,1935
Paul Shaw,['Cameroon'],Researcher,1923,28,40,1951
Michael Callahan,"['Egypt', 'Nepal']",Athlete,1907,53,81,1960
Christine Anderson,['Morocco'],Politician,1904,70,49,1974
Sharon Schultz,"['Marshall Islands', 'Singapore']",Entrepreneur,1910,87,88,1997
Susan Hunter,['Algeria'],Artist,1921,45,80,1966
Johnny Villanueva,['Jersey'],Artist,1877,6,16,1883
Beverly Wilson,['Yemen'],Politician,1877,26,1,1903
Leslie Brown,['Greenland'],Politician,1880,13,69,1893
Christina Turner,['Faroe Islands'],Artist,1904,60,76,1964
James Andrade,['Yemen'],Politician,1880,70,53,1950
Eric Garza,"['Italy', 'Mauritania']",Artist,1902,57,56,1959
Christy Bush,"['Chad', 'Armenia']",Artist,1887,25,19,1912
Steven Gray,['Isle of Man'],Politician,1892,20,18,1912
Katherine Robinson,['Haiti'],Artist,1896,85,67,1981
Jack Howard,"['Indonesia', 'Spain']",Artist,1882,17,17,1899
Trevor Lynch,['Latvia'],Politician,1889,46,65,1935
Carlos Grimes,['South Georgia and the South Sandwich Islands'],Athlete,1911,29,1,1940
Carolyn Martin,"['Christmas Island', 'Andorra']",Cinematographer; camera operator,1900,85,87,1985
Annette Parker,"['Nepal', 'Ireland']",Artist,1902,6,84,1908
Catherine Vincent,['Saint Helena'],Teacher,1910,64,67,1974
Kimberly Chavez,['Mongolia'],Athlete,1900,44,44,1944
Aaron Blevins,"['Thailand', 'Anguilla']",Bullfighter,1895,11,60,1906
Christy Callahan,"['Thailand', 'Russian Federation']",Explorer,1889,73,14,1962
Megan Barajas,"['Cape Verde', 'Timor-Leste']",Politician,1880,3,43,1883
Christina Mendoza,"['United States Minor Outlying Islands', 'Dominican Republic']",Entrepreneur,1876,46,9,1922
James Morse,"['Mayotte', 'Botswana']",Artist,1877,44,12,1921
Monica Richards,"['Brunei Darussalam', 'Mauritania']",Researcher,1905,26,8,1931
Dawn Beasley,['Afghanistan'],Researcher,1907,9,66,1916
Lauren Lucas,"['Zambia', 'Wallis and Futuna']",Researcher,1898,25,0,1923
Emily Gregory,"['Saint Vincent and the Grenadines', 'Denmark']",Artist,1878,44,65,1922
Jennifer Ruiz,"['Kyrgyz Republic', 'Senegal']",Politician,1909,22,48,1931
Dawn Little,['Czech Republic'],Nurse,1896,57,83,1953
James Walker,"['Lebanon', 'Andorra']",Athlete,1880,57,4,1937
James Miller,['British Virgin Islands'],Religious figure,1874,89,24,1963
Jean Graham,['Nauru'],Artist,1872,59,41,1931
Bryan Daugherty,"['Angola', 'French Guiana']",Artist,1919,55,12,1974
Brian Anderson,"['Reunion', 'Norfolk Island']",Artist,1911,63,60,1974
Daniel Smith,['Israel'],Artist,1918,65,70,1983
Jennifer Carrillo,['Andorra'],Artist,1889,66,49,1955
Jean Sanchez,['British Indian Ocean Territory (Chagos Archipelago)'],Criminal,1878,74,42,1952
Richard Rogers,"['Turkey', 'United States of America']",Military personnel,1875,76,10,1951
David Ali,['American Samoa'],Artist,1901,56,10,1957
Erin Robbins,['Guadeloupe'],Farmer,1887,77,46,1964
Rebecca Cervantes,"['Yemen', 'Czech Republic']",Artist,1919,88,75,2007
Marc Espinoza,['Samoa'],Athlete,1917,27,47,1944
Kathryn Schmidt,"['Moldova', 'Anguilla']",Artist,1914,74,73,1988
Dawn Ramos,"['Philippines', 'Cocos (Keeling) Islands']",Artist,1888,38,17,1926
Erica George,"['Australia', 'Antarctica (the territory South of 60 deg S)']",Artist,1907,75,60,1982
Robert Collins,['Netherlands'],Artist,1904,6,73,1910
Karen Johnson,"['Norfolk Island', 'Canada']",Artist,1877,26,41,1903
Dr. Jacob Bradley,"['Jamaica', 'Grenada']",Aristocrat,1910,13,3,1923
Maxwell Bryan,['Peru'],Artist,1912,70,36,1982
Mark Carpenter,"['Nauru', 'Chile']",Artist,1887,63,80,1950
Mr. Daniel Rivers PhD,"['Guinea', 'Jordan']",Privateer,1897,5,49,1902
Adam Ford,"['Mauritania', 'Tuvalu']",Artist,1879,67,85,1946
April Rodriguez,"['Kyrgyz Republic', 'Kiribati']",Politician,1919,27,12,1946
Monique Clark,"['Bermuda', 'Ethiopia']",Artist,1914,31,78,1945
John Williamson,"['Tuvalu', 'Qatar']",Athlete,1910,82,89,1992
Jared Bentley,['Kenya'],Politician,1918,20,88,1938
Megan Frey,['Bosnia and Herzegovina'],Religious figure,1906,20,72,1926
Kayla Owens,"['Fiji', 'Cape Verde']",Military personnel,1923,81,18,2004
Benjamin Mclaughlin,['Sierra Leone'],Artist,1888,35,48,1923
Angela Baird,['Djibouti'],Military personnel,1870,76,60,1946
Erica Shepherd,['Bangladesh'],Artist,1895,26,54,1921
Cheyenne Wells,['Guyana'],Artist,1886,84,69,1970
Kristy Smith,['Denmark'],Artist,1891,59,23,1950
Lindsay Hamilton,"['Mali', 'Gibraltar']",Researcher,1895,12,16,1907
John Thomas,"['Turkey', 'Gabon']",Military personnel,1872,38,19,1910
Johnathan Hicks,"['Fiji', 'United Arab Emirates']",Researcher,1899,78,48,1977
Adam Turner,['Mali'],Researcher,1902,85,83,1987
Carol Harris,['Tonga'],Military personnel,1922,75,5,1997
Ashley Miller,['Lithuania'],Artist,1922,42,83,1964
Stephen Simpson,['Oman'],Artist,1923,32,39,1955
Jenna Smith,"['Indonesia', 'Isle of Man']",Politician,1875,56,32,1931
Douglas York Jr.,"['Somalia', 'Cocos (Keeling) Islands']",Artist,1871,5,20,1876
Tina Nelson,"['Turkey', 'Indonesia']",Athlete,1874,57,61,1931
Wayne Scott,"['Belgium', 'Cyprus']",Military personnel,1917,51,39,1968
Brenda Rowe,"['Falkland Islands (Malvinas)', 'Congo']",Researcher,1882,60,52,1942
Joyce Parker,"['Jordan', 'Madagascar']",Artist,1918,36,75,1954
Kathleen Brown,['Libyan Arab Jamahiriya'],Athlete,1876,17,55,1893
Alexander Hayes,['Senegal'],Artist,1914,70,39,1984
Logan Tran,['Ecuador'],Artist,1875,39,79,1914
Harold Rios,['Mauritania'],Military personnel,1896,60,42,1956
Allen Fisher,"['El Salvador', 'Bermuda']",Artist,1899,31,79,1930
Mary Shelton,['Russian Federation'],Serial killer,1886,72,35,1958
Marilyn Arroyo,"['Peru', 'Zambia']",Artist,1891,19,44,1910
Alyssa Gonzalez,['Moldova'],Artist,1909,20,59,1929
Tiffany Reed MD,"['Russian Federation', 'Ecuador']",Artist,1913,65,88,1978
Gregory Davis,"['Sri Lanka', 'Ecuador']",Researcher,1898,78,76,1976
Emily Sullivan,['Lebanon'],Artist,1883,84,38,1967
Eric Guerrero,"['Namibia', 'Western Sahara']",Artist,1918,83,78,2001
Christopher Santos,"['Niue', 'Mexico']",Artist,1922,11,60,1933
Rebecca Campbell,['Syrian Arab Republic'],Military personnel,1888,64,67,1952
Adam Patel,"['Netherlands Antilles', 'Ghana']",Athlete,1874,47,51,1921
Tommy Olson,"['Madagascar', 'Vanuatu']",Politician,1885,21,60,1906
Joseph Mccullough,"['Saint Pierre and Miquelon', 'Equatorial Guinea']",Researcher,1880,48,4,1928
Michael Diaz,['Solomon Islands'],Artist,1885,49,47,1934
Lisa Glenn,['British Indian Ocean Territory (Chagos Archipelago)'],Military personnel,1882,60,12,1942
Bob Contreras,"['Venezuela', 'Namibia']",Artist,1910,58,8,1968
Dr. Emily Mccarthy,"['Belarus', 'Saint Kitts and Nevis']",Athlete,1917,26,17,1943
Kenneth West,['Maldives'],Politician,1881,70,7,1951
Joyce Cunningham,"['Albania', 'Congo']",Artist,1872,28,84,1900
Mario Bauer,['Myanmar'],Politician,1879,40,49,1919
Sharon Martin,['Kazakhstan'],Artist,1913,75,81,1988
Kevin Caldwell,"['Thailand', 'Western Sahara']",Military personnel,1892,10,86,1902
Michelle Rogers,['Albania'],Artist,1896,10,56,1906
Bonnie Mcmahon,"['Reunion', 'Estonia']",Artist,1879,43,11,1922
Michelle Fields,"['Solomon Islands', 'Somalia']",Artist,1878,73,15,1951
Deborah Owens,"['Bosnia and Herzegovina', 'New Zealand']",Researcher,1900,62,6,1962
Kelly Ruiz,['India'],Artist,1921,85,79,2006
Katherine Wilkerson,['Congo'],Religious figure,1886,61,85,1947
David Garcia,"['British Indian Ocean Territory (Chagos Archipelago)', 'Senegal']",Artist,1886,44,5,1930
Erica Chapman,"['Georgia', 'Turkey']",Artist,1908,39,55,1947
Jordan Andrews,['Antigua and Barbuda'],Artist,1874,85,23,1959
Jacob Howard,"['Saint Lucia', 'Cocos (Keeling) Islands']",Artist,1901,1,82,1902
Melissa Haynes,"['Yemen', 'Greenland']",Artist,1909,36,79,1945
Jessica Boyd,['Switzerland'],Researcher,1923,72,70,1995
Matthew Butler,"['British Indian Ocean Territory (Chagos Archipelago)', 'Philippines']",Politician,1887,65,44,1952
Kimberly Harris,['Syrian Arab Republic'],Lawyer,1876,26,11,1902
Denise Sanders,['Yemen'],Artist,1872,56,49,1928
Karen Wood,"['United Arab Emirates', 'Sierra Leone']",Aristocrat,1878,88,27,1966
Ann Patterson,"['Turkey', 'Solomon Islands']",Politician,1897,22,37,1919
Shelly Schultz,['Niue'],Politician,1881,26,25,1907
Brian Mcfarland,['New Caledonia'],Military personnel,1910,75,87,1985
Sarah Hughes,"['Congo', 'Western Sahara']",Researcher,1894,63,29,1957
Jeffrey Flores,"['Saint Vincent and the Grenadines', 'Burundi']",Politician,1881,27,17,1908
John Harris,"['Egypt', 'Saint Helena']",Gangster,1911,71,25,1982
Danielle Delgado,['Ghana'],Athlete,1917,18,13,1935
Pamela Kelly,['Armenia'],Artist,1893,38,54,1931
Brian Avery,['Sudan'],Politician,1902,30,69,1932
Makayla Miller,"['Senegal', 'Kazakhstan']",Athlete,1922,56,19,1978
Amber Hopkins,['Benin'],Artist,1874,82,43,1956
Rodney Morse,"['Anguilla', 'Uganda']",Artist,1894,78,44,1972
Jason Bass,"['Sri Lanka', 'Peru']",Artist,1887,39,2,1926
Rick Rodriguez,['Nicaragua'],Military personnel,1902,32,12,1934
Sheila Stewart,"['Georgia', 'Liberia']",Artist,1887,56,50,1943
Lisa Palmer,"['Belgium', 'Norway']",Athlete,1876,28,68,1904
Michael Davis,"['Djibouti', 'Lithuania']",Artist,1904,18,12,1922
Daniel Shannon,['Belize'],Ice dancer,1908,39,25,1947
Christopher Watson,"['Marshall Islands', 'British Virgin Islands']",Artist,1872,72,58,1944
Mrs. Kelly Miller,"['Israel', 'Togo']",Condottiero,1886,21,46,1907
Gregory Callahan,['Guam'],Artist,1904,75,31,1979
Anna Blake,"['Kuwait', 'South Africa']",Samurai,1873,28,66,1901
Rebecca Daugherty,['Poland'],Rock drummer,1897,78,47,1975
Tyler Henry,"['Fiji', 'Mexico']",Military personnel,1892,79,40,1971
Richard Long,"['Iceland', 'Philippines']",Artist,1916,34,42,1950
Theresa Clark MD,"['Sweden', 'Turkmenistan']",Artist,1902,69,89,1971
Luis Hernandez,"['Cape Verde', 'Christmas Island']",Artist,1895,34,69,1929
Kathleen Anderson,['Libyan Arab Jamahiriya'],Artist,1898,13,83,1911
Tanya Foster,"['Anguilla', 'Saint Helena']",Artist,1915,13,44,1928
John Coleman,['United Arab Emirates'],Researcher,1885,45,46,1930
Michael Jones,"['Korea', 'United Arab Emirates']",Athlete,1873,58,55,1931
Sydney Coleman,"['Malaysia', 'Jordan']",Impostor,1890,63,61,1953
Roy Key,"['Gambia', 'Jamaica']",Artist,1903,14,34,1917
Susan Thompson,['Guam'],Artist,1917,71,6,1988
David Rivera,['Lesotho'],Politician,1914,54,9,1968
John Thornton,['Czech Republic'],Aristocrat,1923,18,52,1941
Jessica Gutierrez,['Tanzania'],Religious figure,1888,12,24,1900
Sandra Bush,"['United Kingdom', 'Tunisia']",Artist,1905,46,3,1951
Gregory Jones,['Mauritania'],Artist,1875,63,44,1938
Dr. Rodney Richards,"['Austria', 'Falkland Islands (Malvinas)']",Athlete,1902,32,20,1934
Kenneth Small,"['Netherlands Antilles', 'French Guiana']",Political activist; newspaper editor,1902,35,48,1937
Brett Compton,"['Sweden', 'Sweden']",Scenographer,1915,5,55,1920
Hannah Williams,"['Iraq', 'Faroe Islands']",Military personnel,1912,63,55,1975
Ashley Clark,['Gibraltar'],Monk,1903,81,56,1984
Gregory Miller,"['Cuba', 'Samoa']",Teacher,1893,65,75,1958
Laura Cooper,"['Palestinian Territory', 'Angola']",Formula one driver,1874,34,83,1908
Keith Anderson,"['Bhutan', 'Botswana']",Artist,1881,9,57,1890
Jonathan Hudson,['Puerto Rico'],Artist,1901,24,56,1925
Timothy Robertson,['Gabon'],Politician,1915,53,35,1968
Justin Taylor,['Gibraltar'],Researcher,1912,38,40,1950
Melissa Thomas,['Luxembourg'],Nun,1888,78,84,1966
Gavin Little,['Trinidad and Tobago'],Military personnel,1922,83,66,2005
Nicholas Rodgers,"['Belarus', 'North Macedonia']",Politician,1922,2,64,1924
Christopher Holmes,"['Timor-Leste', 'Haiti']",Artist,1922,65,77,1987
Rodney Chen,"['Sierra Leone', 'British Indian Ocean Territory (Chagos Archipelago)']",Artist,1919,81,70,2000
Dr. Phillip Flores,"['Czech Republic', 'Finland']",Artist,1888,14,85,1902
Nicole Bailey,"['Antarctica (the territory South of 60 deg S)', 'United States Minor Outlying Islands']",Politician,1904,29,73,1933
Melissa Hernandez,"['Antigua and Barbuda', 'Barbados']",Artist,1901,55,39,1956
Virginia Manning,"['Mauritius', 'Pitcairn Islands']",Politician,1874,79,41,1953
Katherine Smith,"['Japan', 'Costa Rica']",Politician,1870,60,77,1930
David Bailey,"['Taiwan', 'Belgium']",Artist,1914,86,14,2000
Eric Hall,['Palestinian Territory'],Politician,1906,61,18,1967
Tina Robbins,"['United Kingdom', 'Monaco']",Artist,1897,63,14,1960
Kimberly French,['Sierra Leone'],Artist,1873,6,75,1879
Melissa Howard,['Ethiopia'],Politician,1905,19,42,1924
Kimberly Carter,['Nepal'],Researcher,1901,21,43,1922
Kelsey Holt,"['Palau', 'Guyana']",Artist,1874,79,16,1953
Brenda Berry,"['Gambia', 'Cambodia']",Explorer,1886,86,88,1972
Melissa Gordon,['Peru'],Artist,1895,0,37,1895
Jill Tran,['Haiti'],Artist,1881,19,68,1900
Terry Liu,"['Bangladesh', 'Niger']",Artist,1923,23,70,1946
Ryan Hodge,"['Russian Federation', 'Libyan Arab Jamahiriya']",Artist,1876,83,65,1959
Elizabeth Lowery,['Barbados'],Politician,1900,15,0,1915
Kelsey Shaw,"[""Cote d'Ivoire"", 'Argentina']",Military personnel,1916,6,1,1922
Dwayne Swanson,['Bhutan'],Politician,1872,39,82,1911
Samantha Coleman,"['Burundi', 'Bhutan']",Artist,1917,79,23,1996
Alexander Cook,['Cook Islands'],Politician,1877,43,4,1920
Elizabeth Silva,['Maldives'],Artist,1899,23,0,1922
Timothy Marsh,['Brunei Darussalam'],Politician,1876,9,79,1885
Darren Burke PhD,"['Iran', 'Kenya']",Politician,1872,14,10,1886
Matthew Edwards,"['Sweden', 'Canada']",Artist,1900,79,2,1979
Jacob Scott,['Mauritania'],Artist,1892,29,34,1921
Richard Davis,['Cayman Islands'],Athlete,1903,35,33,1938
Helen Andrews,"['Niue', 'Costa Rica']",Researcher,1877,28,42,1905
Andrew Jones,['Senegal'],Artist,1880,44,40,1924
Ashley Foster,['India'],Artist,1904,70,23,1974
Mark Bailey,"['Argentina', 'Norfolk Island']",Athlete,1922,28,83,1950
Katie Rose,['Brunei Darussalam'],Athlete,1920,83,83,2003
Joshua Carpenter,['Moldova'],Researcher,1891,5,31,1896
Rebecca Hart,"['Uganda', 'Chad']",Artist,1897,30,30,1927
Robyn Cole,['Svalbard & Jan Mayen Islands'],Artist,1920,81,37,2001
Tammy Washington,['Tanzania'],Military personnel,1923,60,69,1983
Michael Haney,"['Vanuatu', 'Ghana']",Artist,1876,64,71,1940
Lisa Snyder,['Isle of Man'],Researcher,1870,22,79,1892
Fred Davis,"['Slovakia (Slovak Republic)', 'Macao']",Artist,1906,78,15,1984
Cody Davis,['Equatorial Guinea'],Teacher,1893,87,0,1980
Mary Porter,['Saint Vincent and the Grenadines'],Artist,1877,64,83,1941
Teresa Martin,['Kenya'],Researcher,1902,82,15,1984
Lydia Vargas,['Gambia'],Researcher,1891,40,7,1931
Jared Sanchez,"['Kiribati', 'Israel']",Artist,1921,29,80,1950
Tammy Dixon,['Iraq'],Researcher,1890,51,9,1941
Wayne Avery,['Iraq'],Artist,1871,78,39,1949
Kyle Thompson,['Iceland'],Monarch,1885,40,17,1925
Deborah Fletcher,['Sweden'],Businessperson,1905,87,53,1992
Susan Warren,"['Turkey', 'Norfolk Island']",Artist,1873,85,75,1958
Jack Newton MD,['Panama'],Teacher,1915,35,2,1950
Curtis Daniels,"['Madagascar', 'Bhutan']",Researcher,1908,8,35,1916
Heather Perez,['Puerto Rico'],Parson,1874,68,13,1942
Eduardo Bowers,['Somalia'],Military personnel,1883,63,14,1946
Kristen Clark,"['Uzbekistan', 'Switzerland']",Artist,1896,21,84,1917
Samuel Tate,"['Palau', 'Maldives']",Artist,1902,53,37,1955
Joseph Johnson,['French Polynesia'],Artist,1924,82,13,2006
Timothy Miller,['Guinea-Bissau'],Artist,1899,30,11,1929
Emily Baker,['North Macedonia'],Ballet dancer; choreographer; dancer,1885,45,53,1930
William Johnson,"['Denmark', 'Georgia']",Politician,1899,64,58,1963
Amanda Stevenson,"['Turkmenistan', 'Mauritania']",Playwright; author; novelist,1888,6,30,1894
Angelica Salinas,"['Sao Tome and Principe', 'India']",Artist,1909,67,48,1976
Jeremy Johnson,"['Ghana', 'Mozambique']",Researcher,1901,46,9,1947
Walter Avila,['Netherlands'],Artist,1904,41,63,1945
Amy Miller,"['Guadeloupe', 'Malaysia']",Artist,1883,9,28,1892
Anita Burns,['Maldives'],Gangster,1919,25,60,1944
Brian Johnston,['Guinea'],Artist,1920,43,65,1963
Stacey Hopkins,"['Oman', 'Antigua and Barbuda']",Artist,1884,30,0,1914
Thomas Nichols,['Rwanda'],Sovereign,1884,66,64,1950
Jeffrey Liu,"['Faroe Islands', 'Iraq']",Politician,1899,30,52,1929
Roy Green,['Brunei Darussalam'],Politician,1888,27,18,1915
Mr. Ryan Espinoza DDS,"['Sri Lanka', 'Germany']",Politician,1904,62,25,1966
Andrew Mullins,"['Bahamas', 'Cambodia']",Artist,1898,64,72,1962
Charles Wright,"['Italy', 'Seychelles']",Politician,1897,76,57,1973
Erin Gibson,['Panama'],Costume designer,1893,85,64,1978
Charles Anderson,['Slovenia'],Artist,1894,76,85,1970
Sherry Donovan,"['Afghanistan', 'Palestinian Territory']",Researcher,1893,13,3,1906
William Cline,"['Zambia', 'Barbados']",Artist,1915,21,63,1936
Robert Carroll,"['Lebanon', 'Norfolk Island']",Artist,1924,83,33,2007
Christy Rios,"['Heard Island and McDonald Islands', 'Netherlands Antilles']",Athlete,1893,67,82,1960
Kelli Lam,"['Cambodia', 'Algeria']",Politician,1879,71,0,1950
Brian Chung,"['Australia', 'Tajikistan']",Alpine skier,1894,19,32,1913
Tammy Montoya,"['Syrian Arab Republic', 'Cameroon']",Politician,1905,40,0,1945
Jenna Martinez,"['Barbados', 'Nicaragua']",Physician,1874,40,27,1914
Gabrielle Harrington,"['Togo', 'Romania']",Military personnel,1897,71,0,1968
Seth Wilcox,['Marshall Islands'],Artist,1919,67,23,1986
William Krause,['Mexico'],Artist,1896,2,69,1898
Kevin Booth,['Slovenia'],Artist,1923,66,84,1989
Pamela Powell,"['Barbados', 'Saint Pierre and Miquelon']",Researcher,1900,34,1,1934
Ethan Hodge,['Romania'],Artist,1894,11,10,1905
Michael Merritt,"['Iran', 'Somalia']",Teacher,1882,25,9,1907
Christopher Davis,"['Estonia', 'Serbia']",Artist,1919,76,41,1995
Maria Washington,"['Albania', 'Lesotho']",Artist,1911,8,83,1919
Troy Klein,"['French Polynesia', 'Egypt']",Nurse; torturer; concentration camp guard,1900,89,7,1989
Mrs. Christine Coleman DVM,['Slovenia'],Artist,1902,11,13,1913
Courtney Robinson,"['Brazil', 'Korea']",Athlete,1912,45,73,1957
Julia Brown,['Lesotho'],Athlete,1908,76,53,1984
Gregory Wells,"['Haiti', 'Italy']",Athlete,1888,76,43,1964
Paige Hayes,"['South Georgia and the South Sandwich Islands', 'Timor-Leste']",Artist,1880,64,42,1944
Alison Hartman,['British Virgin Islands'],Athlete,1914,56,1,1970
Dr. Richard Armstrong,['Guyana'],Researcher,1914,48,15,1962
Laura Mann,"['Canada', 'Armenia']",Artist,1923,15,64,1938
Brendan Morton,"['Belgium', 'Gabon']",Housekeeper,1916,42,77,1958
Stephanie Martinez,['Luxembourg'],Artist,1897,78,40,1975
Regina Waters,['Somalia'],Artist,1908,86,88,1994
William Bishop,"['Honduras', 'Lithuania']",Artist,1909,61,2,1970
Kenneth Moore,"['Romania', 'Kazakhstan']",Artist,1875,22,2,1897
Timothy Brewer,"['Saint Kitts and Nevis', 'Switzerland']",Military personnel,1872,68,13,1940
Joann Williams,['Wallis and Futuna'],Politician,1874,2,3,1876
Dr. Melissa Moore,"['Guinea-Bissau', 'Indonesia']",Artist,1879,4,19,1883
David Pittman,['Kenya'],Researcher,1898,25,25,1923
Katrina Torres,['Saint Kitts and Nevis'],Athlete,1917,48,5,1965
Justin Moreno,['Bolivia'],Politician,1912,12,59,1924
Jeffrey Perez,['Somalia'],Politician,1875,45,35,1920
Steven Wright,"['Indonesia', 'Anguilla']",Artist,1891,82,28,1973
Troy Snow,"['Cuba', 'North Macedonia']",Artist,1881,73,2,1954
Jennifer Soto,['Thailand'],Artist,1903,22,87,1925
Brandon Morales,"['Pakistan', 'Zambia']",Jurist,1879,9,29,1888
Jason Carter,"['Anguilla', 'South Africa']",Politician,1906,44,43,1950
Warren Pierce,['South Georgia and the South Sandwich Islands'],Researcher,1875,26,61,1901
Robert Dickson,['India'],Artist,1878,18,38,1896
Tara Davila,['Libyan Arab Jamahiriya'],Politician,1874,40,24,1914
Joshua Bennett,['Japan'],Athlete,1907,64,21,1971
Gabrielle Tyler,"['Monaco', 'Gambia']",Artist,1910,18,59,1928
John Barrett,['Holy See (Vatican City State)'],Artist,1897,36,11,1933
Trevor Hernandez,['Senegal'],Artist,1918,3,45,1921
Adrian Wilkinson,"['Austria', 'Comoros']",Artist,1914,82,56,1996
Candice Rodriguez,"['Sudan', 'Qatar']",Sovereign,1877,52,47,1929
Mary Farley,['Namibia'],Artist,1917,13,46,1930
Christian Bowman,['Heard Island and McDonald Islands'],Researcher,1903,49,9,1952
Michael Brennan,"['United States Minor Outlying Islands', 'Chad']",Politician,1892,78,3,1970
Dana Taylor,"['Rwanda', 'Hong Kong']",Artist,1913,86,17,1999
Tracy Thompson,"['Nauru', 'Northern Mariana Islands']",Athlete,1889,71,22,1960
David Johnson,"['Seychelles', 'Mauritania']",Artist,1901,2,57,1903
Tiffany Jones,['Somalia'],Politician,1903,38,65,1941
Lisa Cole,['Cape Verde'],Artist,1874,33,14,1907
Savannah Price,"['Kuwait', 'Mongolia']",Politician,1875,9,68,1884
Amanda Tran,"['South Africa', 'Kazakhstan']",Athlete,1878,77,89,1955
Daniel Clark,['Grenada'],Athlete,1898,18,54,1916
Barry Chung,"['Tanzania', 'Azerbaijan']",Anthropologist,1873,84,72,1957
David Choi,"['Congo', 'Zambia']",Artist,1878,53,23,1931
Katrina Simpson,['Trinidad and Tobago'],Religious figure,1896,86,7,1982
Dustin Taylor,['Kenya'],Military personnel,1924,77,67,2001
Lisa Smith,"['Tanzania', 'Bolivia']",Athlete,1919,3,61,1922
Tyrone Wright,"['Niger', 'Montserrat']",Artist,1889,35,60,1924
Mercedes Smith,['Georgia'],Artist,1881,37,63,1918
Jennifer Aguilar,['Guadeloupe'],Artist,1906,35,39,1941
Jason Cabrera,"['Egypt', 'Bhutan']",Politician,1910,9,24,1919
Kevin Mejia,"['Palestinian Territory', 'Burkina Faso']",Artist,1893,50,59,1943
Carrie Jackson,"['Greece', 'Eritrea']",Military personnel,1871,47,50,1918
Jonathan Gilbert,"['Croatia', 'Saint Vincent and the Grenadines']",Entrepreneur,1900,65,71,1965
Lori Lopez,['Chad'],Politician,1879,5,62,1884
Elizabeth Johnson,['Guernsey'],Artist,1892,76,30,1968
Jessica Johnson,['Martinique'],Politician,1913,88,41,2001
Samantha Baxter,"['Palau', 'Maldives']",Ballet dancer; choreographer; fashion designer; dancer,1917,3,74,1920
Dwayne Young,"['Croatia', 'Panama']",Politician,1908,89,84,1997
Dana Ward,"['Czech Republic', 'Kenya']",Politician,1912,41,59,1953
Thomas Jones,['Nigeria'],Athlete,1889,36,81,1925
Rita Evans,['Nauru'],Researcher,1915,60,27,1975
Justin Bass,"['Nauru', 'Benin']",Politician,1892,78,87,1970
Eric Miles,['Iran'],Politician,1919,60,49,1979
Mario Martinez,"['Vietnam', 'United States of America']",Artist,1912,6,77,1918
Stephanie Washington,"['Rwanda', 'Sudan']",Artist,1917,69,2,1986
Matthew Gonzalez,['Bangladesh'],Artist,1896,85,24,1981
Ariana Medina,"['Faroe Islands', 'Kenya']",Athlete,1916,15,10,1931
Suzanne Clark,['Mexico'],Artist,1920,53,5,1973
Morgan Ortiz,"['Guyana', 'British Virgin Islands']",Artist,1918,38,28,1956
Stephanie Thompson,"['Jersey', 'Luxembourg']",Artist,1886,32,66,1918
Todd Morales,"['Croatia', 'Burkina Faso']",Military personnel,1883,72,87,1955
Walter Cook,['Moldova'],Artist,1896,88,42,1984
Jennifer Sosa,['Haiti'],Politician,1903,86,60,1989
Anthony Hawkins MD,['Chile'],Researcher,1875,79,46,1954
Stephanie Poole,"['Comoros', 'North Macedonia']",Researcher,1891,88,18,1979
Catherine Smith DVM,"['Niue', 'Yemen']",Artist,1910,14,89,1924
Leah Barton,['Oman'],Artist,1896,60,16,1956
James Thomas,"['Antarctica (the territory South of 60 deg S)', 'Vietnam']",Artist,1897,76,48,1973
Hannah Richardson,"['Romania', 'Norway']",Artist,1891,24,4,1915
Jeffrey Howard,['Turkey'],Researcher,1897,75,11,1972
Ian Irwin,"['Indonesia', 'China']",Researcher,1877,51,12,1928
Benjamin Robles,"['Malta', 'Djibouti']",Artist,1916,0,29,1916
Robin Randall,['Jersey'],Artist,1901,61,22,1962
Dustin Case,"['Palau', 'Kazakhstan']",Television producer; aerobatics pilot,1908,39,62,1947
Carlos Horn II,"['Czech Republic', 'Botswana']",Politician,1903,56,67,1959
Juan Braun,"['Saudi Arabia', 'Ireland']",Physician,1900,49,21,1949
Daniel Miller,['Namibia'],Artist,1901,37,2,1938
David Maynard,['Gibraltar'],Military personnel,1887,5,69,1892
Thomas Kelly,['Croatia'],Artist,1879,34,36,1913
William Little,['Syrian Arab Republic'],Artist,1905,71,75,1976
Sean Berg,['Iran'],Artist,1904,32,43,1936
Daniel Sullivan,['Iceland'],Politician,1892,60,40,1952
James Leonard,['Dominica'],Artist,1898,18,9,1916
Joseph Williams,"['Belgium', 'Myanmar']",Businessperson,1913,75,46,1988
Ricardo Hall,"['Egypt', 'French Guiana']",Researcher,1875,58,46,1933
Zachary Burke,['Monaco'],Politician,1876,86,4,1962
Hannah Bryan,['Timor-Leste'],Military personnel,1884,0,41,1884
Natasha Anderson,['Norway'],Engineer,1923,35,42,1958
Michael Page,"['Senegal', 'Monaco']",Politician,1922,77,26,1999
Donald Jenkins,['Haiti'],Researcher,1919,24,47,1943
Thomas Ball,"['Moldova', 'Finland']",Politician,1911,38,63,1949
James Austin,"['Saint Barthelemy', 'Syrian Arab Republic']",Politician,1903,32,23,1935
Desiree Taylor,['Samoa'],Teacher,1874,47,82,1921
Patrick Arroyo,"['Singapore', 'Honduras']",Artist,1896,53,80,1949
Suzanne Flores,"['San Marino', 'Bahamas']",Artist,1918,29,47,1947
Jane Madden,['Peru'],Athlete,1916,82,58,1998
Thomas Wagner,"['Iran', 'Finland']",Pianist; music pedagogue,1891,74,8,1965
Patricia Peterson,['Nauru'],Politician,1916,14,42,1930
Michelle Gonzalez,"['Tuvalu', 'Estonia']",Researcher,1886,5,13,1891
Todd Friedman,['Ethiopia'],Nurse,1902,16,45,1918
Justin Johnson,"['United Arab Emirates', 'Zimbabwe']",Researcher,1890,39,81,1929
Kathryn Watson,['Montserrat'],Artist,1892,62,49,1954
Jason Rivera,['Indonesia'],Artist,1905,35,0,1940
Catherine Bell,"['Pitcairn Islands', 'Niue']",Aristocrat,1898,53,67,1951
Laura White,['Estonia'],Politician,1918,29,32,1947
Jacqueline Lucero,"['Brazil', 'Saint Lucia']",Researcher,1902,13,84,1915
Daniel Phillips,"['Mozambique', 'Ireland']",Artist,1918,6,37,1924
Lori Byrd,"['Iran', 'Guernsey']",Engineer,1879,8,47,1887
Taylor Perez,"['Somalia', 'Iceland']",Artist,1903,22,25,1925
Lorraine Clark,['Indonesia'],Artist,1915,49,1,1964
Casey Morales,"['Svalbard & Jan Mayen Islands', 'Samoa']",Artist,1890,55,0,1945
Brandon Wells,"['Lebanon', 'Russian Federation']",Artist,1897,66,39,1963
Kenneth Rojas,"['Uzbekistan', 'Mauritania']",Politician,1910,34,14,1944
Tiffany Joseph,['Latvia'],Artist,1890,11,59,1901
Kendra Wilson,"['Guatemala', 'Barbados']",Human rights activist,1915,51,19,1966
Lauren Weaver,"['Jersey', 'Guernsey']",Comedian; stand-up comedian,1891,67,66,1958
Lawrence Klein,"['Morocco', 'Solomon Islands']",Politician,1877,9,24,1886
Kimberly Jackson,['Ecuador'],Teacher,1891,85,58,1976
Troy Valenzuela,"['Saint Helena', 'Kuwait']",Artist,1910,47,5,1957
Scott Randall,"['Venezuela', 'Malaysia']",Artist,1883,2,5,1885
Jennifer Davidson,['India'],Researcher,1879,9,56,1888
Scott Fuentes,['Tokelau'],Athlete,1906,47,20,1953
Stephanie Lang,"['Ethiopia', 'Dominican Republic']",Artist,1884,56,84,1940
William Petersen,"['Bahamas', 'Antigua and Barbuda']",Artist,1916,48,70,1964
Christopher Page,['Austria'],Politician,1870,14,64,1884
Gregory Duke,"['Gambia', 'Mayotte']",Researcher,1910,76,42,1986
James Nichols,"['Peru', 'Ireland']",Businessperson,1877,63,24,1940
James Davis,"['Bangladesh', 'Costa Rica']",Artist,1920,13,47,1933
Mark Horne,"['Mali', 'Spain']",Artist,1913,48,26,1961
James Gordon,['Montserrat'],Politician,1906,69,15,1975
Amy Rodriguez,"['Malta', 'Suriname']",Politician,1890,49,73,1939
Krista Mejia,['Tokelau'],Researcher,1891,49,70,1940
Bruce Pearson,['Brazil'],Animator; film producer,1909,27,14,1936
Paul Patton,['Grenada'],Artist,1906,26,2,1932
Laurie Martin,['Egypt'],Athlete,1919,22,58,1941
Kyle Henderson,"['Jersey', 'Argentina']",Artist,1882,66,26,1948
Melissa Marshall,['Rwanda'],Artist,1889,74,39,1963
Anthony Adams,['Mongolia'],Explorer,1884,33,87,1917
Michael Francis,['Bulgaria'],Artist,1870,61,33,1931
Robin Stewart,['Switzerland'],Artist,1907,16,38,1923
Thomas Brown,['Cuba'],Artist,1923,21,65,1944
Edward Butler,"['Western Sahara', 'United States of America']",Military personnel,1898,32,32,1930
Rachel Meyer,"['Sri Lanka', 'Yemen']",Politician,1879,17,82,1896
Mr. Tristan Chapman,"['Cyprus', 'Solomon Islands']",Religious figure,1908,30,89,1938
Cody Liu,"['Zimbabwe', 'Nigeria']",Politician,1886,82,18,1968
Cynthia Hicks,"['Falkland Islands (Malvinas)', 'Albania']",Artist,1922,25,13,1947
Ricky Smith,['Tokelau'],Military personnel,1908,25,87,1933
Kimberly Harmon,"['Suriname', 'Wallis and Futuna']",Artist,1924,31,52,1955
Lucas Miller,['New Zealand'],Film producer,1916,68,83,1984
Katherine Cannon,['Ethiopia'],Athlete,1920,64,68,1984
Ashley Benton,['Bhutan'],Politician,1893,63,5,1956
James Ball,['South Africa'],Politician,1923,79,41,2002
Barbara Thompson,"['Burkina Faso', 'Albania']",Artist,1903,18,42,1921
Stephen Montgomery,['Ukraine'],Military personnel,1896,13,25,1909
Brooke Brown,['Faroe Islands'],Military personnel,1904,83,66,1987
Jonathan Moore,"['Holy See (Vatican City State)', 'Gambia']",Artist,1890,75,57,1965
Julie Phillips,"['Peru', 'Somalia']",Entrepreneur,1886,88,8,1974
Kelly Campbell,"['Sao Tome and Principe', 'Rwanda']",Artist,1871,66,53,1937
Patricia Davis,"['Lebanon', 'Tunisia']",Cartographer; explorer,1908,58,11,1966
George Price,"['Hong Kong', 'Afghanistan']",Politician,1918,82,32,2000
Nathan Barnes,"['Philippines', 'Antarctica (the territory South of 60 deg S)']",Aristocrat,1888,43,80,1931
Julie Sullivan,"['Marshall Islands', 'Honduras']",Politician,1914,57,1,1971
Jason Perkins,['Finland'],Artist,1872,80,65,1952
Katelyn Mann,['Lebanon'],Researcher,1878,71,81,1949
Anthony Jensen,"['Christmas Island', 'Yemen']",Engineer,1905,7,55,1912
Mitchell Gibbs,"['Antarctica (the territory South of 60 deg S)', 'Kenya']",Artist,1913,45,18,1958
Eileen Garcia,"['Saint Martin', 'Iraq']",Artist,1893,33,33,1926
Amanda Lopez,"['Korea', 'Norfolk Island']",Artist,1924,32,0,1956
Jeremiah Fields,['Svalbard & Jan Mayen Islands'],Artist,1893,1,36,1894
Eric Forbes,"['Peru', 'Hungary']",Athlete,1908,68,65,1976
Tammy Bauer,['Switzerland'],Researcher,1902,1,75,1903
Amy Barrett,"['Hong Kong', 'Poland']",Politician,1917,78,19,1995
Jeremy Soto MD,"['Jersey', 'Barbados']",Military personnel,1882,83,73,1965
Chase Garcia,['Kuwait'],Military personnel,1920,53,43,1973
James Blevins,['Niue'],Politician,1917,73,86,1990
Mrs. Maria Garrett,['Vanuatu'],Politician,1871,52,52,1923
Kristi Gardner,"['Namibia', 'Burundi']",Journalist,1875,59,42,1934
Eric Powell,['Venezuela'],Artist,1871,12,41,1883
Antonio Byrd,['Andorra'],Artist,1882,61,53,1943
Amanda Smith,['Armenia'],Athlete,1886,0,67,1886
James Jones,['Malaysia'],Artist,1870,47,9,1917
Karen Price,['Spain'],Athlete,1905,23,32,1928
James Houston II,['Uganda'],Artist,1894,56,60,1950
David Mays,"['Bahrain', 'Iceland']",Impresario; talent manager; talent agent,1874,41,82,1915
Michael Parks,['United States Minor Outlying Islands'],Artist,1910,19,62,1929
Patrick Smith,['Comoros'],Ruler,1920,66,61,1986
Robert Tran,['Niue'],Artist,1900,32,77,1932
Audrey Gallagher,['Jordan'],Politician,1895,35,39,1930
Stephen Mcconnell,['Kenya'],Guitarist,1892,31,2,1923
Adrian Walker,"['China', 'Niue']",Prostitute,1901,45,34,1946
Sabrina Allen,"['Senegal', 'Gambia']",Artist,1875,1,82,1876
Tanya Graham,"['Saint Martin', 'Bangladesh']",Politician,1902,14,17,1916
Destiny White,"['Netherlands', 'Anguilla']",Military personnel,1882,16,3,1898
Brett Wells,['Comoros'],Athlete,1870,64,60,1934
Mr. Eric Moore,['Georgia'],Artist,1919,61,19,1980
Michelle Clark,['Myanmar'],Artist,1899,71,39,1970
Brent Stewart,"['Georgia', 'Cocos (Keeling) Islands']",Military personnel,1885,27,53,1912
Kiara Johnson,"['Hong Kong', 'Holy See (Vatican City State)']",Artist,1902,83,81,1985
Emily Wolfe,"['Korea', 'Indonesia']",Artist,1900,23,60,1923
Daniel Hall,['Uganda'],Film producer,1890,24,60,1914
Darrell Brown,"['Azerbaijan', 'San Marino']",Military personnel,1898,18,46,1916
Lori Rivas,"['Sudan', 'Iceland']",Politician,1895,31,87,1926
Cynthia Case,"['Nigeria', 'Saint Martin']",Researcher,1912,26,63,1938
David Boyd,['Libyan Arab Jamahiriya'],Artist,1907,16,83,1923
Gregory Martinez,"['Wallis and Futuna', 'British Indian Ocean Territory (Chagos Archipelago)']",Researcher,1901,71,87,1972
Joseph Price,['Burkina Faso'],Artist,1911,42,78,1953
Brandon Freeman,"['Honduras', 'Zambia']",Politician,1893,25,25,1918
Helen Hunt,['Moldova'],Banker; art collector,1879,11,32,1890
Chad Wu,['Djibouti'],Artist,1915,11,60,1926
Melissa Chung,"['Ukraine', 'Bermuda']",Spy,1914,37,58,1951
Garrett Smith,"['Finland', 'Suriname']",Teacher,1894,49,33,1943
Travis Cochran,"['Cameroon', 'Tokelau']",Politician,1877,75,80,1952
Edward Lee,['Luxembourg'],Artist,1907,51,70,1958
Christine Mccoy,"['Uganda', 'American Samoa']",Engineer,1889,59,33,1948
Joshua Palmer,['Dominica'],Military personnel,1870,18,13,1888
Tracey Boone,"['Norway', 'Estonia']",Patron of the arts,1895,30,54,1925
Rebecca Pugh,"['Kenya', 'Maldives']",Artist,1900,5,2,1905
Steven Kerr,"['India', 'French Guiana']",Teacher,1881,10,0,1891
Cindy Wallace,['Saint Lucia'],Engineer,1917,87,12,2004
Michael Moore,"['Sri Lanka', ""Cote d'Ivoire""]",Professional wrestler,1913,70,6,1983
Kyle Guerra,"['Niue', 'Kuwait']",Artist,1924,58,20,1982
Rebecca Moore,"['Panama', 'Marshall Islands']",Politician,1907,57,34,1964
Tammy Townsend,['Taiwan'],Artist,1922,3,31,1925
Olivia Bell,['Holy See (Vatican City State)'],Artist,1904,58,35,1962
Diane Oliver,"['Saint Lucia', 'Latvia']",Physician,1877,89,66,1966
Joseph Chen,"['Bangladesh', 'Mali']",Researcher,1871,72,21,1943
Maria Gonzalez,['United Kingdom'],Bartender,1894,87,62,1981
Carrie White,"['Mauritius', 'Iraq']",Artist,1871,1,28,1872
Amy Carter,"['Azerbaijan', 'Sudan']",Athlete,1922,88,51,2010
Gina Jones,['Gibraltar'],Professional wrestler,1915,78,37,1993
Tammy Wolfe DVM,"['Bahamas', 'Isle of Man']",Politician,1898,43,58,1941
Jonathan Gonzalez,"['Turkey', 'Bosnia and Herzegovina']",Artist,1896,37,81,1933
Jennifer Tucker,['Ecuador'],Athlete,1886,23,60,1909
John Rodriguez,['United States of America'],Religious figure,1901,5,44,1906
Diana Hines,['Iran'],Artist,1890,55,46,1945
Shannon Carlson,"['Korea', 'Iraq']",Athlete,1919,4,75,1923
Monica Mullins,"['Western Sahara', 'Nepal']",Artist,1891,70,10,1961
Sara Oconnell,['Liechtenstein'],Religious figure,1886,19,47,1905
Edward Wright,['Albania'],Politician,1904,79,5,1983
Mr. Scott Lee DDS,"['Uganda', 'Panama']",Artist,1883,3,69,1886
Jeanne Phillips,['Argentina'],Ballet dancer,1904,45,83,1949
Erica Rowland,"['Bhutan', 'Turkey']",Artist,1892,68,5,1960
Brenda Morrison,"['Singapore', 'Estonia']",Artist,1901,66,9,1967
Patricia Vega,"['Russian Federation', 'Samoa']",Military personnel,1904,39,33,1943
Marissa Patterson,['Portugal'],Artist,1907,69,7,1976
Jessica Morgan,"['Luxembourg', 'Namibia']",Politician,1901,62,24,1963
Felicia Mercer,['Cape Verde'],Athlete,1892,1,47,1893
Jessica Dunn,"['Costa Rica', 'Uzbekistan']",Researcher,1879,75,81,1954
Jeffery Ortiz,"['Bolivia', 'Faroe Islands']",Artist,1874,10,46,1884
Todd Whitehead,"['Liberia', 'Bahamas']",Artist,1897,56,28,1953
Shawn Perez,"['Cuba', 'Honduras']",Politician,1901,17,53,1918
Crystal Thomas,['Congo'],Researcher,1884,37,58,1921
Nathan Nelson,['Cocos (Keeling) Islands'],Artist,1887,45,0,1932
Cody Shelton,"['Australia', 'Papua New Guinea']",Artist,1876,44,73,1920
Brian Miller,['Dominica'],Artist,1921,66,70,1987
Gerald Ramirez,"[""Cote d'Ivoire"", 'Myanmar']",Artist,1907,18,9,1925
Daniel Marshall,"['Cuba', 'Timor-Leste']",Military personnel,1891,81,83,1972
Heather Palmer,"['Samoa', 'Lebanon']",Artist,1906,19,77,1925
Latoya Smith,['Montenegro'],Athlete,1901,19,86,1920
Kristen Brown,"['Morocco', 'Guinea']",Artist,1911,69,46,1980
Jonathan Sanchez,"['Chad', 'Dominica']",Artist,1871,40,31,1911
Melanie Hughes,['Zambia'],Artist,1884,24,57,1908
Lisa Mccarthy,"['Romania', 'Burundi']",Artist,1886,63,49,1949
Mr. Nathan Gaines,['Angola'],Researcher,1876,45,54,1921
Jennifer Cruz,"['Serbia', 'Antigua and Barbuda']",Politician,1908,13,87,1921
Amanda Wood,['Kiribati'],Artist,1886,49,26,1935
Lori Alvarez,['Lithuania'],Politician,1913,10,25,1923
Joseph Harvey,['Guernsey'],Teacher,1877,79,43,1956
Daniel Castillo,"['Comoros', 'Cambodia']",Artist,1885,3,10,1888
Kelsey Lee,['United States Minor Outlying Islands'],Artist,1875,58,21,1933
Richard Moore,"['Oman', 'Belize']",Researcher,1878,27,87,1905
John Hull,"['Nigeria', 'Nauru']",Athlete,1883,11,22,1894
Aaron Flores,['Antigua and Barbuda'],Athlete,1906,14,67,1920
Daniel Wade,['Slovakia (Slovak Republic)'],Politician,1902,62,32,1964
Chelsea Mendez,['Brazil'],Businessperson,1905,49,88,1954
Ruben Bass,['Niue'],Artist,1916,37,78,1953
Heather White,['Burundi'],Politician,1884,45,40,1929
Donna Hale,"['Mozambique', 'Western Sahara']",Consort,1872,53,61,1925
Krista Frank,['Saint Helena'],Surfer,1911,9,12,1920
Jason Reyes,['Bosnia and Herzegovina'],Socialite,1915,3,4,1918
Jonathan Christian,['Burundi'],Artist,1893,0,59,1893
James Smith,"['Turks and Caicos Islands', 'Greenland']",Athlete,1873,53,76,1926
Sherry Shelton,['Marshall Islands'],Researcher,1884,83,8,1967
Jessica Lyons,"['Central African Republic', 'Comoros']",Artist,1874,5,38,1879
Alicia Doyle,['Kazakhstan'],Entrepreneur,1871,69,34,1940
Shannon Smith,"['Malaysia', 'Namibia']",Artist,1890,22,34,1912
Jack Torres,"['Iraq', 'Somalia']",Official; french resistance fighter,1896,73,36,1969
Joshua Douglas,['Monaco'],Politician,1914,20,83,1934
Jessica Gray,"['Latvia', 'Mali']",Artist,1872,39,41,1911
Omar Simmons,['Qatar'],Athlete,1913,27,65,1940
Jonathan Mcpherson,"['Sweden', 'Nauru']",Athlete,1894,19,53,1913
Randy Brown,['Peru'],Artist,1894,89,8,1983
Jacob Garcia,"['Bouvet Island (Bouvetoya)', 'Qatar']",Artist,1887,4,27,1891
Cory Fleming,['Congo'],Researcher,1923,15,0,1938
Kathy Spencer,"['Equatorial Guinea', 'Rwanda']",Researcher,1889,68,83,1957
Wendy Lopez,"[""Cote d'Ivoire""]",Artist,1891,36,51,1927
Jill Santana,['Estonia'],Politician,1912,63,76,1975
Renee Russell DDS,"['Guinea', 'Saint Helena']",Artist,1907,13,36,1920
Joshua Ramsey,"['United States of America', 'Bahamas']",Artist,1904,14,76,1918
Cynthia Woods,"['Guernsey', 'Greenland']",Artist,1918,83,72,2001
Brandon Williams,['Gabon'],Artist,1879,71,2,1950
Stephanie Thomas,"['Chad', 'Lesotho']",Artist,1914,22,45,1936
Ryan Huynh,"['Sweden', 'Uganda']",Manager; judoka; professional wrestler,1902,25,72,1927
Thomas Martin,['Dominican Republic'],Politician,1892,66,61,1958
Seth Daniels Jr.,"['Sao Tome and Principe', 'Greece']",Artist,1874,3,89,1877
Tyler Ramos,['United States Minor Outlying Islands'],Politician,1904,81,52,1985
Kelsey Clayton,['Egypt'],Researcher,1899,83,13,1982
Shannon Kelly MD,"['Peru', 'Afghanistan']",Cinematographer,1904,61,15,1965
James House,['Mali'],Researcher,1892,65,79,1957
Teresa Martin,['Gabon'],Politician,1915,9,86,1924
Amanda Anthony,"['Saudi Arabia', 'Croatia']",Fighter pilot,1897,28,78,1925
Rebecca Clayton,['South Africa'],Artist,1906,54,49,1960
Phillip Eaton,['El Salvador'],Politician,1893,8,23,1901
Justin Nelson,['Iceland'],Politician,1911,84,73,1995
Tyler Flores,['Sierra Leone'],Researcher,1923,68,29,1991
James Holt,"['United States Virgin Islands', 'Japan']",Religious figure,1875,19,30,1894
Mitchell Ramirez,['Philippines'],Artist,1901,82,45,1983
Dustin Campbell,"['Greenland', 'Tonga']",Artist,1877,67,76,1944
Travis Costa,['Svalbard & Jan Mayen Islands'],Artist,1915,77,59,1992
Willie Hansen,"['Belgium', 'Mongolia']",Artist,1900,24,3,1924
Kevin Moss,"['Slovenia', 'Cook Islands']",Politician,1910,48,56,1958
James Nicholson,['Israel'],Military personnel,1913,73,38,1986
Tina Ramirez,['Tunisia'],Politician,1875,1,14,1876
Diana Washington,['Bouvet Island (Bouvetoya)'],Mountaineer; explorer,1910,34,73,1944
Tami Miller,['Mozambique'],Artist,1893,38,5,1931
Nancy Durham,"['Cocos (Keeling) Islands', 'Saudi Arabia']",Artist,1882,87,32,1969
Raymond Palmer,"['Israel', 'Pitcairn Islands']",Artist,1872,0,19,1872
Cory Allen,['Reunion'],Artist,1923,46,57,1969
Rodney Morris,['North Macedonia'],Politician,1907,25,44,1932
Brian Russell,['Morocco'],Politician,1876,32,14,1908
Kimberly Walker,['Yemen'],Artist,1907,7,49,1914
Cynthia Hayes DDS,['Switzerland'],Politician,1872,42,65,1914
Brandon Stanley,"['Somalia', 'South Africa']",Researcher,1900,75,3,1975
Jennifer Miller,"['Niger', 'Guatemala']",Politician,1903,32,73,1935
Nancy Galloway,"['Poland', 'Wallis and Futuna']",Artist,1896,32,51,1928
Victoria Gomez,['Guam'],Pianist,1876,70,24,1946
Stephanie Vaughn,['Thailand'],Entrepreneur,1886,28,57,1914
Donald Frye,"['Vietnam', 'Kenya']",Military personnel,1888,58,73,1946
Steven Quinn,['Greece'],Politician,1881,47,56,1928
Luis Reid,"['Malta', 'Marshall Islands']",Character animator,1877,84,8,1961
Frank Rivas,"['Qatar', 'Cameroon']",Artist,1904,80,11,1984
Emily Smith,"['Ghana', 'Belgium']",Politician,1882,53,46,1935
Mr. John Simon,"['Estonia', 'Czech Republic']",Entrepreneur,1908,11,57,1919
Edward Powell,"['British Indian Ocean Territory (Chagos Archipelago)', 'Chad']",Politician,1906,58,45,1964
Erika Swanson,"['Solomon Islands', 'Afghanistan']",Athlete,1894,30,18,1924
Alexis Smith,['Congo'],Artist,1886,30,15,1916
Lauren Williams,"['Argentina', 'Saint Barthelemy']",Artist,1905,56,16,1961
Stephen Kerr,"['Seychelles', 'Belgium']",Artist,1896,45,12,1941
Stephen Robinson,['Zimbabwe'],Artist,1908,72,31,1980
Melissa Perez,['Palau'],Athlete,1885,6,17,1891
Mary Brown,['Nigeria'],Teacher,1896,47,53,1943
Michael Snyder,['Cape Verde'],Artist,1915,5,73,1920
Linda Martin,"['Philippines', 'Peru']",Racing automobile driver,1916,88,53,2004
Wendy Miller,"['Brazil', 'Saint Lucia']",Artist,1903,16,16,1919
Brenda Hoover,['Saint Martin'],Politician,1915,50,19,1965
Rachel Stewart,"['French Southern Territories', 'China']",Artist,1896,30,74,1926
Charles Galloway,['Bouvet Island (Bouvetoya)'],Politician,1903,77,5,1980
Christopher Miles,"['Chile', 'Cameroon']",Politician,1923,34,69,1957
John Parker,"['Jersey', 'Norway']",Researcher,1892,40,34,1932
Tiffany Hill,['Guam'],Politician,1918,68,1,1986
Alexander Clark,['Qatar'],Military personnel,1893,82,82,1975
Alex Cervantes,['Mexico'],Researcher,1901,27,51,1928
Shawn Watson,['Egypt'],Researcher,1883,62,49,1945
Kimberly Richardson,['Tajikistan'],Architect,1877,36,2,1913
Elizabeth Ochoa,"['Antigua and Barbuda', 'Northern Mariana Islands']",Politician,1879,79,26,1958
Miranda Jackson,"['Brunei Darussalam', 'Hungary']",Artist,1904,23,72,1927
Cynthia Palmer,"['Morocco', 'Kyrgyz Republic']",Politician,1872,13,31,1885
Timothy Hoffman,"[""Lao People's Democratic Republic""]",Politician,1887,60,51,1947
George Turner,"['Turkey', 'Tuvalu']",Artist,1906,67,30,1973
Shannon Mcgee,['Mauritania'],Politician,1872,87,33,1959
Benjamin Matthews,"['Tunisia', 'Swaziland']",Politician,1907,11,54,1918
Latoya Thornton,['Kenya'],Businessperson,1879,21,48,1900
Christina Peterson,['Pitcairn Islands'],Artist,1919,36,31,1955
Ms. Tammy Owens PhD,"['United States Minor Outlying Islands', 'Guadeloupe']",Politician,1901,59,82,1960
Dylan Price,"['France', 'Montenegro']",Politician,1901,29,70,1930
Christine Kerr,['Iceland'],Researcher,1914,68,49,1982
Jonathan Mason,['Iceland'],Military personnel,1875,73,17,1948
Megan Singleton,['Liechtenstein'],Artist,1902,7,31,1909
Ian Moses,"[""Lao People's Democratic Republic"", 'Indonesia']",Military personnel,1899,28,44,1927
Tracy Lewis,['Mongolia'],Artist,1880,6,11,1886
Nichole Short,"['Bolivia', 'Saint Lucia']",Journalist,1899,51,17,1950
Lisa Smith,['Belarus'],Athlete,1889,42,62,1931
Jessica Carr,['Hong Kong'],Artist,1896,14,26,1910
Lindsey Smith,['Bosnia and Herzegovina'],Military personnel,1883,69,54,1952
Jenny Anderson,"['Svalbard & Jan Mayen Islands', 'Slovakia (Slovak Republic)']",Politician,1906,5,25,1911
Jesse Roberts,['Kiribati'],Artist,1898,16,37,1914
Jeffrey Leblanc,['Libyan Arab Jamahiriya'],Artist,1880,39,45,1919
Samantha Andrade,"['Pakistan', 'Azerbaijan']",Athlete,1904,84,79,1988
Maureen Herrera,"['Nauru', 'United States Minor Outlying Islands']",Physician,1891,60,80,1951
Cory Torres,"['Turkmenistan', 'Mali']",Engineer,1897,6,1,1903
Kevin Henderson,['Bermuda'],Artist,1883,24,61,1907
Jason Clark,['Wallis and Futuna'],Artist,1910,72,30,1982
Richard Ruiz,"['Bouvet Island (Bouvetoya)', 'Brazil']",Entrepreneur,1887,89,44,1976
Cody Martin,"['United Kingdom', 'Malta']",Artist,1900,58,9,1958
Danielle Dean,['Falkland Islands (Malvinas)'],Athlete,1883,15,74,1898
Joshua Watson,"['Costa Rica', 'Paraguay']",Politician,1902,7,14,1909
Jessica Hernandez,"['Greece', 'Monaco']",Politician,1901,87,39,1988
Nicole Wilkerson,['Tunisia'],Artist,1914,36,19,1950
April Smith,['Sudan'],Politician,1896,42,85,1938
Aaron Dickerson,"['Gibraltar', 'Oman']",Artist,1919,88,41,2007
Juan Frye,"['Saint Helena', 'Guernsey']",Artist,1893,64,35,1957
Laura Mays,['Heard Island and McDonald Islands'],Artist,1922,75,77,1997
Jeffrey Johnson,['Egypt'],Artist,1876,70,38,1946
Dr. Katelyn James,['Guyana'],Artist,1900,52,46,1952
Melissa Young,['Macao'],Artist,1897,47,87,1944
Andrew Cantrell,['Bulgaria'],Artist,1873,16,12,1889
Jordan Johnson,"['Niue', 'Syrian Arab Republic']",Artist,1892,84,32,1976
Scott Martin,['Sweden'],Politician,1885,70,12,1955
Kelly Kelly,"['Netherlands', 'Macao']",Artist,1913,83,52,1996
Virginia Cox,"['Hungary', 'Saint Barthelemy']",Researcher,1907,84,64,1991
Connor Brooks,['Malaysia'],Fighter pilot,1893,55,69,1948
Stephanie Rose,['Marshall Islands'],Athlete,1898,38,26,1936
Misty Smith,['Somalia'],Artist,1906,47,50,1953
Andrea Rogers,['Korea'],Artist,1893,11,13,1904
Paul Howe,['Northern Mariana Islands'],Artist,1872,50,20,1922
Lindsey Ross,"['British Indian Ocean Territory (Chagos Archipelago)', 'Thailand']",Military personnel,1903,38,9,1941
Amber Small,"['Belgium', 'Malaysia']",Businessperson,1875,51,70,1926
Ryan Roberson,"['Bosnia and Herzegovina', 'Georgia']",Researcher,1897,49,22,1946
Meagan Velazquez,['Moldova'],Artist,1891,44,46,1935
Kim Bradford,['Saudi Arabia'],Politician,1923,86,42,2009
Omar Boyle MD,"['New Caledonia', 'Guinea-Bissau']",Nurse; serial killer,1893,15,27,1908
Natalie Gonzalez,"['Equatorial Guinea', 'Taiwan']",Artist,1876,86,58,1962
Kathleen Gonzalez,"['Italy', 'Cameroon']",Artist,1897,11,81,1908
Tonya Reeves,['Slovenia'],Politician,1910,18,89,1928
Lisa Horton,"['Ghana', 'South Africa']",SalonniÃ¨re,1897,82,17,1979
Terrence Booker,['Thailand'],Artist,1911,73,30,1984
Gary Miller,"['Cape Verde', 'Taiwan']",Researcher,1891,6,34,1897
Crystal Santos,"['Turks and Caicos Islands', 'Saint Lucia']",Artist,1886,49,14,1935
Sheri Gilbert,"['Chile', 'Kenya']",Artist,1898,48,58,1946
Seth Torres,"['Montenegro', 'Papua New Guinea']",Researcher,1901,39,30,1940
Jonathan Morris,['United Kingdom'],Artist,1903,14,58,1917
Katherine Guzman MD,['Uzbekistan'],Politician,1904,20,32,1924
Brian Riggs,"['Senegal', ""Lao People's Democratic Republic""]",Lawyer,1886,87,64,1973
Roberto Knox,['Nicaragua'],Researcher,1915,12,63,1927
Karl Walker,['Lebanon'],Athlete,1873,73,11,1946
Donna Reid,"['Norfolk Island', 'Northern Mariana Islands']",Artist,1920,70,17,1990
Chelsea Meadows,"['Cayman Islands', 'Angola']",Artist,1883,9,67,1892
William Hoffman,['Guinea'],Artist,1915,55,55,1970
Robert Davenport,"['Peru', 'Switzerland']",Artist,1894,66,83,1960
Andrea Wright,['Netherlands'],Military personnel,1916,10,62,1926
Elizabeth Bennett,['Eritrea'],Artist,1891,89,1,1980
Matthew Alvarado,['Colombia'],Artist,1889,46,48,1935
Ashley Fleming,['Kazakhstan'],Ice dancer,1889,9,53,1898
Ricky Morris,['Tuvalu'],Researcher,1890,69,60,1959
Linda Garrett,['Malaysia'],Artist,1896,53,36,1949
Alexandra Stafford,['Nicaragua'],Lady-in-waiting,1920,60,1,1980
Leslie Wade,['Kenya'],Artist,1900,74,65,1974
Stephen Mann,"['Gambia', 'Kazakhstan']",Artist,1884,81,61,1965
Peter Henson,"['Oman', 'Tonga']",Politician,1916,79,64,1995
Thomas Colon,['Liberia'],Teacher,1893,49,11,1942
Beth Schroeder,"['Brazil', 'Kazakhstan']",Artist,1871,64,71,1935
Tanner Melton,"['Gibraltar', 'Congo']",Athlete,1890,69,79,1959
Dr. Kaitlyn Lewis,"['Serbia', 'El Salvador']",Artist,1874,34,20,1908
Bradley Cruz,['Somalia'],Artist,1911,63,16,1974
Jesse Barnes,"[""Lao People's Democratic Republic"", 'Afghanistan']",Athlete,1891,34,25,1925
Kelsey Long,"['Bhutan', 'Korea']",Athlete,1895,30,72,1925
Thomas Peters,['Congo'],Politician,1873,2,15,1875
Edward Jones,"['Mayotte', 'Micronesia']",Politician,1874,48,31,1922
Paul Johnson,['Egypt'],Serial killer; criminal; cult leader,1915,76,67,1991
Clifford Cooper,"['Belgium', 'Taiwan']",Artist,1881,78,71,1959
Elizabeth Martin,['Belarus'],Teacher,1909,47,20,1956
Cynthia Simmons,"['Iraq', 'Saint Martin']",Competitive diver,1912,74,35,1986
Frank Johnson,['Netherlands'],Politician,1882,57,81,1939
Susan Hall,"['Greenland', 'Kiribati']",Politician,1918,70,64,1988
Michelle Fisher,['Christmas Island'],Anarchist,1884,8,38,1892
Ryan Lynch,['Saint Helena'],Politician,1887,3,27,1890
Michael Rodriguez,"['Eritrea', 'Uzbekistan']",Judge,1900,77,33,1977
Susan Zuniga,"['Jersey', 'Svalbard & Jan Mayen Islands']",Artist,1905,56,88,1961
Amanda Hutchinson,['Serbia'],Military personnel,1911,74,52,1985
Michelle Vazquez,"['Saint Kitts and Nevis', 'Montenegro']",Artist,1920,46,25,1966
Anthony Flores,['Latvia'],Artist,1890,5,73,1895
Sara Chambers,['Taiwan'],Pianist,1921,36,88,1957
Danny Hernandez,"['Korea', 'Cambodia']",Researcher,1872,76,24,1948
Michael Bradshaw,['Italy'],Artist,1910,86,27,1996
James Wang,"['Central African Republic', 'Reunion']",Artist,1872,34,41,1906
Laura Hernandez,"['Tajikistan', 'Kiribati']",Artist,1923,65,78,1988
Kayla Mathews MD,"['Marshall Islands', 'Vietnam']",Artist,1909,46,77,1955
Paula Crawford,['Poland'],Artist,1875,35,17,1910
Leonard Cruz,"['Cuba', 'Nigeria']",Military personnel,1909,32,77,1941
Michael Bishop,['Greenland'],Banker; financier; art collector; philanthropist,1897,40,88,1937
Joshua Cole,['Honduras'],Researcher,1892,76,3,1968
Chloe Love,"['Italy', 'Iran']",Rock climber,1906,47,81,1953
James Martin,['Guam'],Aristocrat,1886,14,61,1900
Daniel Moreno,"['Wallis and Futuna', 'United Kingdom']",Politician,1900,27,34,1927
Michael Boyle,['Portugal'],Artist,1871,87,18,1958
Lauren Jordan,"['Solomon Islands', 'Tokelau']",Researcher,1904,77,83,1981
Victor Jackson,"['Tuvalu', 'Wallis and Futuna']",Researcher,1871,30,33,1901
Beth Lucas,"['Germany', 'Suriname']",Politician,1898,2,20,1900
Mrs. Doris Moyer,['Niue'],Politician,1887,54,12,1941
Brian Walker,['Lebanon'],Artist,1913,28,71,1941
Anthony Spencer,"['Venezuela', 'Ecuador']",Politician,1888,53,54,1941
Jeffrey Reynolds,"['Italy', 'Portugal']",Artist,1870,63,68,1933
Courtney Fuller,['Belgium'],Athlete,1892,48,28,1940
Paula Sanders,"['Korea', 'Libyan Arab Jamahiriya']",Artist,1904,43,17,1947
Joshua Hill,"['Timor-Leste', 'Benin']",Criminal,1885,6,62,1891
Jeremy Brewer,"['Aruba', 'Tokelau']",Artist,1878,77,44,1955
Daniel Chavez,"['Falkland Islands (Malvinas)', 'Guinea']",Politician,1911,24,23,1935
Jordan Parker,['Nicaragua'],Politician,1899,89,6,1988
Teresa Ross,['Thailand'],Artist,1876,35,44,1911
Patrick Odonnell,"['Kiribati', 'Northern Mariana Islands']",Pianist; music pedagogue,1880,55,43,1935
Chris Lopez,['French Polynesia'],Politician,1897,54,26,1951
Eric Aguilar,"['Guyana', 'Anguilla']",Artist,1876,65,48,1941
Jeanne Blevins,['Monaco'],Monarch,1903,8,32,1911
Matthew Chavez,['Bangladesh'],Politician,1871,23,73,1894
Linda Price,['Bahamas'],Translator,1908,67,55,1975
Tony Brandt,"['Bangladesh', 'Turks and Caicos Islands']",Artist,1883,81,33,1964
Jason Nixon,"['Turks and Caicos Islands', 'Costa Rica']",Artist,1915,23,48,1938
Jeffrey Smith,"['Liberia', 'Sweden']",Athlete,1884,5,66,1889
Cheryl Neal,"['Hungary', 'Andorra']",Criminal,1915,13,64,1928
Wendy Greene,"['Solomon Islands', 'Sri Lanka']",Military personnel,1887,39,84,1926
Brent Smith,"['Uruguay', 'Mongolia']",Impresario; film producer,1871,26,62,1897
Joseph Gonzalez,['Senegal'],Artist,1904,16,75,1920
Cody Moore,"['Anguilla', 'Antigua and Barbuda']",Pianist,1916,30,66,1946
Stephen Massey,"['Antigua and Barbuda', 'Czech Republic']",Artist,1885,23,52,1908
Jeffrey Sullivan,['Latvia'],Artist,1917,18,43,1935
Joseph Miller,['Bahrain'],Teacher,1892,23,24,1915
Ruth Gregory,['Singapore'],Artist,1902,34,55,1936
Mary Barnes,"['Tonga', 'Belarus']",Artist,1875,63,40,1938
Michael Ortiz,['Venezuela'],Artist,1918,74,2,1992
Kevin Figueroa,['Guadeloupe'],Military personnel,1871,60,21,1931
Shelly Gray,['Palestinian Territory'],Spy,1920,1,40,1921
Patricia Erickson,['Brazil'],Researcher,1883,57,6,1940
Noah Welch,['Comoros'],Civil servant,1871,18,6,1889
Jesus Thomas,"['Vietnam', 'Bouvet Island (Bouvetoya)']",Politician,1924,43,34,1967
Dana Foster,"['Venezuela', 'Somalia']",Artist,1907,31,66,1938
Michael Mills,"['Andorra', 'Bulgaria']",Artist,1878,18,38,1896
Austin Reyes,['American Samoa'],Athlete,1897,1,36,1898
Michele Pacheco,['Mauritius'],Politician,1874,2,74,1876
Bonnie Brandt,"['Norfolk Island', 'Comoros']",Politician,1921,87,23,2008
Jason Pacheco,['Wallis and Futuna'],Artist,1910,49,16,1959
Bryan Thompson,['Austria'],Athlete,1871,35,4,1906
David Ortega,['Cape Verde'],Researcher,1893,74,46,1967
Haley Sawyer,['Bahrain'],Politician,1902,41,35,1943
Julie Sutton,['Anguilla'],Artist,1904,67,16,1971
Sandra Phillips,['Guinea'],Politician,1908,1,56,1909
Jennifer Warner,"['South Georgia and the South Sandwich Islands', 'Norway']",Researcher,1922,56,61,1978
Duane Thomas,"['Azerbaijan', 'Mayotte']",Politician,1896,19,56,1915
Cody Berry,"['Bahrain', 'Singapore']",Politician,1888,11,31,1899
Dominique Mays,"['Reunion', 'American Samoa']",Teacher,1882,28,51,1910
Diane Anderson,"['Brazil', 'Palau']",Artist,1915,10,49,1925
Mark Shaw,['Saint Martin'],Artist,1911,66,40,1977
Pamela Moore,['Syrian Arab Republic'],Artist,1900,71,70,1971
Travis Hawkins,['Papua New Guinea'],Artist,1904,59,53,1963
Frank Smith,['Cape Verde'],Researcher,1879,18,55,1897
Dr. James Benson,"['Peru', 'Moldova']",Monk,1915,47,49,1962
John Nguyen,['Finland'],Artist,1893,73,50,1966
Mr. James Ray,"['Egypt', 'Russian Federation']",Researcher,1902,34,89,1936
Jasmine Smith,"['Angola', 'Mauritania']",Athlete,1892,15,19,1907
Donald Banks,['Mauritania'],Artist,1910,82,35,1992
Tyler Bell,"['Bhutan', 'Sweden']",Military personnel,1886,20,30,1906
Diana Morrow,"['Guinea-Bissau', 'Poland']",Artist,1905,17,17,1922
Michael Martinez,"['Canada', 'British Virgin Islands']",SalonniÃ¨re; model,1915,43,18,1958
Matthew Bowen,"['Antigua and Barbuda', 'Guatemala']",Ballet dancer; ballet master; choreographer; dancer,1910,40,86,1950
James Lowe,"['North Macedonia', 'Poland']",Announcer,1873,14,88,1887
Daniel Russell,"['Montserrat', 'Monaco']",Artist,1877,82,23,1959
Julie Richmond,"['Peru', 'Honduras']",Businessperson,1900,41,39,1941
Elizabeth Thompson,"['Panama', 'New Caledonia']",Artist,1889,80,73,1969
Brandi Davis,"['Costa Rica', 'Jordan']",Religious figure,1890,23,86,1913
Matthew Johnson,['Nauru'],Politician,1915,0,67,1915
Chelsea Montoya,['Kenya'],Researcher,1892,38,77,1930
Francisco Clark,['Armenia'],Researcher,1884,67,9,1951
Denise Smith,"['Puerto Rico', 'Cook Islands']",Gangster,1874,23,37,1897
Tyler Caldwell,"['Cocos (Keeling) Islands', 'Svalbard & Jan Mayen Islands']",Artist,1903,27,42,1930
Daniel Brooks,['Palestinian Territory'],Politician,1893,66,1,1959
Jesse Carter,['Korea'],Artist,1887,40,19,1927
Michele Taylor,"['Senegal', 'Kenya']",Artist,1913,61,9,1974
Megan Boyd,['Falkland Islands (Malvinas)'],Lady-in-waiting,1909,18,17,1927
Victoria Farmer,"['Malaysia', 'Palestinian Territory']",Politician,1918,33,27,1951
Julia Guerrero,['Liechtenstein'],Military personnel,1918,89,28,2007
Lisa Sullivan,"['Congo', 'Australia']",Athlete,1893,49,32,1942
David Sanchez,['United States Virgin Islands'],Monarch,1873,84,82,1957
Susan Adams,['Bosnia and Herzegovina'],Researcher,1908,2,49,1910
James Green,['Palau'],Artist,1893,44,28,1937
Christine Moore,['Gabon'],Artist,1923,19,23,1942
Richard Vasquez,['Trinidad and Tobago'],Artist,1909,28,35,1937
Monica Wilson,"['Libyan Arab Jamahiriya', 'Falkland Islands (Malvinas)']",Researcher,1907,34,65,1941
Matthew Bauer,"['Armenia', 'Palau']",Artist,1902,72,59,1974
Kimberly Cameron,"['Wallis and Futuna', 'French Southern Territories']",Teacher,1886,82,30,1968
Peter Hudson,['Croatia'],Artist,1911,71,84,1982
Amy Leonard,"['Guyana', 'Saint Pierre and Miquelon']",Artist,1897,55,78,1952
Joseph Hammond,['Cyprus'],Aristocrat,1921,49,32,1970
Sydney Kirk,['Bolivia'],Artist,1905,11,81,1916
William Gregory,['Eritrea'],Artist,1879,33,25,1912
Lauren Long,['Andorra'],Politician,1924,38,75,1962
Chad Johnson,['Grenada'],Athlete,1923,61,29,1984
Jennifer Conner,"['Syrian Arab Republic', 'Spain']",Athlete,1905,3,7,1908
Kimberly Brown,"['Syrian Arab Republic', 'Honduras']",Artist,1913,81,51,1994
Misty Moses,['Uganda'],Politician,1905,70,68,1975
Martin Singleton,['Philippines'],Politician,1906,62,59,1968
Thomas Hinton,['Tanzania'],Artist,1920,87,19,2007
Dr. Christopher Johnson,"['Liechtenstein', 'Montenegro']",Athlete,1908,60,44,1968
Diana Parker,"['Benin', 'Bahamas']",Athlete,1882,1,6,1883
Valerie Murray,['Georgia'],Religious figure,1879,56,29,1935
George Le,"['Guernsey', 'Saudi Arabia']",Military personnel,1904,38,38,1942
Judy Martinez,"['Ghana', 'Faroe Islands']",Politician,1909,40,62,1949
Ronald Bailey,"['Philippines', 'Holy See (Vatican City State)']",Artist,1913,83,76,1996
Catherine Richardson,"['Spain', 'Bahamas']",Serial killer,1903,73,7,1976
Shannon Simmons,"['Maldives', 'Maldives']",Politician,1876,0,25,1876
James Johnson,"['Saint Lucia', 'Burundi']",Politician,1885,67,19,1952
Alison Hall,['Kazakhstan'],Military personnel,1881,82,36,1963
James Knapp,"['Romania', 'Bermuda']",Artist,1882,38,38,1920
Mary Bowman,['Venezuela'],Artist,1902,17,31,1919
Laurie Nguyen,"['Saint Vincent and the Grenadines', 'Slovenia']",Politician,1898,10,80,1908
Deborah Young,"['Tanzania', 'Senegal']",Religious figure,1880,60,62,1940
Christopher Hamilton,"['Cocos (Keeling) Islands', 'Cocos (Keeling) Islands']",Artist,1871,14,14,1885
Samuel Thompson,['Vietnam'],Athlete,1911,77,44,1988
Christopher Lewis,"['Nicaragua', 'Djibouti']",Artist,1918,48,17,1966
Sandra Warren,['Spain'],Researcher,1907,45,77,1952
Tom Adams,"['Mayotte', 'British Virgin Islands']",Businessperson,1882,25,1,1907
Jeremy Mendoza,"['Liechtenstein', 'Reunion']",Artist,1910,42,56,1952
Hunter Simmons,"['Bosnia and Herzegovina', 'Indonesia']",Artist,1922,16,56,1938
Zachary Martinez,"['United States Minor Outlying Islands', 'Rwanda']",Artist,1890,85,48,1975
Jose Morris,"['Serbia', 'Cayman Islands']",Researcher,1882,52,70,1934
Pamela Kennedy,['Suriname'],Researcher,1893,4,88,1897
Allison Hines,"['Armenia', 'Libyan Arab Jamahiriya']",Politician,1907,60,40,1967
Michael Kelly,['Malaysia'],Athlete,1919,85,37,2004
Robin Johnson,['Croatia'],Spree killer; mass murderer,1893,77,26,1970
Christopher Wagner,"['Tokelau', 'Bolivia']",Politician,1898,72,86,1970
Sarah Silva,['Pakistan'],Politician,1887,28,28,1915
Margaret Walters,['Timor-Leste'],Religious figure,1893,35,62,1928
Tara Ortiz,"['Lithuania', 'Oman']",Artist,1883,12,63,1895
Katherine Lopez,['Montenegro'],Hotel manager,1870,43,6,1913
Ashley Dougherty,"['Denmark', 'Hungary']",Artist,1877,25,88,1902
Daryl Mills,['Cook Islands'],Politician,1893,50,69,1943
Jessica Olson,['French Southern Territories'],Artist,1907,50,22,1957
Jessica Miller,"['Sudan', 'Greece']",Researcher,1878,14,6,1892
Miss Debbie Dalton,"['Saudi Arabia', 'Falkland Islands (Malvinas)']",Artist,1872,52,10,1924
Laura Stewart,['Taiwan'],Artist,1894,18,21,1912
Misty Burton,['Nicaragua'],Artist,1898,17,42,1915
John Sanders,['Norway'],Athlete,1880,35,51,1915
Amanda Clark,"['Mozambique', 'Faroe Islands']",Artist,1918,64,14,1982
Tracy Williams,"['Chile', 'Latvia']",Athlete,1884,89,88,1973
Jennifer Richards,"['Cambodia', 'French Southern Territories']",Athlete,1880,88,2,1968
Susan Harris,"['Portugal', 'Zimbabwe']",Athlete,1908,50,12,1958
Amanda Smith,"['Canada', 'Afghanistan']",Researcher,1912,27,30,1939
John Jones,['Bolivia'],Researcher,1900,39,63,1939
Matthew Nelson,['Armenia'],Politician,1906,86,2,1992
Robert Rose,"['Slovakia (Slovak Republic)', 'Czech Republic']",Military personnel,1924,44,4,1968
Jessica Jackson,['Suriname'],Artist,1874,12,26,1886
James Kane MD,"['Greece', 'Russian Federation']",Politician,1922,82,59,2004
Justin Gardner,['Trinidad and Tobago'],Alpine skier,1892,53,16,1945
Kayla Phillips,"['France', 'Isle of Man']",Artist,1892,17,36,1909
Rachel Holden,['Barbados'],Artist,1892,50,79,1942
Mark Hayes,['Colombia'],Artist,1870,20,49,1890
Ms. Samantha Hensley,['Gabon'],Artist,1870,63,87,1933
Sherry Wall,['Kiribati'],Military personnel,1902,1,22,1903
Luke Taylor,"['Poland', 'French Polynesia']",Researcher,1898,50,41,1948
Mary Moon,['Myanmar'],Artist,1888,73,0,1961
Richard Morrow,"['Egypt', 'Niue']",Artist,1902,85,21,1987
Jordan Jones,"['Colombia', 'Liechtenstein']",Athlete,1905,32,76,1937
Jon Howe,"['United Kingdom', 'Netherlands']",Military personnel,1912,43,67,1955
Roger Thomas,"['Vanuatu', 'Panama']",Artist,1884,74,47,1958
Robert Smith,['Heard Island and McDonald Islands'],Artist,1904,24,23,1928
Jason Wallace,"['Turkmenistan', 'Congo']",Researcher,1885,68,64,1953
Ronald Neal,"['Peru', 'Kuwait']",Artist,1895,35,65,1930
Taylor Graham,['Saint Barthelemy'],Artist,1916,1,82,1917
Daniel Hernandez,['Thailand'],Artist,1914,88,53,2002
Cynthia Ramirez,"['Belgium', 'Bolivia']",Artist,1904,74,66,1978
Diamond Tanner,['Singapore'],Artist,1915,7,44,1922
Ronald Davis,['Burundi'],Artist,1915,85,17,2000
Mitchell Stone,"['Germany', 'Guadeloupe']",Artist,1874,63,17,1937
Veronica Long,['Mozambique'],Politician,1870,84,18,1954
Julia Rivera,['Bosnia and Herzegovina'],Military personnel,1880,70,27,1950
Howard Parker,"['Colombia', 'Ireland']",Businessperson,1891,61,10,1952
Jessica Dudley,['Angola'],Politician,1879,41,22,1920
Mary Ford,"['Spain', 'Rwanda']",Entrepreneur,1923,71,30,1994
